human symbol,mouse symbol,human,mouse,Total,HSF1 average peak,HSF2 average peak,PPARGC1A average peak
A1BG,A1bg,3,1,4,0,0,0
A1CF,A1cf,2,0,2,0,0,0
A2M,A2m,1,-6,-5,0,0,0
A2ML1,A2ml1,11,3,14,25.038835,0,0
A3GALT2,A3galt2,7,14,21,0,0,0
A4GALT,A4galt,1,-6,-5,0,0,0
A4GNT,A4gnt,-1,0,-1,0,0,0
AAAS,Aaas,7,-11,-4,60.815534,0,0
AACS,Aacs,6,-3,3,3.475728,0,0
AADAC,Aadac,14,3,17,0,0,0
AADACL2,Aadacl2,0,1,1,0,0,0
AADACL3,Aadacl3,16,0,16,2.864078,0,0
AADACL4,Aadacl4,1,0,1,0,0,0
AADAT,Aadat,1,-3,-2,2.805825,0,0
AAGAB,Aagab,5,1,6,59.184466,0,0
AAK1,Aak1,4,1,5,25.980583,0,0
AAMDC,Aamdc,3,-9,-6,5.446602,0,0
AAMP,Aamp,7,-3,4,7.883495,0,0
AANAT,Aanat,19,-11,8,110.446602,0,0
AAR2,Aar2,0,-4,-4,19.029126,0,0
AARD,Aard,1,6,7,0,0,0
AARS2,Aars2,3,-7,-4,13.262136,0,0
AARSD1,Aarsd1,-3,-7,-10,1.825243,0,0
AASDH,Aasdh,5,-9,-4,4.834951,0,0
AASDHPPT,Aasdhppt,5,-7,-2,3.61165,0,0
AASS,Aass,2,7,9,13.213592,0,0
AATF,Aatf,10,1,11,6.475728,0,0
AATK,Aatk,8,-3,5,10.708738,0,0
ABAT,Abat,14,-4,10,0,0,0
ABCA1,Abca1,5,1,6,0.961165,0,0
ABCA12,Abca12,-5,0,-5,0,0,0
ABCA13,Abca13,3,2,5,0,0,0
ABCA2,Abca2,1,-4,-3,0.796117,0,0
ABCA3,Abca3,7,5,12,35.300971,0,0
ABCA4,Abca4,1,1,2,10.932039,0,0
ABCA5,Abca5,6,-1,5,7.300971,0,0
ABCA6,Abca6,1,5,6,0,0,0
ABCA7,Abca7,4,-5,-1,1.145631,0,0
ABCA9,Abca9,2,-1,1,0,0,0
ABCB10,Abcb10,-1,-5,-6,8.834951,0,0
ABCB11,Abcb11,11,-8,3,0,0,0
ABCB4,Abcb4,26,2,28,0,0,0
ABCB5,Abcb5,-2,0,-2,1.029126,0,0
ABCB6,Abcb6,0,1,1,3.087379,0,0
ABCB7,Abcb7,3,0,3,2.805825,0,0
ABCB8,Abcb8,10,6,16,3.621359,0,0
ABCB9,Abcb9,-4,2,-2,36.61165,0,0
ABCC1,Abcc1,8,1,9,2.223301,0,0
ABCC10,Abcc10,-9,-3,-12,1.349515,0,0
ABCC12,Abcc12,8,-10,-2,6.339806,0,0
ABCC2,Abcc2,9,-4,5,0,0,0
ABCC3,Abcc3,8,-15,-7,5.019417,3.75,0
ABCC4,Abcc4,3,-1,2,1.912621,0,0
ABCC5,Abcc5,7,2,9,44.728155,16.708333,0
ABCC6,Abcc6,-10,-1,-11,0,0,0
ABCC8,Abcc8,9,3,12,0,0,0
ABCC9,Abcc9,3,-1,2,0,0,0
ABCD1,Abcd1,1,-6,-5,52.300971,0,0
ABCD2,Abcd2,1,-1,0,0,0,0
ABCD3,Abcd3,5,-3,2,7.213592,0,0
ABCD4,Abcd4,8,-4,4,10.271845,0,0
ABCE1,Abce1,3,-2,1,6.194175,0,0
ABCF1,Abcf1,7,-8,-1,11.427184,0,0
ABCF2,Abcf2,3,-6,-3,9.737864,0,0
ABCF3,Abcf3,7,-5,2,4.145631,0,0
ABCG1,Abcg1,2,2,4,0,0,0
ABCG2,Abcg2,2,0,2,0,0,0
ABCG4,Abcg4,3,5,8,0,0,0
ABCG5,Abcg5,4,-2,2,0,0,0
ABCG8,Abcg8,2,-6,-4,0,0,0
ABHD1,Abhd1,4,-6,-2,3.194175,0,0
ABHD10,Abhd10,-1,-4,-5,0,0,0
ABHD11,Abhd11,7,-3,4,0,0,0
ABHD12,Abhd12,4,-7,-3,2.116505,0,0
ABHD12B,Abhd12b,-3,4,1,0,0,0
ABHD13,Abhd13,0,-1,-1,4.330097,0,0
ABHD14A,Abhd14a,10,-10,0,7.281553,0,0
ABHD14B,Abhd14b,-2,-3,-5,7.281553,0,0
ABHD15,Abhd15,3,-5,-2,3.106796,0,0
ABHD16A,Abhd16a,9,-3,6,4.961165,0,0
ABHD16B,Abhd16b,27,-1,26,140.76699,23.416667,0
ABHD17A,Abhd17a,4,-6,-2,0,0,0
ABHD17B,Abhd17b,14,-4,10,2.543689,0,0
ABHD17C,Abhd17c,2,0,2,1.262136,0,0
ABHD18,Abhd18,-1,-2,-3,4.398058,0,0
ABHD2,Abhd2,4,-3,1,6.805825,0,0
ABHD3,Abhd3,47,10,57,348.514563,166.583333,0
ABHD4,Abhd4,9,-1,8,1.368932,0,0
ABHD5,Abhd5,9,-5,4,11.68932,0,0
ABHD6,Abhd6,1,-9,-8,4.252427,0,0
ABHD8,Abhd8,-2,-3,-5,12.932039,0,0
ABI1,Abi1,8,-3,5,4.854369,0,0
ABI2,Abi2,7,-3,4,77.252427,0,0
ABI3,Abi3,10,-3,7,0,0,0
ABI3BP,Abi3bp,5,0,5,0,0,0
ABITRAM,Abitram,10,-4,6,50.194175,0,0
ABL1,Abl1,10,-4,6,9.427184,0,0
ABL2,Abl2,9,-3,6,1.048544,0,0
ABLIM1,Ablim1,0,-4,-4,0,0,0
ABLIM2,Ablim2,4,5,9,2.446602,0,0
ABLIM3,Ablim3,8,-1,7,15.271845,0,0
ABO,Abo,-7,-5,-12,1.174757,0,0
ABR,Abr,7,-3,4,2.679612,0,0
ABRA,Abra,13,-1,12,0,0,0
ABRACL,Abracl,-2,-2,-4,1.747573,0,0
ABRAXAS1,Abraxas1,1,-10,-9,5.407767,0,0
ABRAXAS2,Abraxas2,2,-3,-1,4.533981,0,0
ABT1,Abt1,-2,-4,-6,11.067961,0,0
ABTB1,Abtb1,1,-6,-5,2.223301,0,0
ABTB2,Abtb2,34,3,37,0,0,0
ACAA2,Acaa2,4,-8,-4,0,0,0
ACACA,Acaca,7,-5,2,6.796117,0,0
ACACB,Acacb,0,-5,-5,1.796117,0,0
ACAD10,Acad10,11,-2,9,48.728155,0,0
ACAD11,Acad11,3,1,4,5.417476,0,0
ACAD8,Acad8,6,-2,4,5.951456,0,0
ACAD9,Acad9,5,-7,-2,15.446602,0,0
ACADL,Acadl,6,1,7,0,0,0
ACADM,Acadm,4,-3,1,8.883495,0,0
ACADS,Acads,5,2,7,14.126214,0,0
ACADSB,Acadsb,0,-3,-3,1.912621,0,0
ACADVL,Acadvl,5,0,5,20.543689,0,0
ACAN,Acan,-3,3,0,0,0,0
ACAP1,Acap1,12,0,12,6.349515,0,0
ACAP2,Acap2,3,-5,-2,126.84466,0,0
ACAP3,Acap3,9,-5,4,3.038835,0,0
ACAT1,Acat1,6,-6,0,4.563107,0,0
ACAT2,Acat2,-2,-2,-4,4.174757,0,0
ACBD3,Acbd3,5,-3,2,23.776699,0,0
ACBD4,Acbd4,3,-1,2,0,0,0
ACBD5,Acbd5,5,-7,-2,5.165049,0,0
ACBD6,Acbd6,5,-5,0,13.23301,0,0
ACBD7,Acbd7,4,13,17,0.84466,0,0
ACCS,Accs,-19,-6,-25,1.436893,0,0
ACCSL,Accsl,-3,-10,-13,0,0,0
ACD,Acd,-2,-3,-5,2.864078,0,0
ACE,Ace,8,1,9,0,0,0
ACE2,Ace2,6,4,10,0,0,0
ACER1,Acer1,5,-2,3,0,0,0
ACER2,Acer2,16,0,16,92.76699,0,0
ACER3,Acer3,3,0,3,3.23301,0,0
ACHE,Ache,33,1,34,32.601942,0,0
ACIN1,Acin1,9,-4,5,34.116505,0,0
ACKR1,Ackr1,2,-3,-1,0,0,0
ACKR2,Ackr2,-4,-7,-11,1.747573,0,0
ACKR3,Ackr3,-7,-4,-11,0,0,0
ACKR4,Ackr4,10,1,11,0,0,0
ACLY,Acly,5,-6,-1,2.485437,0,0
ACMSD,Acmsd,2,7,9,0,0,0
ACO1,Aco1,6,-4,2,2.854369,0,0
ACO2,Aco2,12,0,12,8.572816,0,0
ACOD1,Acod1,-1,0,-1,0,0,0
ACOT1,Acot1,1,2,3,0,0,0
ACOT11,Acot11,-2,-1,-3,0,0,0
ACOT12,Acot12,-3,4,1,3.019417,0,0
ACOT13,Acot13,4,1,5,33.757282,0,0
ACOT2,Acot2,1,1,2,3.203883,0,0
ACOT4,Acot4,4,-3,1,0,0,0
ACOT6,Acot6,3,-3,0,0,0,0
ACOT7,Acot7,9,-3,6,143.650485,52.791667,0
ACOT8,Acot8,7,0,7,1.61165,0,0
ACOT9,Acot9,1,-8,-7,2.932039,0,0
ACOX1,Acox1,11,0,11,4.970874,0,0
ACOX2,Acox2,4,-8,-4,0,0,0
ACOX3,Acox3,11,-2,9,57.912621,0,0
ACOXL,Acoxl,1,6,7,8.281553,0,0
ACP1,Acp1,9,-6,3,6.980583,0,0
ACP2,Acp2,5,-5,0,15.262136,0,0
ACP4,Acp4,-1,-12,-13,26.864078,0,0
ACP5,Acp5,2,1,3,0,0,0
ACP6,Acp6,-8,-3,-11,3.718447,0,0
ACP7,Acp7,2,3,5,6.553398,0,0
ACR,Acr,31,-10,21,4.631068,0,0
ACRBP,Acrbp,50,-9,41,0,0,0
ACRV1,Acrv1,3,-3,0,0,0,0
ACSBG1,Acsbg1,38,-2,36,0,0,0
ACSBG2,Acsbg2,16,2,18,7.786408,0,0
ACSF2,Acsf2,10,-2,8,3.825243,0,0
ACSF3,Acsf3,-4,-2,-6,23.456311,0,0
ACSL1,Acsl1,0,-8,-8,7.640777,0,0
ACSL3,Acsl3,7,0,7,4.883495,0,0
ACSL4,Acsl4,6,3,9,4.747573,0,0
ACSL5,Acsl5,2,-7,-5,0,0,0
ACSL6,Acsl6,0,-8,-8,0,0,0
ACSM1,Acsm1,14,1,15,0,0,0
ACSM3,Acsm3,2,-7,-5,0,0,0
ACSM4,Acsm4,1,-13,-12,0,0,0
ACSM5,Acsm5,-4,-1,-5,0,0,0
ACSS1,Acss1,3,4,7,0,0,0
ACSS2,Acss2,7,-3,4,3.621359,0,0
ACSS3,Acss3,-7,5,-2,1,0,0
ACTA1,Acta1,48,27,75,0,0,0
ACTA2,Acta2,7,-1,6,0,0,0
ACTB,Actb,11,-2,9,12.825243,0,0
ACTBL2,Actbl2,15,0,15,0,0,0
ACTC1,Actc1,11,16,27,0,0,0
ACTG1,Actg1,7,-2,5,0,0,0
ACTG2,Actg2,12,2,14,1.087379,0,0
ACTL10,Actl10,-6,-6,-12,2.92233,0,0
ACTL6A,Actl6a,4,0,4,4.825243,0,0
ACTL6B,Actl6b,0,3,3,0,0,0
ACTL7A,Actl7a,2,0,2,9.145631,0,0
ACTL7B,Actl7b,25,6,31,9.145631,0,0
ACTL9,Actl9,-1,-11,-12,0,0,0
ACTN1,Actn1,7,0,7,5.300971,0,0
ACTN2,Actn2,10,-6,4,0,0,0
ACTN3,Actn3,22,-3,19,4.126214,0,0
ACTN4,Actn4,7,-5,2,1.436893,0,0
ACTR10,Actr10,4,-8,-4,7.92233,0,0
ACTR1A,Actr1a,4,-4,0,2.84466,0,0
ACTR1B,Actr1b,-1,-5,-6,7.660194,0,0
ACTR2,Actr2,8,-2,6,3.631068,0,0
ACTR3,Actr3,7,-1,6,19.359223,0,0
ACTR3B,Actr3b,-5,-6,-11,17.485437,0,0
ACTR5,Actr5,-3,-2,-5,5.135922,0,0
ACTR6,Actr6,1,-11,-10,13.601942,0,0
ACTR8,Actr8,9,-6,3,5.68932,0,0
ACTRT1,Actrt1,0,0,0,0,0,0
ACTRT2,Actrt2,3,1,4,0,0,0
ACTRT3,Actrt3,126,-9,117,48.058252,0,0
ACVR1,Acvr1,-5,1,-4,3.640777,0,0
ACVR1B,Acvr1b,8,-7,1,13.330097,0,0
ACVR1C,Acvr1c,6,5,11,7.009709,0,0
ACVR2A,Acvr2a,7,-1,6,4.679612,0,0
ACVR2B,Acvr2b,5,-2,3,0,0,0
ACVRL1,Acvrl1,2,-5,-3,0,0,0
ACY1,Acy1,0,-6,-6,5,0,0
ACY3,Acy3,-2,-1,-3,0,0,0
ACYP1,Acyp1,4,-10,-6,3.747573,0,107
ACYP2,Acyp2,5,-6,-1,11.252427,3.333333,0
ADA,Ada,2,-4,-2,4.640777,0,0
ADAD1,Adad1,6,-3,3,0,0,0
ADAD2,Adad2,-1,1,0,5.485437,0,0
ADAL,Adal,6,-3,3,10.92233,0,0
ADAM10,Adam10,6,-5,1,1.815534,0,0
ADAM11,Adam11,7,0,7,0.873786,0,0
ADAM12,Adam12,-3,-5,-8,1.330097,0,0
ADAM15,Adam15,9,-4,5,5.883495,0,0
ADAM17,Adam17,9,-1,8,12.864078,0,0
ADAM18,Adam18,3,-4,-1,0,0,0
ADAM19,Adam19,-4,-10,-14,10.68932,4.291667,0
ADAM2,Adam2,0,-5,-5,0,0,0
ADAM20,Adam20,30,-7,23,0,0,0
ADAM21,Adam21,1,-7,-6,0,0,0
ADAM22,Adam22,0,-13,-13,7.320388,0,0
ADAM23,Adam23,1,0,1,0.902913,0,0
ADAM28,Adam28,-4,-4,-8,0,0,0
ADAM29,Adam29,2,-5,-3,0,0,0
ADAM30,Adam30,13,12,25,0,0,0
ADAM32,Adam32,25,-19,6,0,0,0
ADAM33,Adam33,0,2,2,0,0,0
ADAM7,Adam7,0,1,1,0,0,0
ADAM8,Adam8,4,1,5,0,0,0
ADAM9,Adam9,7,3,10,8.815534,0,0
ADAMDEC1,Adamdec1,0,-3,-3,0,0,0
ADAMTS1,Adamts1,1,9,10,0,0,0
ADAMTS10,Adamts10,4,-9,-5,0,0,0
ADAMTS12,Adamts12,-2,-1,-3,1.029126,0,0
ADAMTS13,Adamts13,9,6,15,14.456311,0,0
ADAMTS14,Adamts14,-6,3,-3,0,0,0
ADAMTS15,Adamts15,2,-1,1,3.174757,0,0
ADAMTS16,Adamts16,-4,1,-3,1.359223,0,0
ADAMTS17,Adamts17,2,-4,-2,0,0,0
ADAMTS18,Adamts18,3,1,4,0,0,0
ADAMTS19,Adamts19,4,-1,3,0.902913,0,0
ADAMTS2,Adamts2,-6,-3,-9,0,0,0
ADAMTS20,Adamts20,-3,-5,-8,0,0,0
ADAMTS3,Adamts3,4,5,9,3.990291,0,0
ADAMTS4,Adamts4,0,4,4,1.621359,0,0
ADAMTS5,Adamts5,-1,-7,-8,0,0,0
ADAMTS6,Adamts6,0,-5,-5,0,0,0
ADAMTS7,Adamts7,4,-2,2,0.660194,0,0
ADAMTS8,Adamts8,1,2,3,0,0,0
ADAMTS9,Adamts9,15,2,17,1.38835,0,0
ADAMTSL1,Adamtsl1,-3,0,-3,0,0,0
ADAMTSL2,Adamtsl2,5,8,13,0,0,0
ADAMTSL3,Adamtsl3,1,-1,0,0.737864,0,0
ADAMTSL4,Adamtsl4,10,-3,7,1.951456,0,0
ADAMTSL5,Adamtsl5,8,-11,-3,0,0,0
ADAP1,Adap1,22,-9,13,13.320388,0,0
ADAP2,Adap2,8,2,10,0,0,0
ADAR,Adar,7,-3,4,5.07767,0,0
ADARB1,Adarb1,1,-2,-1,0.92233,0,0
ADARB2,Adarb2,-3,-7,-10,0,0,0
ADAT1,Adat1,-4,-3,-7,6.436893,0,0
ADAT2,Adat2,1,-15,-14,46.194175,0,0
ADAT3,Adat3,1,-8,-7,8.378641,0,0
ADCK1,Adck1,8,-5,3,9.990291,0,0
ADCK2,Adck2,5,0,5,23.970874,0,0
ADCK5,Adck5,3,-8,-5,80.097087,75.166667,0
ADCY1,Adcy1,4,-3,1,0,0,0
ADCY10,Adcy10,97,-1,96,0,0,0
ADCY2,Adcy2,1,-1,0,6.339806,0,0
ADCY3,Adcy3,1,-3,-2,2.699029,0,0
ADCY4,Adcy4,3,-2,1,0,0,0
ADCY5,Adcy5,8,-3,5,5.825243,0,0
ADCY6,Adcy6,4,-8,-4,0,0,0
ADCY7,Adcy7,10,-8,2,11.631068,0,0
ADCY8,Adcy8,-4,-1,-5,0,0,0
ADCY9,Adcy9,7,1,8,0,0,0
ADCYAP1,Adcyap1,-1,-1,-2,0,0,0
ADCYAP1R1,Adcyap1r1,3,-1,2,0,0,0
ADD1,Add1,7,-4,3,6.349515,0,0
ADD2,Add2,5,-4,1,0,0,0
ADD3,Add3,7,-9,-2,0.873786,0,0
ADGB,Adgb,6,-10,-4,1.631068,0,0
ADGRA1,Adgra1,2,-5,-3,5.339806,0,0
ADGRA2,Adgra2,2,1,3,2.145631,0,0
ADGRA3,Adgra3,3,4,7,11.912621,0,0
ADGRB1,Adgrb1,6,-1,5,2.524272,0,0
ADGRB2,Adgrb2,6,3,9,17.407767,0,0
ADGRB3,Adgrb3,5,-5,0,3.825243,0,0
ADGRD1,Adgrd1,1,3,4,6.165049,0,0
ADGRE1,Adgre1,1,-4,-3,0,0,0
ADGRE5,Adgre5,-6,4,-2,5.145631,0,0
ADGRF1,Adgrf1,-15,6,-9,0,0,0
ADGRF2,Adgrf2,2,6,8,0,0,0
ADGRF3,Adgrf3,36,-17,19,9.970874,0,0
ADGRF4,Adgrf4,3,4,7,12.135922,0,0
ADGRF5,Adgrf5,1,-1,0,0,0,0
ADGRG1,Adgrg1,6,6,12,16.126214,0,0
ADGRG2,Adgrg2,-1,5,4,1.165049,0,0
ADGRG3,Adgrg3,-5,2,-3,0,0,0
ADGRG4,Adgrg4,0,3,3,0,0,0
ADGRG5,Adgrg5,5,-6,-1,0.834951,0,0
ADGRG6,Adgrg6,13,-2,11,44.650485,0,0
ADGRG7,Adgrg7,2,5,7,0,0,0
ADGRL1,Adgrl1,10,0,10,38.485437,0,0
ADGRL2,Adgrl2,25,-5,20,16.883495,0,0
ADGRL3,Adgrl3,3,-11,-8,2.106796,0,0
ADGRL4,Adgrl4,0,-1,-1,0,0,0
ADGRV1,Adgrv1,15,0,15,0,0,0
ADH4,Adh4,7,0,7,0,0,0
ADH5,Adh5,0,5,5,3.757282,0,0
ADH7,Adh7,-1,-5,-6,0,0,0
ADHFE1,Adhfe1,19,3,22,6.757282,0,0
ADI1,Adi1,3,-1,2,16.048544,0,0
ADIG,Adig,29,13,42,0,0,0
ADIPOQ,Adipoq,3,3,6,0,0,0
ADIPOR1,Adipor1,8,-2,6,5.048544,0,0
ADIPOR2,Adipor2,9,-1,8,7.359223,0,0
ADK,Adk,7,-4,3,45.145631,28.041667,0
ADM,Adm,11,4,15,6.223301,0,0
ADM2,Adm2,5,12,17,0,0,0
ADNP,Adnp,6,-7,-1,7.029126,0,0
ADNP2,Adnp2,7,-3,4,6.427184,0,0
ADO,Ado,2,3,5,26.436893,5.125,0
ADORA1,Adora1,-1,1,0,0,0,0
ADORA2A,Adora2a,57,17,74,0,0,0
ADORA2B,Adora2b,-2,5,3,6.737864,0,0
ADORA3,Adora3,8,-6,2,0,0,0
ADPGK,Adpgk,2,2,4,14.271845,0,0
ADPRH,Adprh,4,-6,-2,4.087379,0,0
ADPRHL1,Adprhl1,13,-11,2,1.407767,0,0
ADPRM,Adprm,-9,-8,-17,5.553398,0,0
ADPRS,Adprs,-20,1,-19,18.31068,0,0
ADRA1A,Adra1a,2,3,5,0,0,0
ADRA1B,Adra1b,10,-3,7,6.660194,0,0
ADRA1D,Adra1d,-1,-5,-6,0,0,0
ADRA2A,Adra2a,6,8,14,0,0,0
ADRA2B,Adra2b,26,5,31,1.126214,0,0
ADRA2C,Adra2c,12,-5,7,4.621359,0,0
ADRB1,Adrb1,5,1,6,0,0,0
ADRB2,Adrb2,9,-3,6,15.84466,0,0
ADRB3,Adrb3,0,-4,-4,0,0,0
ADRM1,Adrm1,4,-4,0,12.951456,0,0
ADSL,Adsl,1,0,1,3.951456,0,0
ADTRP,Adtrp,0,-8,-8,0,0,0
AEBP1,Aebp1,16,3,19,9.106796,0,0
AEBP2,Aebp2,5,-2,3,10.300971,0,0
AEN,Aen,-13,6,-7,2.699029,0,0
AFAP1,Afap1,-11,-3,-14,2.436893,0,0
AFAP1L1,Afap1l1,12,1,13,14.737864,0,0
AFAP1L2,Afap1l2,-4,2,-2,0,0,0
AFDN,Afdn,8,-4,4,0,0,0
AFF1,Aff1,13,3,16,17.601942,0,0
AFF2,Aff2,7,-3,4,0,0,0
AFF3,Aff3,5,1,6,9.941748,0,0
AFF4,Aff4,12,0,12,4.203883,0,0
AFG1L,Afg1l,2,-5,-3,4.660194,0,0
AFG3L2,Afg3l2,3,-4,-1,7.679612,0,0
AFM,Afm,4,-6,-2,0,0,0
AFMID,Afmid,6,-2,4,0,0,0
AFP,Afp,1,-9,-8,6.728155,0,0
AFTPH,Aftph,8,0,8,6.466019,3.5,0
AGA,Aga,-9,-7,-16,5.407767,0,0
AGAP1,Agap1,9,0,9,4.048544,0,0
AGAP2,Agap2,6,4,10,0,0,0
AGAP3,Agap3,3,0,3,2.223301,0,0
AGBL1,Agbl1,1,-2,-1,0,0,0
AGBL2,Agbl2,20,-7,13,3.679612,0,0
AGBL3,Agbl3,2,-8,-6,14.941748,0,0
AGBL4,Agbl4,0,-9,-9,0,0,0
AGBL5,Agbl5,8,-8,0,0,0,0
AGER,Ager,5,-9,-4,0,0,0
AGFG1,Agfg1,4,-1,3,6.427184,0,0
AGFG2,Agfg2,-18,1,-17,1.106796,0,0
AGGF1,Aggf1,6,1,7,0,0,0
AGK,Agk,-1,-7,-8,24.15534,0,0
AGL,Agl,1,-6,-5,9.242718,0,0
AGMAT,Agmat,4,1,5,0.728155,0,0
AGMO,Agmo,3,4,7,0,0,0
AGO1,Ago1,8,-4,4,8.174757,0,0
AGO2,Ago2,10,-3,7,7.281553,0,0
AGO3,Ago3,3,-6,-3,10.951456,0,0
AGO4,Ago4,-1,1,0,4.563107,0,0
AGPAT1,Agpat1,13,0,13,2.15534,0,0
AGPAT2,Agpat2,-7,-5,-12,4.427184,0,0
AGPAT3,Agpat3,7,-7,0,4.456311,0,0
AGPAT4,Agpat4,3,2,5,0,0,0
AGPAT5,Agpat5,1,-7,-6,15.786408,0,0
AGPS,Agps,5,-3,2,9.009709,0,0
AGR2,Agr2,6,2,8,0,0,0
AGR3,Agr3,14,-7,7,26.058252,0,0
AGRN,Agrn,3,-2,1,10.796117,0,0
AGRP,Agrp,3,1,4,13.524272,0,0
AGT,Agt,12,2,14,8.116505,0,0
AGTPBP1,Agtpbp1,5,-12,-7,7.92233,0,0
AGTR2,Agtr2,1,-2,-1,0,0,0
AGTRAP,Agtrap,1,-3,-2,101.68932,0,0
AGXT,Agxt,5,-1,4,0,0,0
AGXT2,Agxt2,4,5,9,0,0,0
AHCTF1,Ahctf1,6,-7,-1,50.135922,0,0
AHCY,Ahcy,9,-14,-5,16.533981,0,0
AHCYL1,Ahcyl1,8,-2,6,8.640777,0,0
AHCYL2,Ahcyl2,10,-2,8,8.776699,0,0
AHDC1,Ahdc1,6,3,9,2.174757,0,0
AHI1,Ahi1,3,-10,-7,80.262136,0,0
AHNAK,Ahnak,14,-3,11,2.475728,0,0
AHR,Ahr,0,2,2,4.349515,0,0
AHRR,Ahrr,-11,-7,-18,0.854369,0,0
AHSA1,Ahsa1,47,2,49,340.038835,184.5,0
AHSG,Ahsg,8,0,8,2.815534,0,0
AICDA,Aicda,1,-1,0,9.07767,0,0
AIDA,Aida,10,-4,6,7.368932,0,0
AIF1,Aif1,13,-6,7,9.087379,0,0
AIF1L,Aif1l,1,-1,0,1,0,0
AIFM1,Aifm1,4,0,4,1.038835,0,0
AIFM2,Aifm2,3,-11,-8,6.699029,0,0
AIFM3,Aifm3,6,-2,4,0,0,0
AIG1,Aig1,3,1,4,18.912621,0,0
AIM2,Aim2,-6,-10,-16,0.893204,0,0
AIMP1,Aimp1,1,-2,-1,0,0,0
AIMP2,Aimp2,1,-9,-8,10.252427,0,0
AIP,Aip,5,-1,4,0,0,0
AIPL1,Aipl1,-2,-5,-7,0,0,0
AIRE,Aire,5,-11,-6,0,0,0
AJAP1,Ajap1,-2,-2,-4,0,0,0
AJM1,Ajm1,10,6,16,29.543689,0,0
AJUBA,Ajuba,1,-2,-1,5.805825,0,0
AK1,Ak1,6,-4,2,3.495146,0,0
AK2,Ak2,5,-1,4,2.300971,0,0
AK3,Ak3,3,-2,1,5.019417,0,0
AK4,Ak4,7,1,8,3.553398,0,0
AK5,Ak5,16,-6,10,3.660194,0,0
AK6,Ak6,6,-6,0,12.135922,0,0
AK7,Ak7,2,4,6,7.699029,0,0
AK8,Ak8,-9,-2,-11,34.048544,0,0
AK9,Ak9,0,-5,-5,8.029126,0,0
AKAIN1,Akain1,7,2,9,0,0,0
AKAP1,Akap1,-5,-5,-10,13.582524,0,0
AKAP10,Akap10,5,-4,1,6.864078,0,0
AKAP11,Akap11,5,-5,0,9.048544,0,0
AKAP12,Akap12,9,5,14,2.417476,0,0
AKAP13,Akap13,5,4,9,9.786408,0,0
AKAP14,Akap14,34,-8,26,0,0,0
AKAP3,Akap3,4,-4,0,1.970874,0,0
AKAP4,Akap4,-2,1,-1,0,0,0
AKAP5,Akap5,3,-4,-1,6.737864,0,0
AKAP6,Akap6,7,-1,6,0,0,0
AKAP7,Akap7,-2,-10,-12,10.252427,0,0
AKAP8,Akap8,5,-1,4,8.864078,0,0
AKAP8L,Akap8l,11,-1,10,0,0,0
AKAP9,Akap9,6,-2,4,5.912621,0,0
AKIP1,Akip1,1,-3,-2,0,0,0
AKIRIN1,Akirin1,5,-3,2,20.941748,0,0
AKIRIN2,Akirin2,6,4,10,3.660194,0,0
AKNA,Akna,-4,-10,-14,15.300971,0,0
AKNAD1,Aknad1,1,-13,-12,0,0,0
AKR1A1,Akr1a1,5,-2,3,4.504854,0,0
AKR1B10,Akr1b10,4,4,8,1.320388,0,0
AKR1D1,Akr1d1,5,5,10,2.398058,0,0
AKT1,Akt1,13,-3,10,0.737864,0,0
AKT1S1,Akt1s1,6,1,7,2.203883,0,0
AKT2,Akt2,11,-1,10,2.970874,0,0
AKT3,Akt3,11,0,11,0,0,0
AKTIP,Aktip,9,-5,4,4.427184,0,0
ALAD,Alad,3,-5,-2,6.126214,0,0
ALAS1,Alas1,4,-7,-3,8.271845,0,0
ALAS2,Alas2,1,-1,0,0,0,0
ALB,Alb,3,6,9,0,0,0
ALCAM,Alcam,5,5,10,7.553398,0,0
ALDH16A1,Aldh16a1,2,-5,-3,0,0,0
ALDH18A1,Aldh18a1,7,1,8,3.242718,0,0
ALDH1A1,Aldh1a1,2,6,8,0,0,0
ALDH1A2,Aldh1a2,5,6,11,35.825243,30.083333,0
ALDH1A3,Aldh1a3,2,8,10,4.747573,0,0
ALDH1B1,Aldh1b1,-18,-3,-21,0.61165,0,0
ALDH1L1,Aldh1l1,9,1,10,1.281553,0,0
ALDH1L2,Aldh1l2,2,0,2,0,0,0
ALDH2,Aldh2,7,0,7,4.854369,0,0
ALDH3A1,Aldh3a1,16,-1,15,4.495146,0,0
ALDH3A2,Aldh3a2,6,-2,4,3.446602,0,0
ALDH3B1,Aldh3b1,7,-4,3,114.864078,25.375,0
ALDH3B2,Aldh3b2,-2,8,6,2.757282,0,0
ALDH4A1,Aldh4a1,0,1,1,2.941748,0,0
ALDH5A1,Aldh5a1,6,5,11,6.990291,0,0
ALDH6A1,Aldh6a1,3,-5,-2,0.68932,0,0
ALDH7A1,Aldh7a1,9,-5,4,2.427184,0,0
ALDH8A1,Aldh8a1,57,6,63,0,0,0
ALDH9A1,Aldh9a1,6,-3,3,3.941748,0,0
ALDOA,Aldoa,8,-3,5,11.854369,0,0
ALDOB,Aldob,13,1,14,0,0,0
ALDOC,Aldoc,21,-6,15,2.912621,0,0
ALG1,Alg1,6,-10,-4,6.466019,0,0
ALG10B,Alg10b,1,-2,-1,12.572816,0,0
ALG11,Alg11,5,-1,4,0,0,0
ALG12,Alg12,3,-4,-1,0,0,0
ALG13,Alg13,6,-6,0,1.203883,0,0
ALG14,Alg14,4,-5,-1,0.873786,0,0
ALG2,Alg2,3,-2,1,4.708738,0,0
ALG3,Alg3,4,-12,-8,13.893204,0,0
ALG5,Alg5,5,-10,-5,9,0,0
ALG6,Alg6,0,-7,-7,4.213592,0,0
ALG8,Alg8,5,-8,-3,9.38835,0,0
ALG9,Alg9,4,-4,0,6.466019,0,0
ALK,Alk,20,-2,18,5.194175,0,0
ALKAL1,Alkal1,7,0,7,0,0,0
ALKAL2,Alkal2,-1,1,0,0,0,0
ALKBH1,Alkbh1,8,3,11,16.572816,0,0
ALKBH2,Alkbh2,-5,4,-1,6.825243,0,0
ALKBH3,Alkbh3,10,-2,8,8.660194,0,0
ALKBH4,Alkbh4,-1,-2,-3,19.058252,0,0
ALKBH5,Alkbh5,10,2,12,1.058252,0,0
ALKBH6,Alkbh6,3,-2,1,16.951456,0,0
ALKBH7,Alkbh7,6,-1,5,3.359223,0,0
ALKBH8,Alkbh8,-1,2,1,0,0,0
ALLC,Allc,9,-1,8,0,0,0
ALMS1,Alms1,1,-5,-4,20.786408,0,0
ALOX12,Alox12,8,4,12,0,0,0
ALOX12B,Alox12b,2,0,2,18.854369,0,0
ALOX15,Alox15,9,3,12,12.009709,0,0
ALOX5,Alox5,-4,-4,-8,0,0,0
ALOX5AP,Alox5ap,16,3,19,0,0,0
ALOXE3,Aloxe3,100,2,102,56.864078,0,0
ALPI,Alpi,2,-3,-1,0,0,0
ALPK1,Alpk1,1,0,1,2.524272,0,0
ALPK2,Alpk2,-2,12,10,0.640777,0,0
ALPK3,Alpk3,16,0,16,1.543689,0,0
ALPL,Alpl,-2,9,7,0,0,0
ALS2,Als2,6,-11,-5,4.601942,0,0
ALS2CL,Als2cl,3,-5,-2,6.533981,0,0
ALX1,Alx1,0,-8,-8,0,0,0
ALX3,Alx3,-2,10,8,0,0,0
ALX4,Alx4,-6,0,-6,0,0,0
ALYREF,Alyref,8,-4,4,4.834951,0,0
AMACR,Amacr,-11,2,-9,10.300971,0,0
AMBN,Ambn,-3,0,-3,0,0,0
AMBP,Ambp,3,3,6,0,0,0
AMBRA1,Ambra1,6,-3,3,1.873786,0,0
AMD1,Amd1,2,-5,-3,3.31068,0,0
AMDHD1,Amdhd1,21,-4,17,1.009709,0,0
AMDHD2,Amdhd2,2,2,4,4.223301,0,0
AMELX,Amelx,-4,0,-4,0,0,0
AMER1,Amer1,-14,-5,-19,3.76699,0,0
AMER2,Amer2,3,-4,-1,0,0,0
AMER3,Amer3,2,-7,-5,0,0,0
AMFR,Amfr,15,0,15,4.68932,0,0
AMH,Amh,12,6,18,0,0,0
AMHR2,Amhr2,12,12,24,0,0,0
AMIGO1,Amigo1,0,-2,-2,0,0,0
AMIGO2,Amigo2,3,2,5,6.514563,0,0
AMIGO3,Amigo3,16,-3,13,20.582524,0,0
AMMECR1,Ammecr1,0,-3,-3,3.262136,0,0
AMMECR1L,Ammecr1l,7,-2,5,7.475728,3.625,0
AMN,Amn,0,-5,-5,0,0,0
AMN1,Amn1,1,-9,-8,7.747573,0,0
AMOT,Amot,5,0,5,0,0,0
AMOTL1,Amotl1,8,-6,2,12.223301,0,0
AMOTL2,Amotl2,11,8,19,4.61165,0,0
AMPD1,Ampd1,11,6,17,0,0,0
AMPD2,Ampd2,5,-5,0,30.456311,0,0
AMPD3,Ampd3,8,-6,2,0,0,0
AMPH,Amph,5,-4,1,0,0,0
AMT,Amt,5,-9,-4,0,0,0
AMTN,Amtn,-2,-1,-3,0,0,0
AMZ1,Amz1,-1,-6,-7,0,0,0
AMZ2,Amz2,9,-1,8,14.320388,0,0
ANAPC1,Anapc1,5,-5,0,3.368932,0,0
ANAPC10,Anapc10,1,-2,-1,6.194175,0,0
ANAPC11,Anapc11,7,-2,5,4.834951,0,0
ANAPC13,Anapc13,7,0,7,3.466019,0,0
ANAPC15,Anapc15,3,-1,2,5.592233,0,0
ANAPC16,Anapc16,3,0,3,105.776699,0,0
ANAPC2,Anapc2,5,1,6,13.592233,0,0
ANAPC4,Anapc4,2,-6,-4,3.718447,0,0
ANAPC5,Anapc5,8,-2,6,3.873786,0,0
ANAPC7,Anapc7,3,0,3,1.135922,0,0
ANG,Ang,19,-1,18,16.174757,0,0
ANGEL1,Angel1,2,-9,-7,81.407767,0,0
ANGEL2,Angel2,1,-9,-8,2.514563,0,0
ANGPT1,Angpt1,2,-5,-3,5.087379,0,0
ANGPT2,Angpt2,5,-1,4,0,0,0
ANGPT4,Angpt4,1,-4,-3,2.126214,0,0
ANGPTL1,Angptl1,-1,-3,-4,0,0,0
ANGPTL2,Angptl2,6,0,6,0,0,0
ANGPTL3,Angptl3,8,-3,5,0,0,0
ANGPTL4,Angptl4,4,12,16,3.320388,0,0
ANGPTL6,Angptl6,8,-1,7,111.68932,0,0
ANGPTL7,Angptl7,-4,-5,-9,0,0,0
ANGPTL8,Angptl8,-1,-2,-3,0.84466,0,0
ANK1,Ank1,3,-5,-2,0,0,0
ANK2,Ank2,11,-9,2,2.786408,0,0
ANK3,Ank3,0,2,2,6.718447,0,0
ANKAR,Ankar,13,-7,6,52.427184,0,0
ANKDD1A,Ankdd1a,9,1,10,0,0,0
ANKDD1B,Ankdd1b,25,-3,22,0,0,0
ANKEF1,Ankef1,2,-1,1,24.038835,0,0
ANKFN1,Ankfn1,-9,-8,-17,2.398058,0,0
ANKFY1,Ankfy1,-2,0,-2,14.281553,0,0
ANKHD1,Ankhd1,5,-1,4,2.893204,0,0
ANKIB1,Ankib1,4,-4,0,7.067961,0,0
ANKK1,Ankk1,-2,-4,-6,0,0,0
ANKLE1,Ankle1,6,-10,-4,0,0,0
ANKLE2,Ankle2,11,-3,8,11.660194,0,0
ANKMY1,Ankmy1,1,-8,-7,4.174757,0,0
ANKMY2,Ankmy2,9,0,9,8.572816,0,0
ANKRA2,Ankra2,1,-7,-6,0,0,0
ANKRD1,Ankrd1,24,8,32,0,0,0
ANKRD10,Ankrd10,15,-3,12,1.23301,0,0
ANKRD11,Ankrd11,7,0,7,0,0,0
ANKRD12,Ankrd12,11,-7,4,60.873786,0,0
ANKRD13A,Ankrd13a,8,-1,7,2.300971,0,0
ANKRD13B,Ankrd13b,2,1,3,13.339806,0,0
ANKRD13C,Ankrd13c,5,-4,1,3.776699,0,0
ANKRD13D,Ankrd13d,4,-5,-1,19.281553,0,0
ANKRD16,Ankrd16,4,-7,-3,6.669903,0,0
ANKRD17,Ankrd17,9,-5,4,10.912621,0,0
ANKRD2,Ankrd2,9,6,15,0,0,0
ANKRD22,Ankrd22,-2,-5,-7,0,0,0
ANKRD23,Ankrd23,-4,-6,-10,0,0,0
ANKRD24,Ankrd24,8,-6,2,12.485437,0,0
ANKRD26,Ankrd26,4,-2,2,3.514563,0,0
ANKRD27,Ankrd27,3,-13,-10,4.466019,0,0
ANKRD28,Ankrd28,5,-6,-1,6.572816,0,0
ANKRD29,Ankrd29,1,-8,-7,1.145631,0,0
ANKRD31,Ankrd31,-1,0,-1,5.291262,0,0
ANKRD33,Ankrd33,-2,1,-1,0,0,0
ANKRD33B,Ankrd33b,10,5,15,2.291262,0,0
ANKRD34A,Ankrd34a,9,2,11,0,0,0
ANKRD34B,Ankrd34b,16,4,20,0,0,0
ANKRD34C,Ankrd34c,0,0,0,0,0,0
ANKRD35,Ankrd35,4,4,8,0,0,0
ANKRD36,Ankrd36,4,-5,-1,10.242718,0,0
ANKRD37,Ankrd37,28,-10,18,55.330097,0,0
ANKRD39,Ankrd39,-8,-5,-13,3.970874,0,0
ANKRD40,Ankrd40,2,-6,-4,49.854369,0,0
ANKRD42,Ankrd42,13,-6,7,38.029126,0,0
ANKRD44,Ankrd44,4,-8,-4,2.679612,0,0
ANKRD45,Ankrd45,5,-4,1,0,0,0
ANKRD46,Ankrd46,6,-4,2,22.650485,7.916667,0
ANKRD49,Ankrd49,-4,-6,-10,2.456311,0,0
ANKRD50,Ankrd50,-1,-5,-6,3.990291,0,0
ANKRD52,Ankrd52,10,-6,4,7.436893,0,0
ANKRD53,Ankrd53,3,-6,-3,0,0,0
ANKRD54,Ankrd54,7,1,8,22.398058,0,0
ANKRD55,Ankrd55,5,-2,3,0,0,0
ANKRD6,Ankrd6,0,4,4,0,0,0
ANKRD60,Ankrd60,18,-2,16,0,0,0
ANKRD61,Ankrd61,12,-10,2,0,0,0
ANKRD63,Ankrd63,-11,0,-11,0,0,0
ANKRD65,Ankrd65,43,0,43,57.223301,0,0
ANKRD66,Ankrd66,2,-8,-6,1.23301,0,0
ANKRD7,Ankrd7,9,-8,1,0,0,0
ANKRD9,Ankrd9,8,-7,1,0.883495,0,0
ANKS1B,Anks1b,4,1,5,2.524272,0,0
ANKS3,Anks3,3,-4,-1,20.873786,0,0
ANKS4B,Anks4b,-1,-8,-9,0,0,0
ANKS6,Anks6,4,-2,2,11.864078,0,0
ANKUB1,Ankub1,3,-7,-4,0,0,0
ANKZF1,Ankzf1,-3,-4,-7,0,0,0
ANLN,Anln,9,-11,-2,126.805825,20.958333,0
ANO1,Ano1,14,-12,2,0,0,0
ANO10,Ano10,8,-5,3,21.291262,0,0
ANO2,Ano2,0,-1,-1,10.92233,0,0
ANO3,Ano3,-1,-2,-3,40.84466,0,0
ANO4,Ano4,3,6,9,3.058252,0,0
ANO5,Ano5,0,-7,-7,0,0,0
ANO6,Ano6,6,-1,5,2.417476,0,0
ANO7,Ano7,-2,-6,-8,7.650485,0,0
ANO8,Ano8,5,-7,-2,20.417476,0,0
ANO9,Ano9,-1,-3,-4,0,0,0
ANP32A,Anp32a,7,-3,4,0.990291,0,0
ANP32B,Anp32b,6,-1,5,18.76699,0,0
ANP32E,Anp32e,8,0,8,2.873786,0,0
ANPEP,Anpep,7,0,7,0,0,0
ANTKMT,Antkmt,5,-1,4,2.320388,0,0
ANTXR1,Antxr1,7,-1,6,1.116505,0,0
ANTXR2,Antxr2,12,-4,8,3.07767,0,0
ANTXRL,Antxrl,0,-2,-2,0.961165,0,0
ANXA1,Anxa1,14,-7,7,33.223301,0,0
ANXA10,Anxa10,-1,-2,-3,0,0,0
ANXA11,Anxa11,6,-1,5,24.330097,8.458333,0
ANXA13,Anxa13,3,2,5,0,0,0
ANXA2,Anxa2,1,-3,-2,16.951456,0,0
ANXA3,Anxa3,-11,0,-11,24.912621,0,0
ANXA4,Anxa4,-1,-1,-2,25.980583,0,0
ANXA5,Anxa5,9,3,12,6.970874,0,0
ANXA6,Anxa6,9,0,9,3.194175,0,0
ANXA7,Anxa7,3,-11,-8,25.563107,18.25,0
ANXA8,Anxa8,-6,-2,-8,6.728155,0,0
ANXA9,Anxa9,1,1,2,0,0,0
AOAH,Aoah,7,0,7,0,0,0
AOC1,Aoc1,-3,1,-2,0,0,0
AOC2,Aoc2,17,-2,15,0,0,0
AOC3,Aoc3,49,3,52,0,0,0
AOPEP,Aopep,3,-2,1,16,0,0
AOX1,Aox1,7,8,15,2.378641,0,0
AP1AR,Ap1ar,4,-3,1,3.757282,0,0
AP1B1,Ap1b1,6,-2,4,3.533981,0,0
AP1G1,Ap1g1,7,-3,4,6.572816,0,0
AP1G2,Ap1g2,4,-13,-9,2.271845,0,0
AP1M1,Ap1m1,6,-5,1,29.563107,3.041667,0
AP1M2,Ap1m2,6,-4,2,0,0,0
AP1S1,Ap1s1,13,-6,7,61.92233,0,0
AP1S2,Ap1s2,3,2,5,6.330097,0,0
AP1S3,Ap1s3,1,-8,-7,0,0,0
AP2A1,Ap2a1,3,1,4,13.252427,0,0
AP2A2,Ap2a2,8,-1,7,5.407767,0,0
AP2B1,Ap2b1,5,-1,4,1.126214,0,0
AP2M1,Ap2m1,9,0,9,9.407767,0,0
AP2S1,Ap2s1,6,-1,5,5.68932,0,0
AP3B1,Ap3b1,7,-1,6,11.68932,0,0
AP3B2,Ap3b2,7,5,12,0.669903,0,0
AP3D1,Ap3d1,10,-1,9,32.38835,0,0
AP3M1,Ap3m1,6,0,6,26.84466,23.541667,0
AP3M2,Ap3m2,-1,-5,-6,14.893204,0,0
AP3S1,Ap3s1,6,3,9,6.990291,0,0
AP3S2,Ap3s2,0,-8,-8,12.669903,0,0
AP4B1,Ap4b1,38,-11,27,107.524272,0,0
AP4E1,Ap4e1,4,1,5,60.485437,0,0
AP4M1,Ap4m1,1,-2,-1,21.796117,0,0
AP4S1,Ap4s1,5,-2,3,5.165049,0,0
AP5B1,Ap5b1,-8,-13,-21,3.84466,0,0
AP5M1,Ap5m1,8,-5,3,24.126214,4.208333,0
AP5S1,Ap5s1,1,-3,-2,10.339806,0,0
AP5Z1,Ap5z1,6,2,8,5.834951,0,0
APAF1,Apaf1,3,-2,1,4.553398,0,0
APBA1,Apba1,-1,-5,-6,1.417476,0,0
APBA2,Apba2,11,0,11,8.446602,0,0
APBA3,Apba3,9,-5,4,13.291262,0,0
APBB1,Apbb1,10,-4,6,1.242718,5.958333,0
APBB1IP,Apbb1ip,2,-6,-4,0,0,0
APBB2,Apbb2,3,4,7,4.834951,0,0
APBB3,Apbb3,0,-3,-3,0,0,0
APC,Apc,5,-1,4,6.572816,0,0
APC2,Apc2,14,-5,9,0,0,0
APCDD1,Apcdd1,-3,-5,-8,0,0,0
APCS,Apcs,1,-2,-1,0,0,0
APEH,Apeh,2,0,2,4.262136,0,0
APELA,Apela,6,2,8,0,0,0
APEX1,Apex1,6,2,8,5.058252,0,0
APEX2,Apex2,-1,-3,-4,0,0,0
APH1A,Aph1a,4,0,4,7.31068,0,0
APH1B,Aph1b,0,-1,-1,0,0,0
API5,Api5,7,-3,4,8.475728,0,0
APIP,Apip,8,-10,-2,8.553398,0,0
APLF,Aplf,-1,-4,-5,6.524272,0,0
APLN,Apln,-9,-1,-10,1.126214,0,0
APLNR,Aplnr,8,-1,7,0,0,0
APLP1,Aplp1,9,7,16,0,0,0
APLP2,Aplp2,10,-7,3,9.339806,0,0
APMAP,Apmap,6,4,10,4.300971,0,0
APOA1,Apoa1,19,13,32,7.203883,0,0
APOA2,Apoa2,-1,-17,-18,0,0,0
APOA4,Apoa4,4,11,15,0,0,0
APOA5,Apoa5,2,0,2,3.854369,0,0
APOB,Apob,2,4,6,3.941748,0,0
APOBEC1,Apobec1,-5,-4,-9,0,0,0
APOBEC2,Apobec2,-5,-4,-9,3.184466,0,0
APOBEC4,Apobec4,1,-8,-7,0,0,0
APOBR,Apobr,1,-2,-1,13.067961,0,0
APOC1,Apoc1,23,15,38,0,0,0
APOC2,Apoc2,18,-2,16,0,0,0
APOC3,Apoc3,-2,15,13,0,0,0
APOC4,Apoc4,13,7,20,0,0,0
APOD,Apod,11,6,17,0,0,0
APOE,Apoe,44,7,51,0,0,0
APOF,Apof,10,-4,6,63.718447,0,0
APOH,Apoh,17,4,21,1.796117,0,0
APOL6,Apol6,0,4,4,0,0,0
APOLD1,Apold1,0,5,5,22.223301,0,0
APOM,Apom,-16,-10,-26,7.466019,0,0
APOO,Apoo,6,-2,4,0,0,0
APOOL,Apool,2,-5,-3,1.320388,0,0
APP,App,10,-2,8,99.708738,0,0
APPBP2,Appbp2,-1,-3,-4,11.456311,0,0
APPL1,Appl1,5,-6,-1,6.902913,0,0
APPL2,Appl2,7,2,9,11.76699,3.958333,0
APRT,Aprt,8,-6,2,8.970874,0,0
APTX,Aptx,14,-7,7,476.728155,269.166667,218
AQP1,Aqp1,17,-5,12,0,0,0
AQP11,Aqp11,-1,1,0,6.07767,4,0
AQP2,Aqp2,5,4,9,0,0,0
AQP3,Aqp3,30,1,31,0.941748,0,0
AQP4,Aqp4,7,4,11,2.23301,0,0
AQP5,Aqp5,-2,12,10,0,0,0
AQP6,Aqp6,2,-1,1,0,0,0
AQP7,Aqp7,3,-11,-8,1.087379,0,0
AQP8,Aqp8,26,8,34,0,0,0
AQP9,Aqp9,0,-7,-7,0,0,0
AQR,Aqr,1,-5,-4,14.262136,0,0
AR,Ar,16,5,21,1.436893,0,0
ARAF,Araf,6,-3,3,2.466019,0,0
ARAP1,Arap1,8,-1,7,2.737864,0,0
ARAP2,Arap2,7,1,8,2.883495,0,0
ARAP3,Arap3,4,-9,-5,23.621359,0,0
ARC,Arc,71,23,94,2.883495,0,0
ARCN1,Arcn1,7,-5,2,0.941748,0,0
AREG,Areg,4,11,15,10.339806,0,0
AREL1,Arel1,12,-6,6,0,0,0
ARF1,Arf1,11,-1,10,10.242718,0,0
ARF3,Arf3,6,-6,0,29.417476,0,0
ARF4,Arf4,10,0,10,14.029126,0,0
ARF5,Arf5,6,-3,3,4.932039,0,0
ARF6,Arf6,4,-1,3,12.359223,0,0
ARFGAP1,Arfgap1,9,-6,3,53.398058,0,0
ARFGAP2,Arfgap2,0,-6,-6,7.07767,0,0
ARFGAP3,Arfgap3,1,-4,-3,4.621359,0,0
ARFGEF1,Arfgef1,7,-2,5,5.951456,0,0
ARFGEF2,Arfgef2,3,0,3,16.737864,0,0
ARFGEF3,Arfgef3,3,0,3,6.38835,0,0
ARFIP1,Arfip1,3,-3,0,70.223301,0,0
ARFIP2,Arfip2,7,-5,2,5.592233,0,0
ARFRP1,Arfrp1,-2,-3,-5,14.951456,0,0
ARG1,Arg1,1,-4,-3,1.563107,0,0
ARG2,Arg2,12,7,19,3.514563,0,0
ARGLU1,Arglu1,8,-3,5,0.660194,0,0
ARHGAP1,Arhgap1,0,4,4,5.893204,0,0
ARHGAP10,Arhgap10,4,-2,2,7.252427,0,0
ARHGAP11A,Arhgap11a,-3,-10,-13,3.883495,0,0
ARHGAP12,Arhgap12,4,-1,3,1.825243,0,0
ARHGAP15,Arhgap15,2,1,3,0,0,0
ARHGAP17,Arhgap17,8,-1,7,4.019417,0,0
ARHGAP18,Arhgap18,0,1,1,0,0,0
ARHGAP19,Arhgap19,7,-16,-9,5.194175,0,0
ARHGAP20,Arhgap20,-2,1,-1,0,0,0
ARHGAP21,Arhgap21,11,-2,9,4.203883,0,0
ARHGAP22,Arhgap22,-22,0,-22,14.854369,0,0
ARHGAP23,Arhgap23,3,-5,-2,0.902913,0,0
ARHGAP24,Arhgap24,0,-1,-1,0,0,0
ARHGAP25,Arhgap25,-7,4,-3,1.15534,0,0
ARHGAP26,Arhgap26,0,3,3,9.92233,0,0
ARHGAP27,Arhgap27,0,8,8,15.368932,0,0
ARHGAP28,Arhgap28,1,-4,-3,6.728155,0,0
ARHGAP29,Arhgap29,-4,-13,-17,9.941748,0,0
ARHGAP30,Arhgap30,44,0,44,0,0,0
ARHGAP31,Arhgap31,8,2,10,3.757282,0,0
ARHGAP32,Arhgap32,1,0,1,4.737864,0,0
ARHGAP33,Arhgap33,7,-10,-3,3.932039,0,0
ARHGAP35,Arhgap35,9,-2,7,5.194175,0,0
ARHGAP36,Arhgap36,0,6,6,0,0,0
ARHGAP39,Arhgap39,1,2,3,28.737864,0,0
ARHGAP4,Arhgap4,6,2,8,5.631068,0,0
ARHGAP40,Arhgap40,-22,-4,-26,3.262136,0,0
ARHGAP42,Arhgap42,3,-2,1,3.300971,0,0
ARHGAP44,Arhgap44,3,-3,0,0,0,0
ARHGAP45,Arhgap45,7,1,8,4.116505,0,0
ARHGAP5,Arhgap5,12,0,12,18.728155,0,0
ARHGAP6,Arhgap6,-2,4,2,8.330097,0,0
ARHGAP8,Arhgap8,-10,3,-7,0,0,0
ARHGAP9,Arhgap9,11,-1,10,2.009709,0,0
ARHGDIA,Arhgdia,11,-4,7,0.786408,0,0
ARHGDIB,Arhgdib,0,-2,-2,1.475728,0,0
ARHGDIG,Arhgdig,18,3,21,0,0,0
ARHGEF1,Arhgef1,0,-9,-9,23.067961,0,0
ARHGEF10,Arhgef10,1,-4,-3,3.747573,0,0
ARHGEF10L,Arhgef10l,-7,-1,-8,1.883495,0,0
ARHGEF11,Arhgef11,10,-5,5,10.475728,0,0
ARHGEF12,Arhgef12,9,-3,6,22.475728,0,0
ARHGEF15,Arhgef15,16,-9,7,0,0,0
ARHGEF16,Arhgef16,14,0,14,0,0,0
ARHGEF17,Arhgef17,7,1,8,0.970874,0,0
ARHGEF18,Arhgef18,8,-4,4,7.427184,0,0
ARHGEF19,Arhgef19,-7,-10,-17,0,0,0
ARHGEF2,Arhgef2,4,-6,-2,7.271845,0,0
ARHGEF25,Arhgef25,3,-10,-7,0,0,0
ARHGEF26,Arhgef26,6,-6,0,8.815534,0,0
ARHGEF28,Arhgef28,1,-7,-6,4.786408,0,0
ARHGEF3,Arhgef3,0,-1,-1,8.300971,0,0
ARHGEF33,Arhgef33,44,-15,29,0,0,0
ARHGEF37,Arhgef37,2,0,2,7.601942,0,0
ARHGEF38,Arhgef38,3,2,5,0,0,0
ARHGEF39,Arhgef39,-3,-12,-15,4.786408,0,0
ARHGEF4,Arhgef4,3,0,3,0,0,0
ARHGEF40,Arhgef40,-4,-3,-7,0,0,0
ARHGEF5,Arhgef5,2,2,4,6.009709,0,0
ARHGEF6,Arhgef6,5,-2,3,2.951456,0,0
ARHGEF7,Arhgef7,5,0,5,2.912621,0,0
ARHGEF9,Arhgef9,8,-5,3,0,0,0
ARID1A,Arid1a,7,-4,3,14.679612,0,0
ARID1B,Arid1b,9,-1,8,0,0,0
ARID2,Arid2,9,-4,5,2.873786,0,0
ARID3A,Arid3a,5,-11,-6,34.961165,0,0
ARID3B,Arid3b,8,-9,-1,20.019417,0,0
ARID3C,Arid3c,13,-1,12,0,0,0
ARID4A,Arid4a,5,-2,3,10.174757,0,0
ARID4B,Arid4b,10,-8,2,0.815534,0,0
ARID5A,Arid5a,2,0,2,3.757282,0,0
ARID5B,Arid5b,3,3,6,26.135922,0,0
ARIH1,Arih1,11,-3,8,4.359223,0,0
ARIH2,Arih2,7,-6,1,7.407767,0,0
ARL1,Arl1,2,0,2,7.456311,0,0
ARL10,Arl10,3,-5,-2,2.291262,0,0
ARL11,Arl11,4,-13,-9,0,0,0
ARL13A,Arl13a,-4,-1,-5,1.339806,0,0
ARL13B,Arl13b,2,-7,-5,32.165049,0,0
ARL14,Arl14,30,5,35,0,0,0
ARL14EP,Arl14ep,0,-3,-3,12.446602,0,0
ARL14EPL,Arl14epl,44,0,44,23.912621,0,0
ARL15,Arl15,-1,6,5,1.223301,0,0
ARL16,Arl16,3,-7,-4,4.213592,0,0
ARL2,Arl2,8,-8,0,10.145631,0,0
ARL2BP,Arl2bp,1,-5,-4,33.106796,0,0
ARL3,Arl3,5,-2,3,25.330097,0,0
ARL4A,Arl4a,2,-4,-2,69.533981,0,0
ARL4C,Arl4c,10,0,10,0.92233,0,0
ARL4D,Arl4d,1,1,2,0,0,0
ARL5A,Arl5a,6,3,9,9.961165,0,0
ARL5B,Arl5b,6,-2,4,4,0,0
ARL5C,Arl5c,3,17,20,0,0,0
ARL6,Arl6,10,-3,7,50.378641,0,0
ARL6IP1,Arl6ip1,8,-4,4,6.980583,0,0
ARL6IP4,Arl6ip4,6,0,6,4.194175,0,0
ARL6IP5,Arl6ip5,7,2,9,7.281553,0,0
ARL6IP6,Arl6ip6,5,-3,2,7.815534,0,0
ARL8A,Arl8a,7,3,10,21.38835,0,0
ARL8B,Arl8b,8,0,8,22.009709,0,0
ARL9,Arl9,43,19,62,0,0,0
ARMC1,Armc1,2,0,2,4.669903,0,0
ARMC10,Armc10,2,-4,-2,85.126214,0,0
ARMC12,Armc12,16,3,19,3.951456,0,0
ARMC2,Armc2,-10,-4,-14,11.669903,0,0
ARMC3,Armc3,-2,-10,-12,0,0,0
ARMC5,Armc5,5,-2,3,6.116505,0,0
ARMC6,Armc6,-1,-7,-8,12.252427,6.166667,0
ARMC7,Armc7,7,0,7,3.145631,0,0
ARMC8,Armc8,2,-5,-3,5.417476,0,0
ARMC9,Armc9,7,1,8,52.466019,0,0
ARMCX1,Armcx1,2,4,6,0,0,0
ARMCX2,Armcx2,1,-5,-4,0,0,0
ARMCX3,Armcx3,9,-3,6,0,0,0
ARMCX4,Armcx4,-4,-2,-6,0,0,0
ARMCX5,Armcx5,-5,-6,-11,0,0,0
ARMCX6,Armcx6,6,0,6,0,0,0
ARMH1,Armh1,20,1,21,14.815534,0,0
ARMH2,Armh2,21,-11,10,0,0,0
ARMH3,Armh3,4,-10,-6,11.660194,0,0
ARMH4,Armh4,4,1,5,2.281553,0,0
ARMT1,Armt1,7,-8,-1,14.417476,0,0
ARNT,Arnt,3,-7,-4,3.747573,0,0
ARNT2,Arnt2,-8,-1,-9,0,0,0
ARPC1A,Arpc1a,4,-1,3,18.427184,0,0
ARPC1B,Arpc1b,2,2,4,2.592233,0,0
ARPC2,Arpc2,10,-3,7,4.805825,0,0
ARPC3,Arpc3,11,4,15,6.262136,0,0
ARPC4,Arpc4,7,4,11,3.126214,0,0
ARPC5,Arpc5,8,-1,7,0.834951,0,0
ARPC5L,Arpc5l,3,-1,2,11.970874,0,0
ARPIN,Arpin,4,-10,-6,0,0,0
ARPP19,Arpp19,9,-5,4,6.067961,0,0
ARPP21,Arpp21,-2,-3,-5,3.31068,0,0
ARR3,Arr3,-3,-1,-4,0,0,0
ARRB1,Arrb1,5,-3,2,12.92233,0,0
ARRB2,Arrb2,6,-9,-3,5.135922,0,0
ARRDC1,Arrdc1,6,-5,1,2.067961,0,0
ARRDC2,Arrdc2,-2,3,1,13.184466,0,0
ARRDC3,Arrdc3,2,-11,-9,36.718447,0,0
ARRDC4,Arrdc4,6,-2,4,0.970874,0,0
ARRDC5,Arrdc5,7,5,12,0,0,0
ARSA,Arsa,8,-10,-2,0,0,0
ARSB,Arsb,2,-7,-5,3.61165,0,0
ARSG,Arsg,4,-11,-7,13.76699,0,0
ARSI,Arsi,-11,-8,-19,1.68932,0,0
ARSJ,Arsj,5,-3,2,0,0,0
ARSK,Arsk,2,0,2,0,0,0
ART1,Art1,-2,-9,-11,0,0,0
ART3,Art3,7,-15,-8,0,0,0
ART4,Art4,6,6,12,9.271845,0,0
ART5,Art5,2,8,10,0,0,0
ARTN,Artn,-6,-3,-9,0,0,0
ARV1,Arv1,3,-8,-5,0,0,0
ARX,Arx,5,2,7,0,0,0
AS3MT,As3mt,16,-2,14,0,0,0
ASAH1,Asah1,8,3,11,0,0,0
ASAH2,Asah2,-7,-5,-12,0,0,0
ASAP1,Asap1,12,-4,8,14.31068,0,0
ASAP2,Asap2,9,-3,6,2.728155,0,0
ASAP3,Asap3,1,0,1,4.524272,0,0
ASB1,Asb1,9,-5,4,7.252427,0,0
ASB10,Asb10,13,1,14,0,0,0
ASB11,Asb11,4,9,13,0,0,0
ASB12,Asb12,-9,0,-9,0,0,0
ASB13,Asb13,-18,-3,-21,3.533981,0,0
ASB14,Asb14,-2,-13,-15,0,0,0
ASB15,Asb15,1,-13,-12,0,0,0
ASB16,Asb16,24,-1,23,0,0,0
ASB17,Asb17,5,-2,3,0,0,0
ASB18,Asb18,0,-4,-4,0,0,0
ASB2,Asb2,23,-4,19,0,0,0
ASB3,Asb3,12,-1,11,9.07767,0,0
ASB4,Asb4,0,-6,-6,0,0,0
ASB5,Asb5,14,-12,2,0,0,0
ASB6,Asb6,9,-3,6,11.873786,0,0
ASB7,Asb7,4,-6,-2,21.708738,0,0
ASB8,Asb8,7,-4,3,0,0,0
ASB9,Asb9,1,-4,-3,0,0,0
ASCC1,Ascc1,9,-11,-2,105.776699,0,0
ASCC2,Ascc2,13,-1,12,5.194175,0,0
ASCC3,Ascc3,4,-4,0,10.572816,0,0
ASCL1,Ascl1,5,-1,4,0,0,0
ASCL2,Ascl2,3,-6,-3,0,0,0
ASCL3,Ascl3,7,5,12,0,0,0
ASCL4,Ascl4,1,-2,-1,0,0,0
ASCL5,Ascl5,-6,-3,-9,20.582524,0,0
ASF1A,Asf1a,5,-3,2,6.902913,0,0
ASF1B,Asf1b,8,-7,1,12.563107,0,0
ASGR1,Asgr1,13,10,23,0,0,0
ASGR2,Asgr2,6,1,7,7.737864,0,0
ASH1L,Ash1l,7,-1,6,7.601942,0,0
ASH2L,Ash2l,-2,-7,-9,4.223301,0,0
ASIC1,Asic1,9,-8,1,0,0,0
ASIC2,Asic2,-1,3,2,0,0,0
ASIC3,Asic3,14,-10,4,0,0,0
ASIC4,Asic4,10,-5,5,0,0,0
ASIC5,Asic5,-4,2,-2,0,0,0
ASL,Asl,3,-3,0,3.495146,0,0
ASMT,Asmt,10,-3,7,2.145631,0,0
ASNS,Asns,20,16,36,3.757282,0,0
ASNSD1,Asnsd1,4,-10,-6,2.446602,0,0
ASPA,Aspa,-4,-1,-5,0,0,0
ASPDH,Aspdh,-4,-7,-11,14.621359,0,0
ASPG,Aspg,13,-3,10,13.728155,0,0
ASPH,Asph,3,-6,-3,22.504854,0,0
ASPHD1,Asphd1,9,-8,1,11.504854,0,0
ASPHD2,Asphd2,6,5,11,2.07767,0,0
ASPM,Aspm,-3,-12,-15,0.902913,0,0
ASPN,Aspn,11,-2,9,62.174757,0,0
ASPRV1,Asprv1,20,-4,16,0,0,0
ASPSCR1,Aspscr1,1,-3,-2,14.07767,0,0
ASRGL1,Asrgl1,6,-6,0,0.990291,0,0
ASS1,Ass1,7,6,13,0,0,0
ASTE1,Aste1,-5,1,-4,26.514563,0,0
ASTL,Astl,31,4,35,0,0,0
ASTN1,Astn1,4,-1,3,0,0,0
ASTN2,Astn2,10,-2,8,3,0,0
ASXL1,Asxl1,8,-7,1,10.300971,0,0
ASXL2,Asxl2,6,-2,4,18.300971,0,0
ASXL3,Asxl3,4,0,4,0,0,0
ASZ1,Asz1,6,-3,3,0,0,0
ATAD1,Atad1,2,-6,-4,0.640777,0,0
ATAD2,Atad2,3,-3,0,16.019417,0,0
ATAD2B,Atad2b,8,0,8,21.61165,0,0
ATAD3A,Atad3a,7,-4,3,18.582524,0,0
ATAD5,Atad5,4,-6,-2,6.815534,0,0
ATAT1,Atat1,6,-4,2,0,0,0
ATCAY,Atcay,5,4,9,0,0,0
ATE1,Ate1,5,-4,1,5.15534,0,0
ATF1,Atf1,6,-2,4,8.514563,0,0
ATF2,Atf2,7,-5,2,6.553398,0,0
ATF3,Atf3,88,78,166,19.466019,0,0
ATF4,Atf4,7,1,8,1.621359,0,0
ATF5,Atf5,-6,4,-2,33.815534,0,0
ATF6,Atf6,7,-2,5,1.621359,0,0
ATF6B,Atf6b,8,-1,7,11.84466,0,0
ATF7,Atf7,7,-11,-4,6.048544,0,0
ATF7IP,Atf7ip,6,-4,2,4.786408,0,0
ATF7IP2,Atf7ip2,37,-4,33,0,0,0
ATG10,Atg10,-1,3,2,4.961165,0,0
ATG101,Atg101,4,-2,2,14.902913,0,0
ATG12,Atg12,0,-1,-1,0,0,0
ATG13,Atg13,5,-1,4,5.165049,0,0
ATG14,Atg14,4,2,6,10.009709,0,0
ATG16L1,Atg16l1,9,-1,8,11.825243,0,0
ATG16L2,Atg16l2,-11,-5,-16,6.067961,0,0
ATG2A,Atg2a,4,-1,3,1,0,0
ATG2B,Atg2b,4,0,4,8.116505,0,0
ATG3,Atg3,6,1,7,13.407767,0,0
ATG4A,Atg4a,10,8,18,24.300971,0,0
ATG4B,Atg4b,4,-1,3,6.368932,0,0
ATG4C,Atg4c,-1,-13,-14,2.466019,0,0
ATG4D,Atg4d,-4,-4,-8,6.553398,0,0
ATG5,Atg5,8,-2,6,13.116505,0,0
ATG7,Atg7,4,-9,-5,7.165049,0,0
ATG9A,Atg9a,7,-2,5,0,0,0
ATG9B,Atg9b,-1,1,0,3.621359,0,0
ATIC,Atic,5,0,5,9.893204,0,0
ATL1,Atl1,0,-5,-5,16.864078,3.958333,0
ATL2,Atl2,-2,-2,-4,6.660194,0,0
ATL3,Atl3,0,-2,-2,94.38835,28.125,0
ATM,Atm,10,-3,7,4.300971,0,0
ATMIN,Atmin,8,-3,5,9.504854,0,0
ATN1,Atn1,10,-2,8,2.563107,0,0
ATOH1,Atoh1,-2,-14,-16,0,0,0
ATOH7,Atoh7,-7,1,-6,7.912621,0,0
ATOH8,Atoh8,-1,-7,-8,0,0,0
ATOX1,Atox1,10,-5,5,1.834951,0,0
ATP10A,Atp10a,0,-14,-14,0,0,0
ATP10B,Atp10b,4,-5,-1,0,0,0
ATP10D,Atp10d,2,-4,-2,1.417476,0,0
ATP11A,Atp11a,-3,-5,-8,3,0,0
ATP11B,Atp11b,1,-8,-7,6.252427,0,0
ATP11C,Atp11c,-2,-3,-5,3.495146,0,0
ATP12A,Atp12a,-2,-2,-4,0,0,0
ATP13A1,Atp13a1,1,-1,0,18.07767,0,0
ATP13A2,Atp13a2,8,2,10,4.582524,0,0
ATP13A3,Atp13a3,7,-2,5,10.912621,0,0
ATP13A4,Atp13a4,5,2,7,0,0,0
ATP13A5,Atp13a5,5,-5,0,0,0,0
ATP1A1,Atp1a1,12,1,13,11.485437,0,0
ATP1A2,Atp1a2,5,1,6,0,0,0
ATP1A3,Atp1a3,3,4,7,0,0,0
ATP1A4,Atp1a4,2,0,2,0,0,0
ATP1B1,Atp1b1,12,2,14,8.932039,0,0
ATP1B2,Atp1b2,11,2,13,0,0,0
ATP1B3,Atp1b3,10,-1,9,2.456311,0,0
ATP1B4,Atp1b4,0,2,2,0,0,0
ATP23,Atp23,0,-11,-11,5.640777,0,0
ATP2A1,Atp2a1,4,-10,-6,0,0,0
ATP2A2,Atp2a2,9,-1,8,5.135922,0,0
ATP2A3,Atp2a3,-1,-2,-3,0,0,0
ATP2B1,Atp2b1,1,1,2,4.514563,0,0
ATP2B2,Atp2b2,-1,0,-1,0,0,0
ATP2B3,Atp2b3,34,3,37,2.145631,0,0
ATP2B4,Atp2b4,9,-8,1,0,0,0
ATP2C1,Atp2c1,26,-3,23,114.475728,0,0
ATP2C2,Atp2c2,-3,-2,-5,3.475728,0,0
ATP4A,Atp4a,-5,-3,-8,0,0,0
ATP4B,Atp4b,1,2,3,9.184466,0,0
ATP5MD,Atp5md,5,-2,3,0,0,0
ATP5MPL,Atp5mpl,5,0,5,46.640777,0,0
ATP5PB,Atp5pb,6,-7,-1,2.029126,0,0
ATP6AP1,Atp6ap1,8,2,10,0.805825,0,0
ATP6AP2,Atp6ap2,7,1,8,2.427184,0,0
ATP6V0A1,Atp6v0a1,9,-3,6,0,0,0
ATP6V0A2,Atp6v0a2,6,-4,2,5.213592,0,0
ATP6V0A4,Atp6v0a4,0,3,3,0,0,0
ATP6V0B,Atp6v0b,10,2,12,1.834951,0,0
ATP6V0C,Atp6v0c,10,2,12,5.097087,0,0
ATP6V0D1,Atp6v0d1,11,6,17,13.524272,0,0
ATP6V0D2,Atp6v0d2,13,6,19,48.601942,0,0
ATP6V0E2,Atp6v0e2,9,1,10,1.165049,0,0
ATP6V1A,Atp6v1a,4,-1,3,20.019417,0,0
ATP6V1B1,Atp6v1b1,3,-6,-3,0,0,0
ATP6V1B2,Atp6v1b2,1,-3,-2,7.048544,0,0
ATP6V1C1,Atp6v1c1,7,5,12,16.330097,0,0
ATP6V1C2,Atp6v1c2,1,-2,-1,0,0,0
ATP6V1D,Atp6v1d,3,-3,0,7.796117,0,0
ATP6V1E1,Atp6v1e1,3,4,7,0,0,0
ATP6V1E2,Atp6v1e2,-2,0,-2,2.407767,0,0
ATP6V1F,Atp6v1f,9,-6,3,1.398058,0,0
ATP6V1FNB,Atp6v1fnb,28,-4,24,3.339806,0,0
ATP6V1G1,Atp6v1g1,9,-4,5,30.864078,0,0
ATP6V1G2,Atp6v1g2,29,6,35,0,0,126
ATP6V1G3,Atp6v1g3,-8,4,-4,0,0,0
ATP6V1H,Atp6v1h,9,1,10,1.203883,0,0
ATP7A,Atp7a,6,5,11,5.514563,0,0
ATP7B,Atp7b,6,-6,0,0,0,0
ATP8A1,Atp8a1,-3,1,-2,1.31068,0,0
ATP8A2,Atp8a2,2,-2,0,31.23301,0,0
ATP8B1,Atp8b1,7,1,8,3.61165,0,0
ATP8B2,Atp8b2,3,-3,0,4.737864,0,0
ATP8B3,Atp8b3,0,1,1,10.126214,0,0
ATP8B4,Atp8b4,3,-4,-1,0,0,0
ATP9A,Atp9a,9,5,14,28.475728,0,0
ATP9B,Atp9b,8,-5,3,4.184466,0,0
ATPAF1,Atpaf1,6,-6,0,13.330097,0,0
ATPAF2,Atpaf2,1,-7,-6,4.669903,0,0
ATPSCKMT,Atpsckmt,13,-3,10,178.009709,59.041667,0
ATR,Atr,-3,-5,-8,42.126214,0,0
ATRAID,Atraid,6,-8,-2,6.572816,0,0
ATRIP,Atrip,3,-2,1,9.048544,0,0
ATRN,Atrn,5,-4,1,7.135922,0,0
ATRNL1,Atrnl1,21,-2,19,2.699029,0,0
ATRX,Atrx,8,0,8,1.067961,0,0
ATXN1,Atxn1,10,7,17,29.61165,0,0
ATXN10,Atxn10,-3,-3,-6,2.864078,0,0
ATXN1L,Atxn1l,7,-8,-1,7.359223,0,0
ATXN2,Atxn2,8,-2,6,10.15534,0,0
ATXN2L,Atxn2l,8,-4,4,12.650485,0,0
ATXN3,Atxn3,2,-5,-3,8.582524,0,0
ATXN7,Atxn7,6,-2,4,8.320388,0,0
ATXN7L1,Atxn7l1,9,1,10,17.116505,0,0
ATXN7L2,Atxn7l2,-7,-8,-15,25.009709,0,0
ATXN7L3,Atxn7l3,11,-6,5,43.427184,0,0
ATXN7L3B,Atxn7l3b,7,-1,6,3.378641,0,0
AUH,Auh,1,-2,-1,4.213592,0,0
AUNIP,Aunip,-4,-11,-15,7.368932,0,0
AUP1,Aup1,7,-4,3,0,0,0
AURKA,Aurka,-3,-12,-15,5.902913,0,0
AURKAIP1,Aurkaip1,3,1,4,42.805825,0,0
AURKB,Aurkb,-7,-15,-22,0.941748,0,0
AURKC,Aurkc,15,-11,4,7,0,0
AUTS2,Auts2,9,8,17,0,0,0
AVEN,Aven,1,-4,-3,6.407767,0,0
AVIL,Avil,14,6,20,0,0,0
AVL9,Avl9,3,0,3,9.495146,0,0
AVP,Avp,6,16,22,0,0,0
AVPI1,Avpi1,9,-1,8,4.339806,0,0
AVPR1A,Avpr1a,1,6,7,0,0,0
AVPR1B,Avpr1b,6,-1,5,0,0,0
AVPR2,Avpr2,0,3,3,12.912621,0,0
AWAT1,Awat1,-3,-3,-6,0,0,0
AWAT2,Awat2,-1,2,1,0,0,0
AXDND1,Axdnd1,16,0,16,0,0,0
AXIN1,Axin1,0,-2,-2,0,0,0
AXIN2,Axin2,4,0,4,2.106796,0,0
AXL,Axl,6,-3,3,25.718447,0,0
AZGP1,Azgp1,15,0,15,5.893204,0,0
AZI2,Azi2,-2,0,-2,43.23301,4.5,0
AZIN1,Azin1,13,1,14,194.504854,52.916667,0
AZIN2,Azin2,8,-12,-4,71.650485,0,0
B2M,B2m,10,1,11,3.941748,0,0
B3GALNT1,B3galnt1,2,-16,-14,13.203883,0,0
B3GALNT2,B3galnt2,7,-8,-1,3.174757,0,0
B3GALT1,B3galt1,-2,-5,-7,4.087379,0,0
B3GALT2,B3galt2,1,1,2,0,0,0
B3GALT4,B3galt4,75,-14,61,11.126214,0,0
B3GALT5,B3galt5,-3,-3,-6,4.31068,0,0
B3GALT6,B3galt6,-8,-4,-12,3.145631,0,0
B3GAT1,B3gat1,3,0,3,5.271845,0,0
B3GAT2,B3gat2,4,-7,-3,5.174757,0,0
B3GAT3,B3gat3,2,0,2,12.514563,0,0
B3GLCT,B3glct,10,-7,3,6.533981,0,0
B3GNT2,B3gnt2,4,5,9,2.786408,0,0
B3GNT3,B3gnt3,-8,3,-5,9.902913,0,0
B3GNT4,B3gnt4,-2,-14,-16,0.805825,0,0
B3GNT5,B3gnt5,5,2,7,3.805825,0,0
B3GNT6,B3gnt6,2,5,7,0,0,0
B3GNT7,B3gnt7,4,0,4,32.368932,0,0
B3GNT8,B3gnt8,5,-10,-5,0,0,0
B3GNT9,B3gnt9,1,-9,-8,1.252427,0,0
B3GNTL1,B3gntl1,1,-7,-6,2.650485,0,0
B4GALNT1,B4galnt1,7,-4,3,11.203883,0,0
B4GALNT2,B4galnt2,2,6,8,0,0,0
B4GALNT3,B4galnt3,22,-2,20,1.92233,0,0
B4GALNT4,B4galnt4,15,-13,2,0,0,0
B4GALT1,B4galt1,6,1,7,5.320388,0,0
B4GALT2,B4galt2,5,-5,0,4.533981,0,0
B4GALT3,B4galt3,2,-1,1,6.213592,0,0
B4GALT4,B4galt4,2,-8,-6,12.747573,0,0
B4GALT5,B4galt5,5,-4,1,12.650485,0,0
B4GALT6,B4galt6,-1,2,1,1.786408,0,0
B4GALT7,B4galt7,4,0,4,37.019417,4.416667,0
B4GAT1,B4gat1,6,-4,2,49.339806,0,0
B9D1,B9d1,-3,-2,-5,92.621359,0,0
B9D2,B9d2,2,-7,-5,32.320388,0,0
BAALC,Baalc,14,-7,7,2.048544,0,0
BAAT,Baat,27,9,36,0,0,0
BABAM1,Babam1,9,-2,7,10.873786,0,0
BABAM2,Babam2,6,-3,3,6.194175,0,0
BACE1,Bace1,7,0,7,6.320388,0,0
BACE2,Bace2,5,1,6,17.262136,0,0
BACH1,Bach1,15,0,15,5.524272,0,0
BACH2,Bach2,2,-4,-2,0,0,0
BAD,Bad,3,-6,-3,60.854369,0,0
BAG1,Bag1,9,-3,6,2.281553,0,0
BAG2,Bag2,1,5,6,66.029126,18.916667,0
BAG3,Bag3,181,51,232,219.242718,70.916667,139
BAG4,Bag4,4,-2,2,2.029126,0,0
BAG5,Bag5,2,-6,-4,20.15534,0,0
BAG6,Bag6,9,-5,4,5.76699,0,0
BAHCC1,Bahcc1,-2,-6,-8,3.990291,0,0
BAHD1,Bahd1,13,0,13,32.601942,0,0
BAIAP2,Baiap2,12,0,12,100.456311,0,0
BAIAP2L1,Baiap2l1,1,3,4,3.631068,0,0
BAIAP2L2,Baiap2l2,0,1,1,0,0,0
BAIAP3,Baiap3,8,-7,1,0,0,0
BAK1,Bak1,2,-8,-6,0,0,0
BAMBI,Bambi,42,-2,40,2.660194,0,0
BANF1,Banf1,11,-7,4,237.961165,85.625,0
BANF2,Banf2,6,-3,3,0,0,0
BANK1,Bank1,0,1,1,2.359223,0,0
BANP,Banp,21,16,37,25.961165,0,0
BAP1,Bap1,3,-3,0,5.970874,0,0
BARD1,Bard1,-12,-7,-19,1.631068,0,0
BARHL1,Barhl1,-3,-10,-13,6.427184,0,0
BARHL2,Barhl2,4,-4,0,0,0,0
BARX1,Barx1,4,3,7,0,0,0
BARX2,Barx2,6,1,7,0,0,0
BASP1,Basp1,3,5,8,0,0,0
BATF,Batf,-2,-4,-6,3.058252,0,0
BATF2,Batf2,-12,-7,-19,0,0,0
BATF3,Batf3,3,5,8,1.174757,0,0
BAX,Bax,8,-2,6,9.417476,0,0
BAZ1A,Baz1a,1,-1,0,3.601942,0,0
BAZ1B,Baz1b,10,-2,8,5.495146,0,0
BAZ2A,Baz2a,17,-3,14,27.300971,0,0
BAZ2B,Baz2b,3,1,4,7.349515,0,0
BBC3,Bbc3,1,4,5,3.446602,0,0
BBIP1,Bbip1,1,-4,-3,8.524272,0,0
BBOF1,Bbof1,5,-12,-7,73.165049,0,0
BBOX1,Bbox1,3,-4,-1,0,0,0
BBS1,Bbs1,0,0,0,93.475728,0,0
BBS10,Bbs10,5,-5,0,3.864078,0,0
BBS12,Bbs12,0,-8,-8,9.941748,0,0
BBS2,Bbs2,2,-6,-4,8.883495,0,0
BBS4,Bbs4,-4,3,-1,4.038835,0,0
BBS5,Bbs5,9,-3,6,5.533981,0,0
BBS7,Bbs7,4,-4,0,2.456311,0,0
BBS9,Bbs9,6,-2,4,12.38835,0,0
BBX,Bbx,2,-2,0,3.165049,0,0
BCAM,Bcam,3,4,7,0,0,0
BCAN,Bcan,5,-1,4,0,0,0
BCAP29,Bcap29,9,-3,6,6.805825,0,0
BCAP31,Bcap31,8,-3,5,52.300971,0,0
BCAR1,Bcar1,8,0,8,27.15534,0,0
BCAR3,Bcar3,5,0,5,45.786408,0,0
BCAS1,Bcas1,8,-4,4,0.805825,0,0
BCAS2,Bcas2,4,-1,3,19.417476,0,0
BCAS3,Bcas3,8,0,8,2.417476,0,0
BCAT1,Bcat1,2,3,5,9.650485,0,0
BCAT2,Bcat2,7,-3,4,8.271845,0,0
BCCIP,Bccip,3,-9,-6,2.776699,0,0
BCDIN3D,Bcdin3d,1,-3,-2,7.058252,0,0
BCHE,Bche,-2,1,-1,0,0,0
BCKDHA,Bckdha,0,-2,-2,1.796117,0,0
BCKDHB,Bckdhb,0,-9,-9,2.68932,0,0
BCKDK,Bckdk,5,0,5,3.31068,0,0
BCL10,Bcl10,24,-3,21,97.873786,15.458333,0
BCL11A,Bcl11a,4,-8,-4,0,0,0
BCL11B,Bcl11b,4,4,8,1.339806,0,0
BCL2,Bcl2,5,1,6,4.737864,0,0
BCL2L1,Bcl2l1,9,-1,8,39.941748,0,0
BCL2L10,Bcl2l10,40,-3,37,0,0,0
BCL2L11,Bcl2l11,29,1,30,4.660194,0,0
BCL2L12,Bcl2l12,4,-8,-4,19.485437,0,0
BCL2L13,Bcl2l13,3,-6,-3,4.417476,0,0
BCL2L14,Bcl2l14,-3,2,-1,0,0,0
BCL2L15,Bcl2l15,25,-9,16,0,0,0
BCL2L2,Bcl2l2,7,-7,0,6.864078,0,0
BCL3,Bcl3,-7,4,-3,7.038835,0,0
BCL6,Bcl6,20,10,30,4.631068,0,0
BCL6B,Bcl6b,25,1,26,15.339806,0,0
BCL7A,Bcl7a,6,-2,4,0,0,0
BCL7B,Bcl7b,6,-4,2,8.572816,0,0
BCL7C,Bcl7c,5,-5,0,22.718447,0,0
BCL9,Bcl9,4,-11,-7,2.242718,0,0
BCL9L,Bcl9l,4,-4,0,6.009709,0,0
BCLAF1,Bclaf1,5,-5,0,2.76699,0,0
BCLAF3,Bclaf3,-1,-1,-2,0,0,0
BCO1,Bco1,3,-1,2,0,8.125,0
BCO2,Bco2,26,-1,25,120.339806,24.166667,0
BCOR,Bcor,9,-11,-2,2.650485,0,0
BCORL1,Bcorl1,6,0,6,0,0,0
BCR,Bcr,7,0,7,1.009709,0,0
BCS1L,Bcs1l,5,-5,0,1.019417,0,0
BDH1,Bdh1,11,0,11,2.854369,0,0
BDH2,Bdh2,2,6,8,0,0,0
BDKRB1,Bdkrb1,42,0,42,11.398058,0,0
BDKRB2,Bdkrb2,-20,-4,-24,8.242718,0,0
BDNF,Bdnf,-1,0,-1,1.339806,0,0
BDP1,Bdp1,4,-3,1,9.203883,0,0
BEAN1,Bean1,5,-5,0,0,0,0
BECN1,Becn1,6,-4,2,1.07767,0,0
BECN2,Becn2,4,-4,0,0,0,0
BEGAIN,Begain,-15,-3,-18,9.76699,0,0
BEND3,Bend3,6,-2,4,30.669903,0,0
BEND4,Bend4,15,-1,14,28.174757,17.416667,0
BEND5,Bend5,-5,-9,-14,0,0,0
BEND6,Bend6,3,0,3,7.097087,0,0
BEND7,Bend7,3,3,6,20.815534,0,0
BEST1,Best1,-6,-7,-13,0,0,0
BEST2,Best2,43,35,78,0,0,0
BEST3,Best3,14,16,30,3.669903,0,0
BET1,Bet1,9,-8,1,0.61165,0,0
BET1L,Bet1l,8,-4,4,3.873786,0,0
BEX1,Bex1,4,4,8,0,0,0
BEX2,Bex2,9,3,12,0,0,0
BEX3,Bex3,8,2,10,1.747573,0,0
BEX4,Bex4,10,1,11,12.893204,0,0
BFAR,Bfar,5,-5,0,4.320388,0,0
BFSP1,Bfsp1,1,-1,0,8.504854,0,0
BFSP2,Bfsp2,4,1,5,0,0,0
BGLAP,Bglap,-6,15,9,0,0,0
BGN,Bgn,5,2,7,5.504854,0,0
BHLHA15,Bhlha15,4,3,7,0,0,0
BHLHA9,Bhlha9,18,-6,12,5.436893,0,0
BHLHB9,Bhlhb9,6,-10,-4,0,0,0
BHLHE22,Bhlhe22,-1,1,0,0,0,0
BHLHE23,Bhlhe23,0,-1,-1,0,0,0
BHLHE40,Bhlhe40,11,6,17,14.067961,0,0
BHLHE41,Bhlhe41,4,9,13,3.631068,0,0
BHMT,Bhmt,0,8,8,0,0,0
BHMT2,Bhmt2,4,-2,2,0,0,0
BICC1,Bicc1,0,-2,-2,2.718447,0,0
BICD1,Bicd1,5,-2,3,14.961165,0,0
BICD2,Bicd2,10,-3,7,7.621359,0,0
BICDL1,Bicdl1,11,-5,6,3.194175,0,0
BICDL2,Bicdl2,13,-2,11,0,0,0
BICRA,Bicra,2,-10,-8,0,0,0
BICRAL,Bicral,5,-3,2,0.747573,0,0
BID,Bid,3,1,4,32.728155,0,0
BIK,Bik,-11,-13,-24,0,0,0
BIN1,Bin1,4,2,6,3.61165,0,0
BIN2,Bin2,11,-1,10,0,0,0
BIN3,Bin3,0,-4,-4,2.281553,0,0
BIRC2,Birc2,5,-8,-3,16.038835,0,0
BIRC3,Birc3,11,5,16,0,0,0
BIRC5,Birc5,2,-9,-7,15.563107,0,0
BIRC6,Birc6,5,-5,0,12.252427,0,0
BIRC7,Birc7,1,0,1,0,0,0
BIVM,Bivm,4,-9,-5,0,0,0
BLCAP,Blcap,1,-4,-3,5.07767,0,0
BLK,Blk,1,5,6,0,0,0
BLM,Blm,5,-10,-5,2.262136,0,0
BLMH,Blmh,4,-6,-2,4.446602,0,0
BLNK,Blnk,-1,4,3,0,0,0
BLOC1S1,Bloc1s1,4,-1,3,9.553398,0,0
BLOC1S2,Bloc1s2,0,-9,-9,4.165049,0,0
BLOC1S3,Bloc1s3,-3,-2,-5,0,0,0
BLOC1S4,Bloc1s4,-5,-3,-8,5.84466,0,0
BLOC1S5,Bloc1s5,-1,-6,-7,7.126214,0,0
BLOC1S6,Bloc1s6,1,-1,0,3.262136,0,0
BLVRA,Blvra,-1,-3,-4,3.650485,0,0
BLVRB,Blvrb,6,3,9,0,0,0
BLZF1,Blzf1,3,-2,1,14.339806,0,0
BMERB1,Bmerb1,9,1,10,0,0,0
BMF,Bmf,-15,-6,-21,3.825243,0,0
BMI1,Bmi1,7,-1,6,10.407767,0,0
BMP1,Bmp1,9,-1,8,2.281553,0,0
BMP10,Bmp10,1,1,2,0,0,0
BMP15,Bmp15,0,-1,-1,0,0,0
BMP2,Bmp2,4,5,9,1.262136,0,0
BMP2K,Bmp2k,7,-5,2,6.815534,0,0
BMP3,Bmp3,1,-2,-1,0,0,0
BMP4,Bmp4,63,-2,61,73.805825,0,0
BMP5,Bmp5,6,-5,1,0,0,0
BMP6,Bmp6,-1,0,-1,0,0,0
BMP7,Bmp7,11,4,15,13.097087,0,0
BMP8A,Bmp8a,4,6,10,0,0,0
BMP8B,Bmp8b,5,-10,-5,4.553398,0,0
BMPER,Bmper,6,-3,3,0,0,0
BMPR1A,Bmpr1a,2,1,3,4.815534,0,0
BMPR1B,Bmpr1b,2,-2,0,2.067961,0,0
BMPR2,Bmpr2,5,1,6,6.446602,0,0
BMS1,Bms1,5,-5,0,135.242718,16.416667,0
BMT2,Bmt2,38,-5,33,21.786408,0,0
BMX,Bmx,-1,3,2,6.184466,0,0
BNC1,Bnc1,8,-1,7,0,0,0
BNC2,Bnc2,6,-6,0,2.058252,0,0
BNIP1,Bnip1,-8,-2,-10,15.815534,0,0
BNIP2,Bnip2,3,-2,1,5.873786,0,0
BNIP3,Bnip3,5,-3,2,2.601942,0,0
BNIP3L,Bnip3l,6,-6,0,1.23301,0,0
BNIP5,Bnip5,18,2,20,23.417476,0,0
BNIPL,Bnipl,23,4,27,0,0,0
BOC,Boc,6,-1,5,2.786408,0,0
BOD1,Bod1,8,-3,5,58.92233,0,0
BOK,Bok,2,4,6,1.291262,0,0
BOLA1,Bola1,7,-3,4,0,0,0
BOLA2,Bola2,4,-2,2,50.174757,0,0
BOLA3,Bola3,5,-7,-2,12.194175,0,0
BOLL,Boll,18,3,21,1.320388,0,0
BOP1,Bop1,1,-1,0,46.864078,31.666667,0
BORA,Bora,-8,-13,-21,3.320388,0,0
BORCS5,Borcs5,3,-2,1,5.417476,0,0
BORCS6,Borcs6,-4,-2,-6,30.961165,0,0
BORCS7,Borcs7,5,-5,0,0,0,0
BORCS8,Borcs8,6,-5,1,21.883495,0,0
BPGM,Bpgm,9,-2,7,0,0,0
BPHL,Bphl,0,1,1,9.796117,0,0
BPI,Bpi,3,-6,-3,1.533981,0,0
BPIFA1,Bpifa1,0,7,7,0,0,0
BPIFA2,Bpifa2,-3,7,4,0,0,0
BPIFA3,Bpifa3,1,0,1,0,0,0
BPIFB1,Bpifb1,3,0,3,0,0,0
BPIFB2,Bpifb2,1,-5,-4,0,0,0
BPIFB3,Bpifb3,0,-4,-4,0,0,0
BPIFB4,Bpifb4,0,0,0,0,0,0
BPIFB6,Bpifb6,0,-6,-6,0,0,0
BPIFC,Bpifc,2,2,4,0,0,0
BPNT1,Bpnt1,7,0,7,10.398058,0,0
BPNT2,Bpnt2,3,-2,1,0,0,0
BPTF,Bptf,12,-2,10,19.640777,0,0
BRAF,Braf,7,-2,5,15.84466,0,0
BRAP,Brap,5,7,12,48.728155,0,0
BRAT1,Brat1,-6,-2,-8,44.893204,0,0
BRCA1,Brca1,-5,1,-4,2.533981,0,0
BRCA2,Brca2,2,-5,-3,0.893204,0,0
BRCC3,Brcc3,2,4,6,2.514563,0,0
BRD1,Brd1,5,1,6,0,0,0
BRD2,Brd2,8,1,9,26.15534,0,0
BRD3,Brd3,4,-5,-1,1.087379,0,0
BRD3OS,Brd3os,3,-6,-3,39.067961,0,0
BRD4,Brd4,9,-3,6,2.592233,0,0
BRD7,Brd7,10,-4,6,6.592233,0,0
BRD8,Brd8,6,-6,0,4.883495,0,0
BRD9,Brd9,0,-3,-3,15.300971,0,0
BRDT,Brdt,1,-1,0,0,0,0
BRF1,Brf1,5,-3,2,32.61165,0,0
BRF2,Brf2,8,-1,7,10.126214,0,0
BRI3,Bri3,6,0,6,1.262136,0,0
BRI3BP,Bri3bp,3,-4,-1,2.834951,0,0
BRICD5,Bricd5,4,5,9,0.912621,0,0
BRINP1,Brinp1,-4,-2,-6,0,0,0
BRINP2,Brinp2,-2,-1,-3,0,0,0
BRINP3,Brinp3,5,-4,1,1.417476,0,0
BRIP1,Brip1,2,-4,-2,1.252427,0,0
BRIX1,Brix1,0,-2,-2,17.495146,0,0
BRK1,Brk1,8,-4,4,2.524272,0,0
BRME1,Brme1,8,-19,-11,0,0,0
BRMS1,Brms1,7,-1,6,49.339806,0,0
BRMS1L,Brms1l,-2,-9,-11,19.145631,0,0
BROX,Brox,7,0,7,7.368932,0,0
BRPF1,Brpf1,3,-2,1,10.398058,0,0
BRPF3,Brpf3,11,-3,8,10.145631,0,0
BRS3,Brs3,1,0,1,0,0,0
BRSK1,Brsk1,0,-8,-8,9.23301,0,0
BRSK2,Brsk2,5,-9,-4,0,0,0
BRWD1,Brwd1,8,-3,5,15.407767,0,0
BRWD3,Brwd3,4,-3,1,16.92233,0,0
BSCL2,Bscl2,5,-10,-5,54.466019,0,0
BSDC1,Bsdc1,8,-8,0,0,0,0
BSG,Bsg,13,-5,8,7.495146,0,0
BSN,Bsn,1,-4,-3,4.854369,0,0
BSND,Bsnd,-1,-2,-3,0,0,0
BSPH1,Bsph1,2,-4,-2,0,0,0
BSPRY,Bspry,5,-6,-1,0,0,0
BST1,Bst1,-2,8,6,0,0,0
BST2,Bst2,32,13,45,69.728155,27.125,169
BSX,Bsx,13,9,22,0,0,0
BTAF1,Btaf1,4,-1,3,0,0,0
BTBD1,Btbd1,11,-2,9,9.932039,0,0
BTBD10,Btbd10,0,-5,-5,10.601942,0,0
BTBD16,Btbd16,6,-9,-3,0,0,0
BTBD17,Btbd17,2,-1,1,0,0,0
BTBD18,Btbd18,4,-2,2,0,0,0
BTBD19,Btbd19,7,0,7,2.126214,0,0
BTBD2,Btbd2,14,-5,9,0,0,0
BTBD3,Btbd3,8,-1,7,11.456311,0,0
BTBD6,Btbd6,8,-6,2,31.834951,0,0
BTBD7,Btbd7,9,0,9,13.038835,0,0
BTBD8,Btbd8,0,-17,-17,0,0,0
BTBD9,Btbd9,13,2,15,26.524272,0,0
BTC,Btc,0,7,7,3.165049,0,0
BTD,Btd,3,2,5,3.893204,0,0
BTF3,Btf3,8,-2,6,1.038835,0,0
BTF3L4,Btf3l4,6,-1,5,3.398058,0,0
BTG1,Btg1,8,1,9,4.76699,0,0
BTG2,Btg2,12,15,27,0,0,0
BTG3,Btg3,7,-1,6,0.84466,0,0
BTG4,Btg4,5,-3,2,0,0,0
BTK,Btk,28,-4,24,3.106796,0,0
BTLA,Btla,14,3,17,0,0,0
BTN1A1,Btn1a1,11,4,15,4.776699,0,0
BTN2A2,Btn2a2,8,-2,6,0.864078,0,0
BTNL2,Btnl2,0,3,3,0,0,0
BTNL9,Btnl9,0,2,2,0,0,0
BTRC,Btrc,3,-7,-4,7.135922,0,0
BUB1,Bub1,-1,-8,-9,2.242718,0,0
BUB1B,Bub1b,-8,-11,-19,5.805825,0,0
BUB3,Bub3,5,-5,0,0,0,0
BUD13,Bud13,-8,-5,-13,18.524272,0,0
BUD23,Bud23,11,-7,4,9.815534,0,0
BUD31,Bud31,9,-1,8,7.495146,0,0
BVES,Bves,5,0,5,0,0,0
BYSL,Bysl,3,-2,1,4.737864,0,0
BZW1,Bzw1,5,1,6,11.174757,0,0
BZW2,Bzw2,3,2,5,8.572816,0,0
C1D,C1d,10,-9,1,3.223301,0,0
C1GALT1,C1galt1,4,1,5,10.291262,0,0
C1GALT1C1,C1galt1c1,3,-4,-1,14.417476,0,0
C1QA,C1qa,3,-5,-2,0,0,0
C1QB,C1qb,1,-6,-5,0,0,0
C1QBP,C1qbp,7,1,8,25.097087,0,0
C1QC,C1qc,4,-2,2,6.485437,0,0
C1QL1,C1ql1,10,0,10,1.31068,0,0
C1QL2,C1ql2,-1,11,10,0,0,0
C1QL3,C1ql3,-4,1,-3,0,0,0
C1QL4,C1ql4,-9,-24,-33,4.203883,0,0
C1QTNF1,C1qtnf1,0,2,2,1.126214,0,0
C1QTNF12,C1qtnf12,14,4,18,0,0,0
C1QTNF2,C1qtnf2,2,-10,-8,0,0,0
C1QTNF3,C1qtnf3,5,-3,2,0,0,0
C1QTNF4,C1qtnf4,25,7,32,0,0,0
C1QTNF5,C1qtnf5,-6,-6,-12,1.194175,0,0
C1QTNF6,C1qtnf6,0,-8,-8,5.252427,0,0
C1QTNF7,C1qtnf7,0,2,2,0,0,0
C1QTNF9,C1qtnf9,4,5,9,0,0,0
C1RL,C1rl,-1,1,0,0,0,0
C2,C2,7,9,16,7.097087,0,0
C2CD2,C2cd2,0,-6,-6,7.990291,0,0
C2CD2L,C2cd2l,6,-1,5,5.466019,0,0
C2CD3,C2cd3,8,-3,5,12.485437,0,0
C2CD4A,C2cd4a,5,-3,2,4.475728,0,0
C2CD4B,C2cd4b,0,-4,-4,0,0,0
C2CD4C,C2cd4c,2,-1,1,1.038835,0,0
C2CD4D,C2cd4d,-10,-3,-13,5.291262,0,0
C2CD5,C2cd5,3,-5,-2,10.970874,0,0
C2CD6,C2cd6,8,-8,0,0,0,0
C3,C3,10,9,19,0,0,0
C3AR1,C3ar1,-8,-8,-16,0,0,0
C4A,C4b,13,6,19,0,0,0
C4B,C4bp,6,2,8,0,0,0
C5AR1,C5ar1,22,7,29,0,0,0
C5AR2,C5ar2,0,-3,-3,3.203883,0,0
C6,C6,2,-3,-1,0,0,0
C7,C7,5,6,11,0,0,0
C8A,C8a,1,-3,-2,0,0,0
C8B,C8b,-4,-7,-11,0,0,0
C8G,C8g,44,-6,38,7.058252,0,0
C9,C9,16,-7,9,0,0,0
C9orf72,C9orf72,-7,-4,-11,2.737864,0,0
CAAP1,Caap1,7,-4,3,7.058252,0,0
CAB39,Cab39,14,-4,10,47.621359,0,0
CAB39L,Cab39l,-2,-8,-10,2.601942,0,0
CABCOCO1,Cabcoco1,-1,-8,-9,49.291262,5.708333,0
CABIN1,Cabin1,4,1,5,24.699029,0,0
CABLES1,Cables1,12,0,12,2.07767,0,0
CABLES2,Cables2,-1,-6,-7,8.650485,0,0
CABP1,Cabp1,1,4,5,2.708738,0,0
CABP2,Cabp2,2,2,4,0,0,0
CABP4,Cabp4,3,0,3,0,0,0
CABP5,Cabp5,0,15,15,0,0,0
CABP7,Cabp7,-5,-3,-8,0,0,0
CABS1,Cabs1,-2,-1,-3,0,0,0
CABYR,Cabyr,6,-8,-2,0,0,0
CACFD1,Cacfd1,54,-4,50,64.640777,0,0
CACHD1,Cachd1,7,2,9,12.504854,0,0
CACNA1A,Cacna1a,6,-6,0,17.145631,0,0
CACNA1B,Cacna1b,1,-2,-1,0,0,0
CACNA1C,Cacna1c,8,-2,6,0,0,0
CACNA1D,Cacna1d,0,-2,-2,7.854369,0,0
CACNA1E,Cacna1e,-1,-3,-4,0,0,0
CACNA1F,Cacna1f,16,-1,15,0,0,0
CACNA1G,Cacna1g,74,-4,70,0,0,0
CACNA1H,Cacna1h,16,-12,4,27.242718,6.25,0
CACNA1I,Cacna1i,0,-2,-2,1.640777,0,0
CACNA1S,Cacna1s,1,-5,-4,20.582524,0,0
CACNA2D1,Cacna2d1,3,-2,1,2.31068,0,0
CACNA2D2,Cacna2d2,8,0,8,0,0,0
CACNA2D3,Cacna2d3,-4,0,-4,0,0,0
CACNA2D4,Cacna2d4,-7,-5,-12,1.737864,0,0
CACNB1,Cacnb1,0,-2,-2,1.436893,0,0
CACNB2,Cacnb2,5,-7,-2,0.893204,0,0
CACNB3,Cacnb3,3,-1,2,6.951456,0,0
CACNB4,Cacnb4,5,-2,3,1.912621,0,0
CACNG1,Cacng1,-1,1,0,0,0,0
CACNG2,Cacng2,-1,0,-1,0,0,0
CACNG3,Cacng3,2,0,2,0,0,0
CACNG4,Cacng4,7,-2,5,8.660194,0,0
CACNG5,Cacng5,2,-6,-4,0,0,0
CACNG6,Cacng6,3,-1,2,0,0,0
CACNG7,Cacng7,7,-2,5,0,0,0
CACNG8,Cacng8,5,-14,-9,0,0,0
CACTIN,Cactin,8,-3,5,3.019417,0,0
CACUL1,Cacul1,8,-3,5,38.281553,0,0
CACYBP,Cacybp,52,3,55,371.640777,56.166667,0
CAD,Cad,7,-7,0,5.504854,0,0
CADM1,Cadm1,13,3,16,0,0,0
CADM2,Cadm2,3,0,3,34.446602,0,0
CADM3,Cadm3,1,-2,-1,0,0,0
CADM4,Cadm4,6,2,8,0,0,0
CADPS,Cadps,0,2,2,0,0,0
CADPS2,Cadps2,2,2,4,10,0,0
CAGE1,Cage1,6,-11,-5,2.640777,0,0
CALB1,Calb1,16,2,18,0,0,0
CALB2,Calb2,8,2,10,0,0,0
CALCA,Calca,24,5,29,0,0,0
CALCB,Calcb,-9,5,-4,0,0,0
CALCOCO1,Calcoco1,11,0,11,1.961165,0,0
CALCOCO2,Calcoco2,5,-16,-11,2.495146,0,0
CALCR,Calcr,0,-1,-1,0,0,0
CALCRL,Calcrl,-1,-4,-5,0,0,0
CALD1,Cald1,12,2,14,2.359223,0,0
CALHM1,Calhm1,0,3,3,0,0,0
CALHM2,Calhm2,-9,-6,-15,0,0,0
CALHM3,Calhm3,8,-7,1,0,0,0
CALHM4,Calhm4,-2,1,-1,12.621359,0,0
CALHM5,Calhm5,4,-9,-5,0,0,0
CALHM6,Calhm6,13,3,16,0,0,0
CALM1,Calm1,4,-2,2,31.116505,4.125,0
CALM2,Calm2,10,-6,4,27.572816,0,0
CALM3,Calm3,7,-1,6,18.504854,0,0
CALML3,Calml3,-1,2,1,0,0,0
CALML4,Calml4,-7,6,-1,0,0,0
CALN1,Caln1,2,-1,1,4.592233,0,0
CALR,Calr,6,0,6,14.737864,0,0
CALR3,Calr3,9,-4,5,52.174757,0,0
CALU,Calu,7,2,9,3.495146,0,0
CALY,Caly,15,1,16,1.320388,0,0
CAMK1,Camk1,6,-3,3,1.368932,0,0
CAMK1D,Camk1d,5,-4,1,0.970874,0,0
CAMK1G,Camk1g,0,-14,-14,3.349515,0,0
CAMK2A,Camk2a,3,-1,2,0,0,0
CAMK2B,Camk2b,7,-2,5,0,0,0
CAMK2D,Camk2d,7,4,11,10.31068,0,0
CAMK2G,Camk2g,4,-3,1,84.271845,37.291667,0
CAMK2N1,Camk2n1,4,2,6,0,0,0
CAMK2N2,Camk2n2,-2,-3,-5,1.106796,0,0
CAMK4,Camk4,4,7,11,5.631068,0,0
CAMKK1,Camkk1,-24,-2,-26,12,0,0
CAMKK2,Camkk2,1,-1,0,5.485437,0,0
CAMKMT,Camkmt,4,-9,-5,21.893204,0,0
CAMKV,Camkv,4,-3,1,0.708738,0,0
CAMP,Camp,9,1,10,0,0,0
CAMSAP1,Camsap1,9,-6,3,2.76699,0,0
CAMSAP2,Camsap2,7,1,8,12.961165,0,0
CAMSAP3,Camsap3,6,0,6,2.223301,0,0
CAMTA1,Camta1,8,-3,5,12.058252,0,0
CAMTA2,Camta2,6,-4,2,2.339806,0,0
CAND1,Cand1,6,-6,0,9.582524,0,0
CAND2,Cand2,1,-9,-8,0,0,0
CANT1,Cant1,2,-4,-2,7.669903,0,0
CANX,Canx,9,-4,5,10.07767,0,0
CAP1,Cap1,8,-3,5,6.747573,0,0
CAP2,Cap2,14,3,17,75.679612,8.833333,0
CAPG,Capg,-2,-1,-3,4.116505,0,0
CAPN1,Capn1,8,-16,-8,4.805825,0,0
CAPN10,Capn10,5,0,5,4.359223,0,0
CAPN11,Capn11,20,0,20,0,0,0
CAPN12,Capn12,9,1,10,0,0,0
CAPN13,Capn13,5,-4,1,1.106796,0,0
CAPN15,Capn15,7,-3,4,2.116505,0,0
CAPN2,Capn2,8,0,8,29.582524,0,0
CAPN3,Capn3,8,1,9,28.815534,0,0
CAPN5,Capn5,5,-6,-1,4.572816,0,0
CAPN6,Capn6,3,-6,-3,0,0,0
CAPN7,Capn7,0,-6,-6,5.786408,0,0
CAPN8,Capn8,6,-7,-1,1.252427,0,0
CAPN9,Capn9,5,-2,3,0,0,0
CAPNS1,Capns1,10,-3,7,6.68932,0,0
CAPNS2,Capns2,10,-8,2,0,0,0
CAPRIN1,Caprin1,7,-3,4,6.679612,0,0
CAPRIN2,Caprin2,9,-9,0,17.776699,0,0
CAPS2,Caps2,1,-10,-9,15.815534,0,0
CAPSL,Capsl,0,5,5,0,0,0
CAPZA1,Capza1,2,-2,0,4.902913,0,0
CAPZA2,Capza2,16,-5,11,6.058252,0,0
CAPZA3,Capza3,0,-3,-3,0,0,0
CAPZB,Capzb,11,-1,10,4.320388,0,0
CARD10,Card10,0,0,0,2.019417,0,0
CARD11,Card11,19,0,19,11.456311,0,0
CARD14,Card14,6,-2,4,12.902913,0,0
CARD19,Card19,-3,-1,-4,3.912621,0,0
CARD6,Card6,-1,-11,-12,0,0,0
CARD9,Card9,39,12,51,0,0,0
CARF,Carf,0,-3,-3,4.165049,0,0
CARHSP1,Carhsp1,7,-3,4,28.650485,0,0
CARM1,Carm1,6,-1,5,7.291262,0,0
CARMIL1,Carmil1,1,-12,-11,6.466019,0,0
CARMIL2,Carmil2,6,1,7,1.23301,0,0
CARMIL3,Carmil3,2,-4,-2,0.728155,0,0
CARNMT1,Carnmt1,4,-2,2,7.582524,0,0
CARNS1,Carns1,-1,-10,-11,0,0,0
CARS2,Cars2,3,-4,-1,3.504854,0,0
CARTPT,Cartpt,6,6,12,0,0,0
CASC3,Casc3,7,-2,5,8.223301,0,0
CASD1,Casd1,0,-4,-4,5.757282,0,0
CASK,Cask,8,2,10,6.864078,0,0
CASKIN1,Caskin1,4,-2,2,0,0,0
CASKIN2,Caskin2,-11,-8,-19,9.048544,0,0
CASP1,Casp1,21,-8,13,6.650485,0,0
CASP12,Casp12,32,3,35,0,0,0
CASP14,Casp14,-1,-3,-4,1.504854,0,0
CASP2,Casp2,5,-3,2,5.31068,0,0
CASP3,Casp3,4,-1,3,6.019417,0,0
CASP4,Casp4,16,0,16,8.058252,0,0
CASP6,Casp6,9,-6,3,0,0,0
CASP7,Casp7,7,-7,0,67.563107,0,0
CASP8,Casp8,1,-3,-2,17.805825,0,0
CASP8AP2,Casp8ap2,3,-2,1,0.864078,0,0
CASP9,Casp9,9,-4,5,41.776699,0,0
CASQ1,Casq1,6,-15,-9,0,0,0
CASQ2,Casq2,-1,2,1,0,0,0
CASR,Casr,-1,2,1,4.262136,0,0
CASS4,Cass4,91,-4,87,0,0,0
CAST,Cast,8,-3,5,16.456311,0,0
CASTOR1,Castor1,6,0,6,0,0,0
CASTOR2,Castor2,8,0,8,4.805825,0,0
CASZ1,Casz1,3,0,3,7.38835,0,0
CAT,Cat,6,0,6,9.68932,0,0
CATIP,Catip,3,-5,-2,0,0,0
CATSPER1,Catsper1,-4,-9,-13,1.009709,0,0
CATSPER2,Catsper2,8,-9,-1,0,0,0
CATSPER3,Catsper3,21,-11,10,0,0,0
CATSPER4,Catsper4,33,-1,32,0,0,0
CATSPERB,Catsperb,19,-10,9,0,0,0
CATSPERD,Catsperd,4,2,6,16.038835,0,0
CATSPERZ,Catsperz,14,-7,7,6.679612,0,115
CAV1,Cav1,7,-3,4,18.757282,0,0
CAV2,Cav2,8,0,8,5.592233,0,0
CAV3,Cav3,3,-1,2,0,0,0
CAVIN1,Cavin1,4,1,5,0,0,0
CAVIN2,Cavin2,0,-7,-7,0,0,0
CAVIN3,Cavin3,-3,2,-1,5.563107,0,0
CAVIN4,Cavin4,8,-7,1,0,0,0
CBARP,Cbarp,-3,6,3,0,0,0
CBFA2T2,Cbfa2t2,5,-2,3,3.533981,0,0
CBFA2T3,Cbfa2t3,35,-1,34,45.349515,0,0
CBFB,Cbfb,4,-2,2,10.194175,0,0
CBL,Cbl,12,-8,4,2.504854,0,0
CBLB,Cblb,8,-1,7,7.427184,0,0
CBLC,Cblc,1,5,6,0,0,0
CBLIF,Cblif,0,-1,-1,0,0,0
CBLL1,Cbll1,5,-4,1,8.660194,0,0
CBLN1,Cbln1,0,-4,-4,0,0,0
CBLN2,Cbln2,4,-1,3,0,0,0
CBLN3,Cbln3,2,-8,-6,11.553398,0,0
CBLN4,Cbln4,-3,5,2,0,0,0
CBR1,Cbr1,9,-3,6,5.553398,0,0
CBR3,Cbr3,6,3,9,2.407767,0,0
CBR4,Cbr4,0,-6,-6,4.543689,0,0
CBS,Cbs,12,0,12,2.417476,0,0
CBWD1,Cbwd1,3,-6,-3,8.300971,4.541667,0
CBX1,Cbx1,8,0,8,9.456311,0,0
CBX2,Cbx2,-7,-17,-24,2.058252,0,0
CBX3,Cbx3,8,-2,6,244.990291,170.833333,94
CBX4,Cbx4,15,0,15,7.038835,0,0
CBX5,Cbx5,10,-2,8,2.485437,0,0
CBX6,Cbx6,1,2,3,8.330097,0,0
CBX7,Cbx7,-5,-2,-7,0,0,0
CBX8,Cbx8,8,-2,6,18.097087,0,0
CBY1,Cby1,5,-9,-4,3.058252,0,0
CBY2,Cby2,-16,0,-16,0,0,0
CBY3,Cby3,-1,-10,-11,2.485437,0,0
CC2D1A,Cc2d1a,7,-4,3,11.757282,0,0
CC2D1B,Cc2d1b,-1,-7,-8,6.475728,0,0
CC2D2A,Cc2d2a,6,-3,3,0,0,0
CC2D2B,Cc2d2b,8,-8,0,2.23301,0,0
CCAR1,Ccar1,10,-6,4,8.262136,0,0
CCAR2,Ccar2,6,-4,2,24.067961,0,0
CCBE1,Ccbe1,6,8,14,0,0,0
CCDC102A,Ccdc102a,7,-14,-7,126.76699,16.791667,0
CCDC103,Ccdc103,2,-9,-7,26.864078,0,0
CCDC105,Ccdc105,0,-13,-13,0,0,0
CCDC106,Ccdc106,15,-9,6,8.097087,0,0
CCDC107,Ccdc107,9,-7,2,62.757282,6.166667,0
CCDC110,Ccdc110,-7,-1,-8,2.048544,0,0
CCDC112,Ccdc112,0,-7,-7,8.398058,0,0
CCDC113,Ccdc113,-1,-6,-7,87.582524,0,0
CCDC115,Ccdc115,8,-5,3,29.184466,0,0
CCDC116,Ccdc116,3,-4,-1,7.708738,0,0
CCDC117,Ccdc117,10,6,16,424.15534,226.166667,285
CCDC12,Ccdc12,1,-12,-11,3.504854,0,0
CCDC120,Ccdc120,-11,-4,-15,0,0,0
CCDC121,Ccdc121,113,-8,105,130.640777,9.583333,0
CCDC122,Ccdc122,7,-5,2,1.84466,0,0
CCDC124,Ccdc124,10,-6,4,8.15534,0,0
CCDC125,Ccdc125,1,0,1,1.23301,0,0
CCDC126,Ccdc126,7,-3,4,8.737864,0,0
CCDC127,Ccdc127,5,-2,3,25.446602,0,0
CCDC13,Ccdc13,30,-9,21,19.417476,0,0
CCDC134,Ccdc134,7,-5,2,1.543689,0,0
CCDC136,Ccdc136,9,-10,-1,2.786408,0,0
CCDC137,Ccdc137,-1,-1,-2,2.660194,0,0
CCDC138,Ccdc138,9,-1,8,12.291262,0,0
CCDC14,Ccdc14,-3,-9,-12,11.15534,0,0
CCDC141,Ccdc141,-2,2,0,0,0,0
CCDC142,Ccdc142,7,-6,1,1.970874,0,0
CCDC146,Ccdc146,0,-7,-7,7.398058,0,0
CCDC148,Ccdc148,5,-5,0,11.398058,0,0
CCDC149,Ccdc149,5,3,8,3.135922,0,0
CCDC15,Ccdc15,-1,-5,-6,2.320388,0,0
CCDC150,Ccdc150,3,-9,-6,6.902913,0,0
CCDC152,Ccdc152,3,-10,-7,0.912621,0,0
CCDC153,Ccdc153,-5,-2,-7,0,0,0
CCDC154,Ccdc154,17,-9,8,2.252427,0,0
CCDC157,Ccdc157,-2,0,-2,56.941748,0,0
CCDC158,Ccdc158,2,3,5,0,0,0
CCDC159,Ccdc159,-2,-9,-11,5.417476,0,0
CCDC160,Ccdc160,0,-1,-1,0,0,0
CCDC163,Ccdc163,11,0,11,11.757282,0,0
CCDC166,Ccdc166,21,-9,12,1.300971,0,0
CCDC167,Ccdc167,-1,-7,-8,0,0,0
CCDC169,Ccdc169,0,-13,-13,0,0,0
CCDC17,Ccdc17,9,-8,1,0,0,0
CCDC170,Ccdc170,-1,1,0,3.029126,0,0
CCDC171,Ccdc171,2,-7,-5,1.825243,0,0
CCDC172,Ccdc172,3,2,5,1.368932,0,0
CCDC174,Ccdc174,2,-7,-5,5.398058,0,142
CCDC175,Ccdc175,0,-6,-6,23.92233,0,0
CCDC177,Ccdc177,-1,-1,-2,0,0,0
CCDC178,Ccdc178,-3,-8,-11,0,0,0
CCDC18,Ccdc18,5,-8,-3,54.252427,19,0
CCDC180,Ccdc180,3,-12,-9,0,0,0
CCDC181,Ccdc181,3,-7,-4,0,0,0
CCDC182,Ccdc182,4,-6,-2,1.330097,0,0
CCDC183,Ccdc183,5,-11,-6,1.194175,0,0
CCDC184,Ccdc184,6,-1,5,9.941748,0,0
CCDC185,Ccdc185,2,-4,-2,3.446602,0,0
CCDC186,Ccdc186,1,2,3,15.883495,0,0
CCDC187,Ccdc187,14,2,16,0,0,0
CCDC188,Ccdc188,-15,3,-12,0,0,0
CCDC189,Ccdc189,0,-5,-5,0,0,0
CCDC190,Ccdc190,-11,4,-7,0,0,0
CCDC191,Ccdc191,3,-5,-2,30.38835,0,0
CCDC192,Ccdc192,-1,-5,-6,0,0,0
CCDC194,Ccdc194,47,15,62,0,0,0
CCDC198,ccdc198,17,9,26,0,0,0
CCDC201,Ccdc201,3,-3,0,0,0,0
CCDC22,Ccdc22,3,-1,2,0,0,0
CCDC24,Ccdc24,4,-2,2,16.378641,0,0
CCDC25,Ccdc25,7,-9,-2,0,0,0
CCDC27,Ccdc27,2,2,4,18.029126,0,0
CCDC28A,Ccdc28a,0,-8,-8,0,0,0
CCDC28B,Ccdc28b,18,2,20,65.466019,0,0
CCDC3,Ccdc3,2,-1,1,0,0,0
CCDC30,Ccdc30,5,-9,-4,36.087379,0,0
CCDC32,Ccdc32,3,-5,-2,18.640777,0,0
CCDC33,Ccdc33,8,0,8,0,0,0
CCDC34,Ccdc34,5,-5,0,70.912621,0,0
CCDC38,Ccdc38,8,-12,-4,1.009709,0,0
CCDC39,Ccdc39,-3,-12,-15,18.456311,0,0
CCDC40,Ccdc40,6,-7,-1,28.572816,0,0
CCDC42,Ccdc42,7,-7,0,1.184466,0,0
CCDC43,Ccdc43,1,-7,-6,7.854369,0,0
CCDC47,Ccdc47,5,-8,-3,11,0,0
CCDC50,Ccdc50,9,-7,2,7.407767,0,0
CCDC51,Ccdc51,-3,-3,-6,0.796117,0,0
CCDC54,Ccdc54,9,0,9,0,0,0
CCDC57,Ccdc57,-5,-2,-7,69.679612,0,0
CCDC59,Ccdc59,4,0,4,13.951456,0,0
CCDC6,Ccdc6,11,-3,8,9.145631,0,0
CCDC60,Ccdc60,0,-8,-8,1.728155,0,0
CCDC61,Ccdc61,-12,-4,-16,0,0,0
CCDC62,Ccdc62,18,-18,0,0,0,0
CCDC63,Ccdc63,5,-10,-5,0,0,0
CCDC65,Ccdc65,10,-10,0,0,0,0
CCDC66,Ccdc66,3,0,3,2.504854,0,0
CCDC68,Ccdc68,0,8,8,7.23301,0,0
CCDC69,Ccdc69,3,4,7,1.097087,0,0
CCDC70,Ccdc70,12,-1,11,2.135922,0,0
CCDC71,Ccdc71,-31,-8,-39,17.38835,0,0
CCDC71L,Ccdc71l,4,-1,3,8.300971,0,0
CCDC73,Ccdc73,10,1,11,0,0,0
CCDC74A,Ccdc74a,-3,-9,-12,9.126214,0,0
CCDC77,Ccdc77,6,-8,-2,50.135922,0,0
CCDC78,Ccdc78,0,-3,-3,1.194175,0,0
CCDC8,Ccdc8,-3,-4,-7,0,0,0
CCDC80,Ccdc80,1,-3,-2,0,0,0
CCDC81,Ccdc81,109,-2,107,0,0,0
CCDC82,Ccdc82,3,-4,-1,6.097087,0,0
CCDC83,Ccdc83,3,-8,-5,27.718447,0,0
CCDC85A,Ccdc85a,0,2,2,3.116505,0,0
CCDC85B,Ccdc85b,-3,1,-2,9.475728,0,0
CCDC85C,Ccdc85c,1,3,4,9.436893,0,0
CCDC86,Ccdc86,1,0,1,7.912621,0,0
CCDC87,Ccdc87,-7,-8,-15,30.058252,0,0
CCDC88A,Ccdc88a,8,-9,-1,49.572816,0,0
CCDC88B,Ccdc88b,8,-7,1,1.067961,0,0
CCDC88C,Ccdc88c,7,1,8,8.466019,0,0
CCDC89,Ccdc89,25,-10,15,0,0,0
CCDC9,Ccdc9,11,-5,6,8.029126,0,0
CCDC90B,Ccdc90b,9,-5,4,6.563107,0,0
CCDC91,Ccdc91,5,-13,-8,13.893204,0,0
CCDC92,Ccdc92,6,-6,0,30.398058,0,0
CCDC93,Ccdc93,6,-1,5,3.271845,0,0
CCDC96,Ccdc96,11,-4,7,54.31068,0,0
CCDC97,Ccdc97,10,-2,8,13.417476,0,0
CCDC9B,Ccdc9b,-2,0,-2,2.902913,0,0
CCER1,Ccer1,0,-4,-4,0,0,0
CCER2,Ccer2,-5,18,13,0,0,0
CCHCR1,Cchcr1,13,-9,4,1.300971,0,0
CCIN,Ccin,13,5,18,18.980583,0,0
CCK,Cck,6,12,18,7,0,0
CCKAR,Cckar,1,5,6,0,0,0
CCKBR,Cckbr,1,-1,0,0,0,0
CCL1,Ccl1,-1,2,1,0,0,0
CCL11,Ccl11,-1,19,18,0,0,0
CCL17,Ccl17,9,-1,8,0.92233,0,0
CCL19,Ccl19,6,-3,3,0,0,0
CCL2,Ccl2,16,0,16,0,0,0
CCL20,Ccl20,62,2,64,10.194175,0,115
CCL22,Ccl22,5,4,9,0,0,0
CCL24,Ccl24,7,3,10,0,0,0
CCL25,Ccl25,17,-2,15,0,0,0
CCL26,Ccl26,95,-3,92,14.524272,0,0
CCL28,Ccl28,4,-7,-3,1.145631,0,0
CCL3,Ccl3,1,2,3,1.592233,0,0
CCL4,Ccl4,1,-10,-9,0,0,0
CCL5,Ccl5,-1,6,5,0,0,0
CCL7,Ccl7,-3,2,-1,0,0,0
CCL8,Ccl8,0,12,12,0,0,0
CCM2,Ccm2,6,-3,3,0.932039,0,0
CCM2L,Ccm2l,-2,1,-1,0,0,0
CCN1,Ccn1,18,30,48,14.902913,0,0
CCN2,Ccn2,6,8,14,4.398058,0,0
CCN3,Ccn3,0,-10,-10,45.165049,0,0
CCN4,Ccn4,7,-5,2,0,0,0
CCN5,Ccn5,-1,-12,-13,2.834951,0,0
CCN6,Ccn6,-8,-9,-17,0,0,0
CCNA1,Ccna1,-2,-3,-5,7.902913,0,0
CCNA2,Ccna2,-9,-8,-17,6.893204,0,0
CCNB1,Ccnb1,-3,-24,-27,19.038835,0,0
CCNB1IP1,Ccnb1ip1,7,38,45,0,0,0
CCNB2,Ccnb2,7,-9,-2,0,0,0
CCNB3,Ccnb3,-4,10,6,0,0,0
CCNC,Ccnc,2,-5,-3,13.582524,0,0
CCND1,Ccnd1,-2,-9,-11,2.271845,0,0
CCND2,Ccnd2,12,5,17,2.116505,0,0
CCND3,Ccnd3,8,3,11,79.456311,47.666667,114
CCNDBP1,Ccndbp1,6,0,6,5.291262,0,0
CCNE1,Ccne1,-3,-9,-12,0.873786,0,0
CCNE2,Ccne2,-10,-6,-16,3.38835,0,0
CCNF,Ccnf,-17,-16,-33,2.834951,0,0
CCNG1,Ccng1,7,2,9,51.854369,0,0
CCNG2,Ccng2,1,-8,-7,1.737864,0,0
CCNH,Ccnh,7,1,8,7.912621,0,0
CCNI,Ccni,8,-3,5,2.135922,0,0
CCNJ,Ccnj,-6,-17,-23,5.145631,0,0
CCNJL,Ccnjl,-2,1,-1,4.067961,0,0
CCNK,Ccnk,3,-2,1,3.407767,0,0
CCNL1,Ccnl1,7,0,7,28.291262,3.666667,0
CCNL2,Ccnl2,4,-3,1,7.271845,0,0
CCNO,Ccno,37,-2,35,25.621359,0,0
CCNQ,Ccnq,4,-10,-6,2.126214,0,0
CCNT1,Ccnt1,6,1,7,8.242718,0,0
CCNT2,Ccnt2,4,-2,2,11.563107,0,0
CCNY,Ccny,5,-4,1,14.058252,0,0
CCNYL1,Ccnyl1,8,-4,4,4.737864,0,0
CCP110,Ccp110,1,-5,-4,14.563107,0,0
CCPG1,Ccpg1,2,-1,1,18.223301,0,0
CCR1,Ccr1,-16,3,-13,0,0,0
CCR10,Ccr10,5,-7,-2,1.902913,0,0
CCR2,Ccr2,3,-2,1,3.048544,0,0
CCR3,Ccr3,-6,-4,-10,0,0,0
CCR4,Ccr4,1,0,1,0,0,0
CCR5,Ccr5,-1,13,12,2.592233,0,0
CCR6,Ccr6,-1,3,2,0,0,0
CCR7,Ccr7,-6,-2,-8,0,0,0
CCR8,Ccr8,-1,3,2,0,0,0
CCR9,Ccr9,-2,-1,-3,5.252427,0,0
CCRL2,Ccrl2,-23,-3,-26,0,0,0
CCS,Ccs,4,-7,-3,30.058252,0,0
CCSAP,Ccsap,8,-10,-2,0.932039,0,0
CCSER1,Ccser1,14,-1,13,5.747573,0,0
CCSER2,Ccser2,0,-13,-13,2.213592,0,0
CCT2,Cct2,5,-2,3,57.563107,4.875,0
CCT3,Cct3,11,-1,10,196.699029,24.75,146
CCT4,Cct4,12,0,12,534.825243,257.708333,421
CCT5,Cct5,12,2,14,178.009709,59.041667,0
CCT6A,Cct6a,8,-1,7,187.699029,98.958333,0
CCT6B,Cct6b,-6,-6,-12,0,0,0
CCT7,Cct7,9,-2,7,161.194175,11.5,181
CCT8,Cct8,8,0,8,95.825243,8.666667,0
CCZ1,Ccz1,1,-9,-8,6.165049,0,0
CD101,Cd101,2,4,6,2,0,0
CD109,Cd109,2,-10,-8,4.446602,0,0
CD14,Cd14,70,1,71,0,0,0
CD151,Cd151,11,3,14,0.873786,0,0
CD160,Cd160,17,-6,11,4.631068,0,0
CD163,Cd163,15,-1,14,14.621359,0,0
CD164,Cd164,8,-2,6,6.407767,0,0
CD164L2,Cd164l2,17,6,23,31.019417,0,0
CD177,Cd177,4,-5,-1,0,0,0
CD180,Cd180,-1,-16,-17,6.708738,0,0
CD19,Cd19,4,2,6,0,0,0
CD2,Cd2,2,1,3,0,0,0
CD200,Cd200,7,-9,-2,0,0,0
CD200R1,Cd200r1,6,-4,2,1.92233,0,0
CD207,Cd207,3,-2,1,0,0,0
CD22,Cd22,-3,-3,-6,0,0,0
CD226,Cd226,2,1,3,0,0,0
CD247,Cd247,5,-3,2,0,0,0
CD248,Cd248,-1,-11,-12,0.990291,0,0
CD27,Cd27,6,-2,4,0,0,0
CD274,Cd274,-5,-6,-11,3.407767,0,0
CD276,Cd276,7,-9,-2,2.864078,0,0
CD28,Cd28,3,5,8,0.932039,0,0
CD2AP,Cd2ap,1,-3,-2,4.873786,0,0
CD2BP2,Cd2bp2,8,-2,6,5.737864,0,0
CD300A,Cd300a,0,3,3,1.058252,0,0
CD300C,Cd300c,1,0,1,0,0,0
CD300E,Cd300e,2,1,3,0,0,0
CD300LB,Cd300lb,9,-1,8,0,0,0
CD300LD,Cd300ld,-3,-2,-5,0,0,0
CD300LF,Cd300lf,1,3,4,2.679612,0,0
CD300LG,Cd300lg,0,-5,-5,0,0,0
CD302,Cd302,4,3,7,1.718447,0,0
CD320,Cd320,2,-3,-1,8.805825,0,0
CD33,Cd33,3,-4,-1,1.067961,0,0
CD34,Cd34,0,4,4,0,0,0
CD36,Cd36,1,3,4,0,0,0
CD37,Cd37,-4,-6,-10,0,0,0
CD38,Cd38,-1,-1,-2,0,0,0
CD3D,Cd3d,-11,-5,-16,0,0,0
CD3E,Cd3e,0,13,13,0,0,0
CD3G,Cd3g,1,-2,-1,0,0,0
CD4,Cd4,19,-2,17,0,0,0
CD40,Cd40,-2,-6,-8,8.970874,0,0
CD40LG,Cd40lg,2,-2,0,0,0,0
CD44,Cd44,11,4,15,3.902913,0,0
CD46,Cd46,5,-15,-10,6.378641,0,0
CD47,Cd47,1,-2,-1,10.84466,0,0
CD48,Cd48,5,1,6,0,0,0
CD5,Cd5,-6,0,-6,0,0,0
CD52,Cd52,13,-5,8,0,0,0
CD53,Cd53,6,9,15,0,0,0
CD55,Cd55,5,-6,-1,24.252427,4.458333,0
CD5L,Cd5l,1,-2,-1,0,0,0
CD6,Cd6,1,3,4,0,0,0
CD63,Cd63,3,0,3,16.300971,0,0
CD68,Cd68,12,3,15,2.485437,0,0
CD69,Cd69,-3,-6,-9,0,0,0
CD7,Cd7,29,-3,26,0,0,0
CD70,Cd70,-8,2,-6,2.135922,0,0
CD72,Cd72,0,-10,-10,3.029126,0,0
CD74,Cd74,28,-2,26,0,0,0
CD79A,Cd79a,40,18,58,0,0,0
CD79B,Cd79b,13,12,25,0,0,0
CD80,Cd80,9,1,10,0,0,0
CD81,Cd81,10,3,13,0,0,0
CD82,Cd82,4,-6,-2,0,0,0
CD83,Cd83,11,12,23,11.145631,0,0
CD84,Cd84,2,0,2,0,0,0
CD86,Cd86,-2,0,-2,0,0,0
CD8A,Cd8a,1,-5,-4,0,0,0
CD9,Cd9,5,-1,4,8.417476,0,0
CD93,Cd93,-1,4,3,0,0,0
CD96,Cd96,6,-5,1,0,0,0
CD99L2,Cd99l2,8,0,8,1.737864,0,0
CDA,Cda,-3,-1,-4,0,0,0
CDADC1,Cdadc1,-6,-2,-8,1.592233,0,0
CDAN1,Cdan1,-1,-4,-5,3.320388,0,0
CDC123,Cdc123,3,-9,-6,0,0,0
CDC14A,Cdc14a,4,2,6,62.980583,0,0
CDC14B,Cdc14b,5,-5,0,4.592233,0,0
CDC16,Cdc16,2,-4,-2,4.68932,0,0
CDC20,Cdc20,-6,-9,-15,2.553398,0,0
CDC20B,Cdc20b,2,-8,-6,2.796117,0,0
CDC23,Cdc23,7,-4,3,0,0,0
CDC25A,Cdc25a,-11,-2,-13,1.951456,0,0
CDC25B,Cdc25b,7,-5,2,12.009709,0,0
CDC25C,Cdc25c,3,-20,-17,5.932039,0,0
CDC26,Cdc26,12,2,14,9.834951,0,0
CDC27,Cdc27,9,-6,3,7.776699,0,0
CDC34,Cdc34,1,-10,-9,0,0,0
CDC37,Cdc37,5,-1,4,60.563107,0,0
CDC37L1,Cdc37l1,3,-5,-2,7.631068,0,0
CDC40,Cdc40,1,-2,-1,1.76699,0,0
CDC42,Cdc42,7,-4,3,4.631068,0,0
CDC42BPA,Cdc42bpa,8,-1,7,17.601942,0,0
CDC42BPB,Cdc42bpb,11,1,12,11.223301,0,0
CDC42BPG,Cdc42bpg,-1,-2,-3,1.504854,0,0
CDC42EP1,Cdc42ep1,-2,-3,-5,2.582524,0,0
CDC42EP2,Cdc42ep2,18,-15,3,8.417476,0,0
CDC42EP3,Cdc42ep3,10,-5,5,11.475728,0,0
CDC42EP4,Cdc42ep4,16,1,17,8.135922,0,0
CDC42EP5,Cdc42ep5,-9,-11,-20,0,0,0
CDC42SE1,Cdc42se1,6,-4,2,10.15534,0,0
CDC42SE2,Cdc42se2,7,-6,1,2.912621,0,0
CDC45,Cdc45,-3,-8,-11,2.737864,0,0
CDC5L,Cdc5l,5,-7,-2,2.485437,0,0
CDC6,Cdc6,1,-8,-7,48.203883,0,0
CDC7,Cdc7,-6,-9,-15,5.854369,0,0
CDC73,Cdc73,6,-2,4,7.07767,0,0
CDCA2,Cdca2,-2,-8,-10,2.601942,0,0
CDCA3,Cdca3,4,-21,-17,0,0,0
CDCA4,Cdca4,-19,-3,-22,12.514563,0,0
CDCA5,Cdca5,8,-11,-3,19.902913,0,0
CDCA7,Cdca7,-5,-8,-13,11.932039,0,0
CDCA7L,Cdca7l,3,-9,-6,3.834951,0,0
CDCA8,Cdca8,-19,-4,-23,1.349515,0,0
CDCP1,Cdcp1,1,2,3,1.650485,0,0
CDCP2,Cdcp2,0,10,10,0,0,0
CDH1,Cdh1,-1,6,5,1.339806,0,0
CDH10,Cdh10,2,-1,1,0,0,0
CDH11,Cdh11,-1,-5,-6,2.300971,0,0
CDH12,Cdh12,2,-4,-2,0,0,0
CDH13,Cdh13,1,-4,-3,2.359223,0,0
CDH15,Cdh15,7,-1,6,0,0,0
CDH16,Cdh16,18,-2,16,0,0,0
CDH17,Cdh17,10,-2,8,11.61165,0,0
CDH18,Cdh18,-1,-13,-14,0,0,0
CDH19,Cdh19,2,2,4,0,0,0
CDH2,Cdh2,9,0,9,0,0,0
CDH20,Cdh20,4,-5,-1,0,0,0
CDH22,Cdh22,0,-2,-2,0,0,0
CDH23,Cdh23,-1,-4,-5,0,0,0
CDH24,Cdh24,4,-3,1,2.194175,0,0
CDH26,Cdh26,8,-9,-1,13.436893,0,0
CDH3,Cdh3,7,0,7,0,0,0
CDH4,Cdh4,5,0,5,8.504854,0,0
CDH5,Cdh5,5,2,7,0,0,0
CDH6,Cdh6,4,0,4,0.864078,0,0
CDH7,Cdh7,2,1,3,0,0,0
CDH8,Cdh8,3,-1,2,0,0,0
CDH9,Cdh9,-2,-1,-3,0,0,0
CDHR1,Cdhr1,8,0,8,0,0,0
CDHR2,Cdhr2,-1,0,-1,1.92233,0,0
CDHR3,Cdhr3,3,3,6,0,0,0
CDHR4,Cdhr4,3,-4,-1,1.058252,0,0
CDHR5,Cdhr5,8,6,14,0,0,0
CDIN1,Cdin1,2,-7,-5,0,0,0
CDIP1,Cdip1,10,-1,9,6.019417,0,0
CDIPT,Cdipt,8,-1,7,4.912621,0,0
CDK1,Cdk1,1,-7,-6,8.786408,0,0
CDK10,Cdk10,5,-4,1,0,0,0
CDK11B,Cdk11b,13,-1,12,5.786408,0,0
CDK12,Cdk12,5,-4,1,15.427184,0,0
CDK13,Cdk13,8,2,10,1.126214,0,0
CDK14,Cdk14,1,-9,-8,11.815534,0,0
CDK15,Cdk15,-8,-3,-11,0,0,0
CDK16,Cdk16,3,0,3,4.203883,0,0
CDK17,Cdk17,9,2,11,4.533981,0,0
CDK18,Cdk18,6,-4,2,4.912621,0,0
CDK19,Cdk19,3,-3,0,3.31068,0,0
CDK2,Cdk2,1,-3,-2,1.747573,0,0
CDK20,Cdk20,2,0,2,0,0,0
CDK2AP1,Cdk2ap1,5,-4,1,14.650485,0,0
CDK2AP2,Cdk2ap2,13,5,18,0,0,0
CDK4,Cdk4,7,3,10,32.92233,0,0
CDK5,Cdk5,6,-2,4,4.446602,0,0
CDK5R1,Cdk5r1,13,-7,6,2.864078,0,0
CDK5R2,Cdk5r2,0,0,0,0,0,0
CDK5RAP1,Cdk5rap1,4,-2,2,14.330097,0,0
CDK5RAP2,Cdk5rap2,5,-4,1,6.990291,0,0
CDK5RAP3,Cdk5rap3,4,-7,-3,9.029126,0,0
CDK6,Cdk6,7,0,7,10.815534,0,0
CDK7,Cdk7,2,-6,-4,0,0,0
CDK8,Cdk8,4,-2,2,1.747573,0,0
CDK9,Cdk9,8,-2,6,12.932039,0,0
CDKAL1,Cdkal1,3,-3,0,1.805825,0,0
CDKL1,Cdkl1,-1,-16,-17,29.213592,0,0
CDKL2,Cdkl2,15,-4,11,0,0,0
CDKL3,Cdkl3,14,-8,6,97.650485,0,0
CDKL4,Cdkl4,12,-4,8,1.514563,0,0
CDKL5,Cdkl5,7,-6,1,7.76699,0,0
CDKN1A,Cdkn1a,12,22,34,2.495146,0,0
CDKN1B,Cdkn1b,-1,0,-1,12.601942,0,0
CDKN1C,Cdkn1c,34,3,37,0,0,0
CDKN2A,Cdkn2a,11,-6,5,22.174757,0,0
CDKN2AIP,Cdkn2aip,14,-3,11,5.669903,0,0
CDKN2AIPNL,Cdkn2aipnl,8,-1,7,18.805825,0,0
CDKN2B,Cdkn2b,19,2,21,3.864078,0,0
CDKN2C,Cdkn2c,32,-7,25,8.737864,0,0
CDKN2D,Cdkn2d,-1,-2,-3,9.883495,0,0
CDKN3,Cdkn3,-7,-20,-27,2.961165,0,0
CDNF,Cdnf,3,-4,-1,0,0,0
CDO1,Cdo1,21,5,26,0,0,0
CDON,Cdon,6,-4,2,5.834951,0,0
CDPF1,Cdpf1,-8,-11,-19,4.485437,0,0
CDR1,Cdr1,1,-3,-2,4.242718,0,0
CDR2,Cdr2,7,-3,4,3.145631,0,0
CDR2L,Cdr2l,6,-3,3,4.126214,0,0
CDRT4,Cdrt4,-9,-1,-10,0,0,0
CDS1,Cds1,-3,-4,-7,4.184466,0,0
CDS2,Cds2,6,-2,4,10.466019,0,0
CDSN,Cdsn,-2,-9,-11,11.68932,0,0
CDT1,Cdt1,2,1,3,4.097087,0,0
CDV3,Cdv3,7,4,11,2.582524,0,0
CDX1,Cdx1,-2,6,4,0,0,0
CDX2,Cdx2,4,1,5,0,0,0
CDX4,Cdx4,0,-2,-2,0,0,0
CDYL,Cdyl,10,-2,8,4.553398,0,0
CDYL2,Cdyl2,3,0,3,3.223301,0,0
CEACAM1,Ceacam1,-9,1,-8,0,0,0
CEACAM16,Ceacam16,17,-1,16,3.951456,0,0
CEACAM18,Ceacam18,0,-2,-2,0,0,0
CEACAM19,Ceacam19,0,-4,-4,16.038835,0,0
CEACAM20,Ceacam20,6,-6,0,2.815534,0,0
CEACAM3,Ceacam3,-2,5,3,0,0,0
CEACAM5,Ceacam5,7,-1,6,0,0,0
CEBPA,Cebpa,1,-4,-3,12.796117,0,0
CEBPB,Cebpb,-1,22,21,3.106796,0,0
CEBPD,Cebpd,6,10,16,2.737864,0,0
CEBPE,Cebpe,8,2,10,0.873786,0,0
CEBPG,Cebpg,6,2,8,2.466019,0,0
CEBPZ,Cebpz,3,1,4,0.728155,0,0
CEBPZOS,Cebpzos,8,0,8,2.553398,0,0
CECR2,Cecr2,9,1,10,4.854369,0,0
CEL,Cel,13,8,21,0,0,0
CELA1,Cela1,8,5,13,0,0,0
CELA2A,Cela2a,5,1,6,0,0,0
CELA3A,Cela3a,0,1,1,0,0,0
CELA3B,Cela3b,-4,6,2,0,0,0
CELF1,Celf1,1,-3,-2,13.271845,0,0
CELF2,Celf2,26,-7,19,7.524272,0,0
CELF3,Celf3,3,-14,-11,5.883495,0,0
CELF4,Celf4,-1,-4,-5,0,0,0
CELF5,Celf5,5,0,5,0,0,0
CELF6,Celf6,4,-6,-2,1.359223,0,0
CELSR1,Celsr1,13,-4,9,110.184466,5.458333,0
CELSR2,Celsr2,8,5,13,2.398058,0,0
CELSR3,Celsr3,8,1,9,3.407767,0,0
CEMIP,Cemip,-1,-12,-13,5.466019,0,0
CEMIP2,Cemip2,10,-1,9,6.504854,0,0
CEND1,Cend1,7,-3,4,0,0,0
CENPA,Cenpa,6,-9,-3,81.097087,0,0
CENPB,Cenpb,-2,-3,-5,12.009709,0,0
CENPE,Cenpe,-1,-14,-15,7.951456,0,0
CENPF,Cenpf,5,-12,-7,1.23301,0,0
CENPH,Cenph,1,-10,-9,14.242718,0,0
CENPI,Cenpi,2,-12,-10,0,0,0
CENPJ,Cenpj,-3,-1,-4,0,0,0
CENPK,Cenpk,6,-3,3,0,0,0
CENPL,Cenpl,0,-6,-6,13.776699,0,0
CENPM,Cenpm,4,-6,-2,0.980583,0,0
CENPN,Cenpn,0,-10,-10,3.31068,0,0
CENPO,Cenpo,3,-6,-3,5.281553,0,0
CENPP,Cenpp,-6,-3,-9,7.796117,0,0
CENPQ,Cenpq,2,-8,-6,0,0,0
CENPS,Cenps,-1,-5,-6,49.961165,0,0
CENPT,Cenpt,1,-12,-11,83.029126,0,0
CENPU,Cenpu,-1,-17,-18,0,0,0
CENPV,Cenpv,23,-9,14,0,0,0
CENPW,Cenpw,3,-5,-2,1.135922,0,0
CENPX,Cenpx,8,0,8,2.582524,0,0
CEP104,Cep104,7,-4,3,15.252427,0,0
CEP112,Cep112,3,-12,-9,68.757282,0,0
CEP120,Cep120,2,-6,-4,16.339806,0,0
CEP126,Cep126,1,-5,-4,18.951456,0,0
CEP128,Cep128,4,-1,3,5.834951,0,0
CEP131,Cep131,6,-10,-4,1.252427,0,0
CEP135,Cep135,1,-1,0,31.592233,4.791667,0
CEP152,Cep152,7,-3,4,25.883495,0,0
CEP162,Cep162,5,1,6,1.757282,0,0
CEP164,Cep164,2,-3,-1,13.019417,0,0
CEP170,Cep170,7,-4,3,4.456311,0,0
CEP170B,Cep170b,1,-1,0,3.31068,0,0
CEP19,Cep19,12,-11,1,43.621359,0,0
CEP192,Cep192,-5,-11,-16,9.728155,0,0
CEP20,Cep20,2,-5,-3,5.650485,0,0
CEP250,Cep250,4,-7,-3,11.23301,0,0
CEP290,Cep290,0,-9,-9,12.786408,0,0
CEP295,Cep295,-3,-5,-8,5.15534,0,0
CEP295NL,Cep295nl,57,0,57,5.825243,0,0
CEP350,Cep350,6,-7,-1,3.475728,0,0
CEP41,Cep41,1,-6,-5,57.31068,0,0
CEP43,Cep43,5,-10,-5,14.660194,0,0
CEP44,Cep44,5,-2,3,0,0,0
CEP55,Cep55,4,-10,-6,2.961165,0,0
CEP57,Cep57,7,-5,2,5.786408,0,0
CEP57L1,Cep57l1,-4,-13,-17,13.757282,0,0
CEP63,Cep63,-1,-4,-5,3.466019,0,0
CEP68,Cep68,-6,-7,-13,4.029126,0,0
CEP70,Cep70,6,-13,-7,2.640777,0,0
CEP72,Cep72,-7,-11,-18,3.533981,0,0
CEP76,Cep76,4,-1,3,8.019417,0,0
CEP78,Cep78,3,-6,-3,2.475728,0,0
CEP83,Cep83,-1,-2,-3,5.669903,0,0
CEP85,Cep85,-7,-4,-11,1.951456,0,0
CEP85L,Cep85l,5,-7,-2,2.718447,0,0
CEP89,Cep89,5,0,5,2.961165,0,0
CEP95,Cep95,8,-3,5,0,0,0
CEP97,Cep97,5,0,5,1.368932,0,0
CEPT1,Cept1,3,-7,-4,3.592233,0,0
CER1,Cer1,-1,-3,-4,0,0,0
CERCAM,Cercam,4,-8,-4,9.145631,0,0
CERK,Cerk,6,0,6,0,0,0
CERKL,Cerkl,0,-6,-6,9.718447,0,0
CERS1,Cers1,29,2,31,7.92233,0,0
CERS2,Cers2,9,2,11,3.883495,0,0
CERS3,Cers3,8,4,12,0,0,0
CERS4,Cers4,11,-9,2,0,0,0
CERS5,Cers5,2,1,3,4.223301,0,0
CERS6,Cers6,8,5,13,20.834951,0,0
CERT1,Cert1,9,-4,5,4.456311,0,0
CES4A,Ces4a,2,-2,0,15.504854,0,267
CES5A,Ces5a,5,-6,-1,0,0,0
CETN1,Cetn1,4,-4,0,17.951456,0,0
CETN2,Cetn2,4,2,6,4.407767,0,0
CETN3,Cetn3,2,-12,-10,1.563107,0,0
CFAP100,Cfap100,-4,-7,-11,0,0,0
CFAP126,Cfap126,8,-9,-1,0,0,0
CFAP157,Cfap157,6,-7,-1,0,0,0
CFAP161,Cfap161,4,1,5,0,0,0
CFAP20,Cfap20,9,5,14,14.281553,0,0
CFAP206,Cfap206,14,-4,10,11.019417,0,0
CFAP20DC,Cfap20dc,14,-4,10,34.194175,0,0
CFAP221,Cfap221,15,-5,10,8.621359,0,0
CFAP298,Cfap298,2,-5,-3,16.281553,0,0
CFAP299,Cfap299,-2,-4,-6,0,0,0
CFAP300,Cfap300,11,8,19,0,0,0
CFAP36,Cfap36,4,-5,-1,34.242718,0,0
CFAP410,Cfap410,2,-4,-2,11.262136,0,0
CFAP43,Cfap43,19,-10,9,84.495146,0,0
CFAP44,Cfap44,30,-8,22,0,0,0
CFAP45,Cfap45,-7,-9,-16,7.679612,0,0
CFAP46,Cfap46,-5,-7,-12,11.31068,0,0
CFAP47,Cfap47,-4,0,-4,0,0,0
CFAP52,Cfap52,8,-4,4,11.582524,0,0
CFAP53,Cfap53,72,-7,65,7.106796,0,0
CFAP54,Cfap54,5,-4,1,125.533981,0,0
CFAP57,Cfap57,-6,-5,-11,21.475728,0,0
CFAP58,Cfap58,1,-8,-7,34.563107,0,0
CFAP61,Cfap61,33,-4,29,18.786408,0,0
CFAP65,Cfap65,16,-5,11,0,0,0
CFAP69,Cfap69,14,2,16,17.980583,0,0
CFAP70,Cfap70,14,-7,7,3.31068,0,0
CFAP73,Cfap73,-11,-5,-16,3.252427,0,0
CFAP74,Cfap74,-3,-11,-14,41.262136,0,0
CFAP77,Cfap77,3,-7,-4,22.378641,0,0
CFAP91,Cfap91,-3,-9,-12,104.970874,0,0
CFAP97,Cfap97,5,-13,-8,42.07767,0,0
CFAP97D1,Cfap97d1,2,7,9,62.320388,0,0
CFAP97D2,Cfap97d2,53,-11,42,0,0,0
CFAP99,Cfap99,2,-7,-5,26.61165,0,0
CFB,Cfb,9,1,10,0,0,0
CFC1,Cfc1,2,3,5,0,0,0
CFD,Cfd,8,14,22,13.563107,0,0
CFDP1,Cfdp1,11,-3,8,12.76699,0,0
CFH,Cfh,0,5,5,1.339806,0,0
CFHR1,Cfhr1,1,-6,-5,0,0,0
CFHR2,Cfhr2,-4,-2,-6,0,0,0
CFHR4,Cfhr4,1,-4,-3,1.563107,0,0
CFI,Cfi,-4,7,3,0,0,0
CFL1,Cfl1,9,-5,4,11.660194,0,0
CFL2,Cfl2,8,-1,7,7.349515,0,0
CFLAR,Cflar,4,2,6,15.252427,0,0
CFP,Cfp,70,1,71,0,0,0
CFTR,Cftr,3,-6,-3,0,0,0
CGA,Cga,20,-5,15,0,0,0
CGAS,Cgas,34,-3,31,191.475728,68.458333,0
CGGBP1,Cggbp1,4,-4,0,27.475728,0,0
CGN,Cgn,7,2,9,26.184466,0,0
CGNL1,Cgnl1,-2,-3,-5,0,0,0
CGREF1,Cgref1,25,-5,20,3.194175,0,0
CGRRF1,Cgrrf1,3,-2,1,16.776699,0,0
CH25H,Ch25h,-1,12,11,0,0,0
CHAC1,Chac1,33,30,63,2.932039,0,0
CHAC2,Chac2,1,-2,-1,19.640777,0,0
CHAD,Chad,3,-3,0,0,0,0
CHADL,Chadl,27,1,28,0,0,0
CHAF1A,Chaf1a,0,-9,-9,14.048544,0,0
CHAF1B,Chaf1b,-2,-8,-10,4.825243,0,0
CHAMP1,Champ1,-10,-6,-16,5.038835,0,0
CHAT,Chat,2,5,7,14.980583,0,0
CHCHD1,Chchd1,6,-2,4,28.291262,0,0
CHCHD10,Chchd10,10,8,18,81.718447,0,0
CHCHD2,Chchd2,11,-3,8,0.932039,0,0
CHCHD3,Chchd3,8,-2,6,57.68932,0,0
CHCHD4,Chchd4,2,-5,-3,8.708738,0,0
CHCHD5,Chchd5,1,-2,-1,1.203883,0,0
CHCHD6,Chchd6,14,-12,2,1.660194,0,0
CHCHD7,Chchd7,2,-11,-9,2.38835,0,0
CHD1,Chd1,2,-2,0,6.38835,0,0
CHD1L,Chd1l,3,-11,-8,29.368932,0,0
CHD2,Chd2,8,4,12,10.009709,0,0
CHD3,Chd3,12,-4,8,200.281553,0,0
CHD4,Chd4,5,-4,1,34.330097,0,0
CHD5,Chd5,8,-3,5,0,0,0
CHD6,Chd6,1,2,3,2.660194,0,0
CHD7,Chd7,14,-3,11,1.009709,0,0
CHD8,Chd8,6,-6,0,1.097087,0,0
CHD9,Chd9,-4,-7,-11,2.533981,0,0
CHDH,Chdh,2,0,2,22.640777,0,0
CHEK1,Chek1,2,6,8,2.718447,0,0
CHEK2,Chek2,-1,-2,-3,2.864078,0,0
CHERP,Cherp,3,-3,0,51.223301,0,0
CHFR,Chfr,5,-9,-4,2.980583,0,0
CHGA,Chga,8,2,10,14.893204,0,0
CHGB,Chgb,7,-4,3,1.533981,0,0
CHIC1,Chic1,5,-1,4,0,0,0
CHIC2,Chic2,8,-2,6,14.514563,0,0
CHID1,Chid1,8,-5,3,12.902913,0,0
CHIT1,Chit1,-1,-7,-8,0,0,0
CHKA,Chka,10,1,11,1.300971,0,0
CHKB,Chkb,-6,-1,-7,1.067961,0,0
CHL1,Chl1,-1,0,-1,0,0,0
CHM,Chm,6,5,11,0,0,0
CHML,Chml,6,-4,2,16.07767,0,0
CHMP1A,Chmp1a,5,-4,1,0,0,0
CHMP1B,Chmp1b,5,-3,2,15.543689,0,0
CHMP2A,Chmp2a,12,-5,7,5.737864,0,0
CHMP2B,Chmp2b,4,-1,3,5.961165,0,0
CHMP3,Chmp3,6,-1,5,2.213592,0,0
CHMP4B,Chmp4b,7,-5,2,18.912621,0,0
CHMP4C,Chmp4c,1,2,3,11.038835,0,0
CHMP5,Chmp5,9,2,11,2.281553,0,0
CHMP6,Chmp6,-7,-6,-13,10.407767,9.75,0
CHMP7,Chmp7,9,-3,6,9.669903,0,0
CHN1,Chn1,4,-7,-3,35.378641,0,0
CHN2,Chn2,3,-3,0,3.436893,0,0
CHODL,Chodl,3,0,3,0,0,0
CHORDC1,Chordc1,79,6,85,440.883495,252.125,494
CHP1,Chp1,11,-2,9,4.970874,0,0
CHP2,Chp2,6,-3,3,0,0,0
CHPF,Chpf,6,0,6,1.116505,0,0
CHPF2,Chpf2,3,-7,-4,8.951456,0,0
CHPT1,Chpt1,7,-4,3,8.07767,0,0
CHRAC1,Chrac1,5,-14,-9,0,0,0
CHRD,Chrd,7,-1,6,0,0,0
CHRDL1,Chrdl1,0,7,7,1.213592,0,0
CHRDL2,Chrdl2,9,1,10,0,0,0
CHRM1,Chrm1,3,6,9,0,0,0
CHRM2,Chrm2,-4,1,-3,0,0,0
CHRM3,Chrm3,2,2,4,1.815534,0,0
CHRM4,Chrm4,3,-5,-2,11.76699,0,0
CHRM5,Chrm5,3,-2,1,0,0,0
CHRNA1,Chrna1,0,-2,-2,0,0,0
CHRNA10,Chrna10,19,7,26,0,0,0
CHRNA2,Chrna2,80,-10,70,0,0,0
CHRNA3,Chrna3,27,4,31,0,0,0
CHRNA4,Chrna4,15,11,26,0,0,0
CHRNA5,Chrna5,42,-8,34,95.252427,7.041667,0
CHRNA6,Chrna6,-1,-1,-2,0,0,0
CHRNA7,Chrna7,28,-9,19,0,0,0
CHRNA9,Chrna9,2,-8,-6,0,0,0
CHRNB1,Chrnb1,-1,0,-1,1.359223,0,0
CHRNB2,Chrnb2,4,-7,-3,1.194175,0,0
CHRNB3,Chrnb3,1,-8,-7,0,0,0
CHRNB4,Chrnb4,5,7,12,0,0,0
CHRND,Chrnd,6,1,7,0,0,0
CHRNE,Chrne,9,-10,-1,0,0,0
CHRNG,Chrng,2,-12,-10,0,0,0
CHST1,Chst1,2,-10,-8,0.708738,0,0
CHST10,Chst10,2,-5,-3,6.834951,0,0
CHST11,Chst11,22,9,31,13.941748,0,0
CHST12,Chst12,1,-24,-23,3.07767,0,0
CHST13,Chst13,-2,-3,-5,0,0,0
CHST14,Chst14,-2,-10,-12,1.951456,0,0
CHST15,Chst15,0,1,1,9.38835,0,0
CHST2,Chst2,2,1,3,1.242718,0,0
CHST3,Chst3,7,-1,6,0.970874,0,0
CHST4,Chst4,-4,0,-4,0,0,0
CHST5,Chst5,-1,-5,-6,0,0,0
CHST7,Chst7,14,0,14,1.92233,0,0
CHST8,Chst8,2,7,9,0,0,0
CHST9,Chst9,-2,-3,-5,0,0,0
CHSY1,Chsy1,7,-5,2,7.592233,0,0
CHSY3,Chsy3,-3,-1,-4,1.883495,0,0
CHTF18,Chtf18,2,-4,-2,0,0,0
CHTF8,Chtf8,5,-5,0,10.563107,0,0
CHTOP,Chtop,5,-3,2,2.805825,0,0
CHUK,Chuk,6,-4,2,1.456311,0,0
CHURC1,Churc1,1,-4,-3,44.543689,0,0
CIAO1,Ciao1,4,2,6,6.563107,0,0
CIAO2A,Ciao2a,6,-5,1,8.893204,0,0
CIAO2B,Ciao2b,11,-6,5,10.271845,0,0
CIAO3,Ciao3,-4,-3,-7,17.456311,0,0
CIAPIN1,Ciapin1,0,-9,-9,19.456311,0,0
CIART,Ciart,22,7,29,7.737864,0,0
CIB1,Cib1,9,-6,3,16.281553,0,0
CIB2,Cib2,15,-8,7,1.61165,0,0
CIB3,Cib3,8,0,8,2.825243,0,0
CIB4,Cib4,-3,0,-3,0,0,0
CIBAR1,Cibar1,1,-10,-9,0,0,0
CIBAR2,Cibar2,12,-1,11,7.058252,0,0
CIC,Cic,10,-3,7,5.776699,0,0
CIDEA,Cidea,1,2,3,12.514563,0,0
CIDEB,Cideb,0,-7,-7,0,0,0
CIDEC,Cidec,13,8,21,0,0,0
CIITA,Ciita,1,-2,-1,0,0,0
CILK1,Cilk1,3,-11,-8,4.427184,0,0
CILP,Cilp,2,1,3,0,0,0
CILP2,Cilp2,20,0,20,7.815534,0,0
CINP,Cinp,1,-2,-1,108.631068,0,0
CIP2A,Cip2a,4,-6,-2,28.485437,0,0
CIPC,Cipc,3,-3,0,44.456311,0,0
CIR1,Cir1,2,-4,-2,1.213592,0,0
CIRBP,Cirbp,3,-12,-9,21.368932,0,0
CISD1,Cisd1,6,-7,-1,2.883495,0,0
CISD2,Cisd2,7,1,8,7.990291,0,0
CISD3,Cisd3,4,-2,2,5.76699,0,0
CISH,Cish,-1,7,6,6.932039,0,0
CIT,Cit,4,-14,-10,1.699029,3.375,0
CITED1,Cited1,38,5,43,0,0,0
CITED2,Cited2,1,3,4,7.485437,0,0
CITED4,Cited4,-26,2,-24,0.815534,0,0
CIZ1,Ciz1,6,-5,1,10.902913,0,0
CKAP2,Ckap2,0,-5,-5,4.427184,0,0
CKAP2L,Ckap2l,-7,-16,-23,2.194175,0,0
CKAP4,Ckap4,6,-4,2,4.300971,0,0
CKAP5,Ckap5,5,-10,-5,3.728155,0,0
CKB,Ckb,13,2,15,6.970874,0,0
CKLF,Cklf,-7,-8,-15,3.718447,0,0
CKM,Ckm,11,3,14,0,0,0
CKMT2,Ckmt2,19,-4,15,0,0,0
CKS1B,Cks1b,8,-8,0,102.291262,7.5,0
CKS2,Cks2,11,-2,9,229.446602,127.75,109
CLASP1,Clasp1,11,-1,10,15.291262,0,0
CLASP2,Clasp2,6,-4,2,4.84466,0,0
CLASRP,Clasrp,6,-2,4,2.427184,0,0
CLBA1,Clba1,4,-3,1,32,0,0
CLCA1,Clca1,2,-2,0,0,0,0
CLCA2,Clca2,0,0,0,0,0,0
CLCC1,Clcc1,7,-4,3,5.436893,0,0
CLCF1,Clcf1,-14,1,-13,0,0,0
CLCN1,Clcn1,12,-13,-1,0,0,0
CLCN2,Clcn2,1,-4,-3,5.087379,0,0
CLCN3,Clcn3,5,-2,3,1.475728,0,0
CLCN4,Clcn4,5,-1,4,0,0,0
CLCN5,Clcn5,-1,1,0,7.864078,0,0
CLCN6,Clcn6,10,-1,9,35.951456,0,0
CLCN7,Clcn7,9,2,11,9.718447,0,0
CLCNKA,Clcnka,-1,4,3,0,0,0
CLCNKB,Clcnkb,2,1,3,0,0,0
CLDN1,Cldn1,-2,2,0,4.223301,0,0
CLDN10,Cldn10,7,-1,6,2.368932,0,0
CLDN11,Cldn11,11,19,30,0,0,0
CLDN12,Cldn12,7,-3,4,37.543689,0,0
CLDN14,Cldn14,9,3,12,2.592233,0,0
CLDN15,Cldn15,9,13,22,0,0,0
CLDN16,Cldn16,1,4,5,0,0,0
CLDN17,Cldn17,0,0,0,0,0,0
CLDN18,Cldn18,5,-1,4,0,0,0
CLDN19,Cldn19,5,14,19,1.349515,0,0
CLDN2,Cldn2,6,5,11,0,0,0
CLDN22,Cldn22,23,-9,14,0,0,0
CLDN23,Cldn23,-11,1,-10,2.067961,0,0
CLDN24,Cldn24,33,-5,28,0,0,0
CLDN3,Cldn3,0,2,2,1.543689,0,0
CLDN4,Cldn4,3,19,22,26.378641,0,0
CLDN5,Cldn5,-2,8,6,0,0,0
CLDN6,Cldn6,65,14,79,3.669903,0,0
CLDN7,Cldn7,0,15,15,0,0,0
CLDN8,Cldn8,0,4,4,0,0,0
CLDN9,Cldn9,66,-4,62,2.941748,0,0
CLDND1,Cldnd1,6,-6,0,10.883495,0,0
CLDND2,Cldnd2,-32,-6,-38,3.106796,0,0
CLEC10A,Clec10a,22,-10,12,1.737864,0,0
CLEC11A,Clec11a,0,-13,-13,4.883495,0,0
CLEC12A,Clec12a,-1,1,0,0,0,0
CLEC12B,Clec12b,0,1,1,0,0,0
CLEC14A,Clec14a,-1,-9,-10,0,0,0
CLEC16A,Clec16a,10,0,10,6.728155,0,0
CLEC18A,Clec18a,27,-4,23,0,0,0
CLEC1A,Clec1a,16,5,21,0,0,0
CLEC1B,Clec1b,-4,7,3,0,0,0
CLEC2D,Clec2d,3,-3,0,0,0,0
CLEC2L,Clec2l,3,-2,1,0,0,0
CLEC3A,Clec3a,-8,-2,-10,0,0,0
CLEC3B,Clec3b,2,1,3,0,0,0
CLEC4D,Clec4d,2,7,9,4.631068,0,0
CLEC4E,Clec4e,2,7,9,3.563107,0,0
CLEC4F,Clec4f,2,-5,-3,0,0,0
CLEC4G,Clec4g,-2,-4,-6,0,0,0
CLEC5A,Clec5a,2,9,11,0,0,0
CLEC7A,Clec7a,1,-1,0,0,0,0
CLEC9A,Clec9a,0,-8,-8,0,0,0
CLGN,Clgn,-1,-12,-13,12.407767,0,0
CLHC1,Clhc1,1,-1,0,0,0,0
CLIC1,Clic1,7,4,11,4.07767,0,0
CLIC3,Clic3,-1,-8,-9,1.126214,0,0
CLIC4,Clic4,8,-5,3,16.660194,0,0
CLIC5,Clic5,5,2,7,0,0,0
CLIC6,Clic6,-5,-3,-8,0,0,0
CLINT1,Clint1,5,-4,1,15.087379,0,0
CLIP1,Clip1,7,-4,3,8.76699,0,0
CLIP2,Clip2,11,-2,9,3.262136,0,0
CLIP3,Clip3,10,-10,0,0,0,0
CLIP4,Clip4,2,-15,-13,0,0,0
CLK1,Clk1,63,-2,61,130.116505,5.833333,0
CLK2,Clk2,2,-3,-1,7.349515,0,0
CLK3,Clk3,7,-1,6,15.106796,0,0
CLK4,Clk4,19,-2,17,32.990291,0,0
CLMN,Clmn,-4,2,-2,0.980583,0,0
CLMP,Clmp,-4,-5,-9,6.300971,0,0
CLN3,Cln3,8,1,9,13.067961,0,0
CLN5,Cln5,3,2,5,4.970874,0,0
CLN6,Cln6,4,-8,-4,3.786408,0,0
CLN8,Cln8,7,4,11,1.116505,0,0
CLNK,Clnk,2,-8,-6,0,0,0
CLNS1A,Clns1a,4,-3,1,4.669903,0,0
CLOCK,Clock,6,1,7,5.854369,0,0
CLP1,Clp1,-1,-3,-4,2.76699,0,0
CLPB,Clpb,8,1,9,5.970874,0,0
CLPP,Clpp,11,-7,4,10.106796,0,0
CLPS,Clps,-2,0,-2,0,0,0
CLPSL2,Clpsl2,-4,1,-3,0,0,0
CLPTM1,Clptm1,10,-6,4,4.76699,0,0
CLPTM1L,Clptm1l,7,-7,0,33.805825,0,0
CLPX,Clpx,-15,-8,-23,4.553398,0,0
CLRN1,Clrn1,-1,-5,-6,0,0,0
CLRN2,Clrn2,1,0,1,14.019417,0,0
CLRN3,Clrn3,13,4,17,0,0,0
CLSPN,Clspn,1,-13,-12,4.281553,0,0
CLSTN1,Clstn1,10,-3,7,3.961165,0,0
CLSTN2,Clstn2,1,2,3,0,0,0
CLSTN3,Clstn3,9,1,10,1.067961,0,0
CLTA,Clta,9,-2,7,0,0,0
CLTB,Cltb,3,3,6,12.436893,0,0
CLTC,Cltc,11,-2,9,41.31068,0,0
CLTRN,Cltrn,1,6,7,3.262136,0,0
CLU,Clu,81,27,108,183.116505,61.333333,0
CLUAP1,Cluap1,0,-3,-3,26.679612,0,0
CLUH,Cluh,3,-3,0,75.038835,0,0
CLVS1,Clvs1,11,-4,7,0,0,0
CLVS2,Clvs2,5,-3,2,0,0,0
CLYBL,Clybl,-9,-1,-10,1,0,0
CMA1,Cma1,9,0,9,0,0,0
CMAS,Cmas,4,-3,1,9.23301,0,0
CMBL,Cmbl,4,-3,1,113.941748,34.833333,0
CMC1,Cmc1,6,-1,5,0,0,0
CMC2,Cmc2,2,-1,1,0,0,0
CMC4,Cmc4,5,-3,2,2.514563,0,0
CMIP,Cmip,-7,-2,-9,148.31068,94.583333,0
CMKLR1,Cmklr1,-5,1,-4,0,0,0
CMPK1,Cmpk1,8,-1,7,3,0,0
CMPK2,Cmpk2,-4,-3,-7,2.145631,0,0
CMSS1,Cmss1,5,-7,-2,6.067961,0,0
CMTM1,Cmtm1,11,-9,2,0,0,0
CMTM3,Cmtm3,0,3,3,1.330097,0,0
CMTM4,Cmtm4,5,1,6,2.582524,0,0
CMTM5,Cmtm5,4,3,7,0,0,0
CMTM6,Cmtm6,2,-4,-2,3.194175,0,0
CMTM7,Cmtm7,-7,0,-7,18.466019,3.041667,0
CMTM8,Cmtm8,1,10,11,2.339806,0,0
CMTR1,Cmtr1,7,-3,4,6.23301,0,0
CMTR2,Cmtr2,3,-2,1,19.271845,0,0
CMYA5,Cmya5,39,-5,34,4.524272,0,0
CNBD1,Cnbd1,3,0,3,0,0,0
CNBD2,Cnbd2,-2,-5,-7,0,0,0
CNBP,Cnbp,5,1,6,6.106796,0,0
CNDP1,Cndp1,4,-10,-6,0,0,0
CNDP2,Cndp2,5,-7,-2,30.048544,0,0
CNEP1R1,Cnep1r1,-4,-6,-10,7.76699,0,0
CNFN,Cnfn,-2,7,5,0.873786,0,0
CNGA1,Cnga1,6,1,7,2.582524,0,0
CNGA2,Cnga2,0,-3,-3,0,0,0
CNGA3,Cnga3,2,3,5,0,0,0
CNGA4,Cnga4,-1,-5,-6,7.873786,0,0
CNGB1,Cngb1,0,-2,-2,0,0,0
CNGB3,Cngb3,-1,-4,-5,0,0,0
CNIH1,Cnih1,6,-2,4,13.786408,0,0
CNIH2,Cnih2,18,-6,12,0,0,0
CNIH3,Cnih3,-3,-1,-4,5.126214,0,0
CNIH4,Cnih4,3,-2,1,1.893204,0,0
CNKSR1,Cnksr1,28,6,34,0,0,0
CNKSR2,Cnksr2,6,2,8,2.097087,0,0
CNKSR3,Cnksr3,6,2,8,8.631068,0,0
CNMD,Cnmd,3,-7,-4,0,0,0
CNN1,Cnn1,8,-4,4,12.116505,0,0
CNN2,Cnn2,3,-7,-4,118.495146,0,0
CNN3,Cnn3,9,6,15,0,0,0
CNNM1,Cnnm1,1,-6,-5,6.854369,0,0
CNNM2,Cnnm2,2,-2,0,1.990291,0,0
CNNM3,Cnnm3,6,-3,3,3.223301,0,0
CNNM4,Cnnm4,4,0,4,17.864078,0,0
CNOT1,Cnot1,9,-4,5,1.165049,0,0
CNOT10,Cnot10,5,-1,4,8.165049,0,0
CNOT11,Cnot11,-1,-3,-4,13.009709,0,0
CNOT2,Cnot2,1,-10,-9,6.126214,0,0
CNOT3,Cnot3,8,-2,6,28.825243,8.625,289
CNOT4,Cnot4,10,-4,6,8.504854,0,0
CNOT6,Cnot6,8,-3,5,5.495146,0,0
CNOT6L,Cnot6l,10,-5,5,5.009709,0,0
CNOT7,Cnot7,4,-5,-1,4.456311,0,0
CNOT8,Cnot8,6,-3,3,58.951456,0,0
CNOT9,Cnot9,4,-4,0,1.699029,0,0
CNP,Cnp,10,1,11,4.407767,0,0
CNPPD1,Cnppd1,5,-1,4,5.932039,0,0
CNPY1,Cnpy1,4,4,8,0,0,0
CNPY2,Cnpy2,0,-4,-4,16.805825,0,0
CNPY3,Cnpy3,4,0,4,12,0,0
CNPY4,Cnpy4,3,-2,1,23.92233,0,0
CNR1,Cnr1,9,-4,5,0,0,0
CNR2,Cnr2,6,6,12,1.262136,0,0
CNRIP1,Cnrip1,4,2,6,3.621359,0,0
CNST,Cnst,4,-2,2,10.601942,0,0
CNTD1,Cntd1,11,-7,4,1.436893,0,0
CNTF,Cntf,9,-2,7,0,0,0
CNTFR,Cntfr,13,0,13,0,0,0
CNTLN,Cntln,0,-4,-4,2.912621,0,0
CNTN1,Cntn1,4,-2,2,9.126214,0,0
CNTN2,Cntn2,7,0,7,0,0,0
CNTN3,Cntn3,-2,-2,-4,0,0,0
CNTN4,Cntn4,1,-1,0,0,0,0
CNTN5,Cntn5,-1,-5,-6,1.699029,0,0
CNTN6,Cntn6,-2,-7,-9,0,0,0
CNTNAP1,Cntnap1,8,1,9,1.902913,0,0
CNTNAP2,Cntnap2,2,4,6,0,0,0
CNTNAP3,Cntnap3,6,0,6,6.990291,0,0
CNTNAP4,Cntnap4,2,0,2,0,0,0
CNTRL,Cntrl,0,-9,-9,10.475728,0,0
CNTROB,Cntrob,7,-5,2,0,0,0
COA3,Coa3,6,-2,4,1.436893,0,0
COA4,Coa4,3,-17,-14,4.203883,0,0
COA5,Coa5,4,-7,-3,9.776699,0,0
COA6,Coa6,1,1,2,6.864078,0,0
COA7,Coa7,-1,-6,-7,6.407767,0,0
COA8,Coa8,7,1,8,20.15534,0,0
COASY,Coasy,8,1,9,5.68932,0,0
COBL,Cobl,4,-2,2,6.019417,0,0
COBLL1,Cobll1,9,-1,8,2.84466,0,0
COCH,Coch,0,-7,-7,0,0,0
COG1,Cog1,-7,-3,-10,7.058252,0,0
COG2,Cog2,-3,-9,-12,22.834951,0,0
COG3,Cog3,0,-5,-5,3.553398,0,0
COG4,Cog4,6,-5,1,0,0,0
COG5,Cog5,3,-9,-6,11.174757,0,0
COG6,Cog6,8,-7,1,1.368932,0,0
COG7,Cog7,10,-7,3,8.572816,0,0
COG8,Cog8,2,-2,0,3.572816,0,0
COIL,Coil,-11,-6,-17,5.776699,0,0
COL10A1,Col10a1,9,-5,4,0,0,0
COL11A1,Col11a1,4,2,6,0,0,0
COL11A2,Col11a2,11,2,13,0,0,0
COL12A1,Col12a1,8,-4,4,3.436893,0,0
COL13A1,Col13a1,5,0,5,4.009709,0,0
COL14A1,Col14a1,9,-10,-1,4.621359,0,0
COL15A1,Col15a1,-1,4,3,0,0,0
COL16A1,Col16a1,4,-8,-4,0,0,0
COL17A1,Col17a1,7,-2,5,0,0,0
COL18A1,Col18a1,-4,0,-4,1.097087,0,0
COL19A1,Col19a1,3,-5,-2,5.135922,0,0
COL1A1,Col1a1,46,-9,37,41.621359,0,0
COL1A2,Col1a2,-2,-4,-6,0,0,0
COL20A1,Col20a1,6,-6,0,0,0,0
COL22A1,Col22a1,4,-5,-1,0,0,0
COL23A1,Col23a1,5,-3,2,68.679612,48.75,0
COL24A1,Col24a1,4,-1,3,0,0,0
COL25A1,Col25a1,4,-4,0,0,0,0
COL26A1,Col26a1,67,-4,63,2.135922,0,0
COL27A1,Col27a1,5,-1,4,0.708738,0,0
COL28A1,Col28a1,11,-1,10,0,0,0
COL2A1,Col2a1,40,-9,31,1.349515,0,0
COL3A1,Col3a1,-2,-1,-3,0,0,0
COL4A1,Col4a1,-6,7,1,0.92233,0,0
COL4A2,Col4a2,3,-1,2,0.92233,0,0
COL4A3,Col4a3,4,-12,-8,4.058252,0,0
COL4A4,Col4a4,1,-1,0,4.058252,0,0
COL4A5,Col4a5,9,4,13,4.349515,0,0
COL4A6,Col4a6,-1,3,2,4.349515,0,0
COL5A1,Col5a1,12,-9,3,3.368932,0,0
COL5A2,Col5a2,1,-1,0,0,0,0
COL5A3,Col5a3,1,-6,-5,0.776699,0,0
COL6A1,Col6a1,6,-4,2,3.631068,0,0
COL6A2,Col6a2,22,-3,19,0,0,0
COL6A3,Col6a3,-2,13,11,15.368932,0,0
COL6A5,Col6a5,6,1,7,3.815534,0,0
COL6A6,Col6a6,-1,4,3,0,0,0
COL7A1,Col7a1,11,2,13,0,0,0
COL8A1,Col8a1,-2,0,-2,1.252427,0,0
COL8A2,Col8a2,0,0,0,0,0,0
COL9A1,Col9a1,6,-8,-2,0,0,0
COL9A2,Col9a2,2,2,4,0,0,0
COL9A3,Col9a3,-1,-2,-3,0,0,0
COLEC10,Colec10,-4,-2,-6,5.048544,0,0
COLEC11,Colec11,36,4,40,1.15534,0,0
COLEC12,Colec12,3,-2,1,0,0,0
COLGALT1,Colgalt1,5,2,7,7.106796,0,0
COLGALT2,Colgalt2,10,-1,9,0,0,0
COLQ,Colq,3,0,3,2.378641,0,0
COMMD1,Commd1,4,-1,3,534.825243,257.708333,421
COMMD10,Commd10,6,-7,-1,3.631068,0,0
COMMD2,Commd2,4,-4,0,33.854369,0,0
COMMD3,Commd3,-2,4,2,5.543689,0,0
COMMD4,Commd4,4,-1,3,5.68932,0,0
COMMD5,Commd5,8,-10,-2,5.825243,0,0
COMMD6,Commd6,7,-7,0,2.582524,0,0
COMMD7,Commd7,5,-4,1,2.990291,0,0
COMMD8,Commd8,-1,-2,-3,14.621359,0,0
COMMD9,Commd9,6,1,7,1.300971,0,0
COMP,Comp,6,-4,2,0,0,0
COMT,Comt,5,3,8,4.970874,0,0
COMTD1,Comtd1,-1,-4,-5,19.582524,0,0
COP1,Cop1,6,-1,5,2.106796,0,0
COPA,Copa,10,-2,8,71.757282,0,0
COPB1,Copb1,6,-3,3,5.961165,0,0
COPB2,Copb2,6,-4,2,15.407767,0,0
COPE,Cope,7,0,7,4.009709,0,0
COPG1,Copg1,6,-1,5,1.92233,0,0
COPG2,Copg2,1,-6,-5,3.07767,0,0
COPRS,Coprs,5,-10,-5,3.15534,0,0
COPS2,Cops2,11,-4,7,11.456311,0,0
COPS3,Cops3,8,0,8,23.087379,0,0
COPS4,Cops4,3,-2,1,7.456311,0,100
COPS5,Cops5,8,-5,3,10.679612,0,0
COPS6,Cops6,14,-3,11,14.466019,0,0
COPS7A,Cops7a,2,-1,1,59.07767,20.625,0
COPS7B,Cops7b,7,-7,0,27.84466,0,0
COPS8,Cops8,7,-4,3,11.116505,0,0
COPS9,Cops9,3,-3,0,4.990291,0,0
COPZ1,Copz1,9,-2,7,0,0,0
COPZ2,Copz2,25,-1,24,0,0,0
COQ10A,Coq10a,-5,0,-5,16.019417,0,0
COQ10B,Coq10b,1,1,2,2.582524,0,0
COQ2,Coq2,0,-4,-4,6.262136,0,0
COQ3,Coq3,5,-4,1,0,0,0
COQ4,Coq4,3,0,3,30.427184,0,0
COQ5,Coq5,11,0,11,1.359223,0,0
COQ6,Coq6,5,-1,4,15.38835,0,0
COQ7,Coq7,2,-3,-1,5.660194,0,0
COQ8A,Coq8a,0,-2,-2,4.223301,0,0
COQ8B,Coq8b,3,1,4,3.582524,0,0
COQ9,Coq9,-1,-10,-11,19.456311,0,0
CORIN,Corin,8,0,8,7.912621,0,0
CORO1A,Coro1a,-2,5,3,1.281553,0,0
CORO1B,Coro1b,8,-9,-1,2.300971,0,0
CORO1C,Coro1c,10,-7,3,12.92233,0,0
CORO2A,Coro2a,4,-10,-6,0.941748,0,0
CORO2B,Coro2b,9,-4,5,1.679612,0,0
CORO6,Coro6,5,1,6,0,0,0
CORO7,Coro7,-11,-3,-14,0.786408,0,0
CORT,Cort,36,-18,18,3.747573,0,0
COTL1,Cotl1,11,-8,3,7.68932,0,0
COX10,Cox10,5,-3,2,7.223301,0,0
COX11,Cox11,1,-10,-9,23.737864,0,0
COX14,Cox14,6,-4,2,1.300971,0,0
COX15,Cox15,7,-2,5,3.776699,0,0
COX16,Cox16,7,-15,-8,9.087379,0,0
COX17,Cox17,0,-1,-1,0,0,0
COX18,Cox18,4,-4,0,10.941748,0,0
COX19,Cox19,2,-6,-4,17.514563,0,0
COX20,Cox20,6,-7,-1,10.854369,0,0
COX4I1,Cox4i1,9,-3,6,12.941748,0,0
COX4I2,Cox4i2,5,-3,2,0,0,0
COX5A,Cox5a,9,-7,2,10.553398,0,0
COX5B,Cox5b,7,-2,5,1.203883,0,0
COX6A1,Cox6a1,8,-4,4,2.067961,0,0
COX6A2,Cox6a2,14,10,24,0,0,0
COX6B1,Cox6b1,6,-3,3,1.631068,0,0
COX6B2,Cox6b2,10,10,20,0,0,0
COX6C,Cox6c,5,-4,1,0.980583,0,0
COX7A1,Cox7a1,11,3,14,0,0,0
COX7A2,Cox7a2,6,2,8,4.970874,0,0
COX7A2L,Cox7a2l,11,-5,6,4.436893,0,0
COX7B,Cox7b,5,-10,-5,0,0,0
COX7B2,Cox7b2,2,8,10,0,0,0
COX7C,Cox7c,6,0,6,5.456311,0,0
COX8A,Cox8a,6,10,16,4.009709,0,0
COX8C,Cox8c,83,-1,82,0.854369,0,0
CP,Cp,21,1,22,0.834951,0,0
CPA1,Cpa1,3,4,7,0.951456,0,0
CPA2,Cpa2,20,1,21,0,0,0
CPA3,Cpa3,0,-2,-2,0,0,0
CPA4,Cpa4,1,2,3,6.514563,0,0
CPA5,Cpa5,6,1,7,5.543689,0,0
CPA6,Cpa6,1,-12,-11,0,0,0
CPB1,Cpb1,1,-4,-3,12.524272,0,0
CPB2,Cpb2,0,-5,-5,1.349515,0,0
CPD,Cpd,2,-2,0,13.15534,0,0
CPE,Cpe,9,4,13,20.902913,0,0
CPEB1,Cpeb1,5,-1,4,15.15534,0,0
CPEB2,Cpeb2,17,0,17,2.339806,0,0
CPEB3,Cpeb3,31,-1,30,23.601942,0,0
CPEB4,Cpeb4,39,3,42,35.699029,0,0
CPED1,Cped1,41,1,42,17.271845,0,0
CPLANE1,Cplane1,4,-1,3,6.048544,0,0
CPLANE2,Cplane2,8,2,10,37.825243,0,0
CPLX1,Cplx1,8,10,18,0,0,0
CPLX2,Cplx2,2,-2,0,7.029126,0,0
CPLX3,Cplx3,21,16,37,0,0,0
CPLX4,Cplx4,35,-1,34,0,0,0
CPM,Cpm,0,3,3,2.84466,0,0
CPN1,Cpn1,5,10,15,0,0,0
CPN2,Cpn2,13,1,14,2.708738,0,0
CPNE1,Cpne1,8,-5,3,28.533981,8.833333,0
CPNE2,Cpne2,5,-1,4,3.941748,0,0
CPNE3,Cpne3,9,-1,8,37.436893,0,0
CPNE4,Cpne4,5,-2,3,0,0,0
CPNE5,Cpne5,-6,-1,-7,1.135922,0,0
CPNE6,Cpne6,10,-1,9,0.941748,0,0
CPNE7,Cpne7,5,2,7,2.514563,0,0
CPNE8,Cpne8,3,5,8,8.631068,0,0
CPNE9,Cpne9,3,2,5,0,0,0
CPOX,Cpox,9,-2,7,30.291262,4.166667,0
CPPED1,Cpped1,2,-5,-3,9.281553,0,0
CPQ,Cpq,3,-6,-3,2.203883,0,0
CPS1,Cps1,3,2,5,2.067961,0,0
CPSF1,Cpsf1,11,-1,10,34.242718,0,0
CPSF2,Cpsf2,1,-2,-1,2.427184,0,0
CPSF3,Cpsf3,-2,0,-2,26.087379,0,0
CPSF4,Cpsf4,7,-4,3,11.300971,0,0
CPSF4L,Cpsf4l,9,-6,3,10.854369,0,0
CPSF6,Cpsf6,2,-5,-3,5.15534,0,0
CPSF7,Cpsf7,8,-6,2,30.466019,0,0
CPT1A,Cpt1a,5,3,8,2.699029,0,0
CPT1B,Cpt1b,12,-8,4,1.067961,0,0
CPT1C,Cpt1c,20,-12,8,0,0,0
CPT2,Cpt2,-6,-3,-9,7.029126,0,0
CPTP,Cptp,2,0,2,1.135922,0,0
CPVL,Cpvl,1,-10,-9,3.436893,0,0
CPXCR1,Cpxcr1,0,0,0,0,0,0
CPXM1,Cpxm1,2,3,5,0,0,0
CPXM2,Cpxm2,3,10,13,0,0,0
CPZ,Cpz,-1,5,4,1.330097,0,0
CR1L,Cr1l,8,-3,5,0,0,0
CR2,Cr2,1,-11,-10,0.84466,0,0
CRABP1,Crabp1,-2,-9,-11,0,0,0
CRABP2,Crabp2,18,7,25,3.514563,0,0
CRACD,Cracd,6,-9,-3,0,0,0
CRACDL,Cracdl,4,1,5,0,0,0
CRACR2A,Cracr2a,5,2,7,39.252427,0,0
CRACR2B,Cracr2b,30,-2,28,0.873786,0,0
CRADD,Cradd,-2,0,-2,0,0,0
CRAMP1,Cramp1l,15,-6,9,50.223301,0,0
CRAT,Crat,8,-9,-1,11.669903,0,0
CRB1,Crb1,1,-5,-4,2.349515,0,0
CRB2,Crb2,-2,-5,-7,2.660194,0,0
CRB3,Crb3,-3,4,1,5.417476,0,0
CRBN,Crbn,5,-4,1,15.271845,0,0
CRCP,Crcp,2,-1,1,6.009709,0,0
CRCT1,Crct1,0,-12,-12,0,0,0
CREB1,Creb1,14,-5,9,0,0,0
CREB3,Creb3,4,1,5,13.184466,0,0
CREB3L1,Creb3l1,-1,3,2,11.31068,0,0
CREB3L2,Creb3l2,4,-1,3,7.067961,0,0
CREB3L3,Creb3l3,13,1,14,3.009709,0,0
CREB3L4,Creb3l4,21,-7,14,64.825243,0,0
CREB5,Creb5,16,11,27,0,0,0
CREBBP,Crebbp,8,1,9,14.650485,0,0
CREBL2,Crebl2,1,-3,-2,8.38835,0,0
CREBRF,Crebrf,4,3,7,3.640777,0,0
CREBZF,Crebzf,4,-3,1,5.291262,0,0
CREG1,Creg1,6,7,13,6.058252,0,0
CREG2,Creg2,3,-2,1,32.533981,0,0
CRELD1,Creld1,17,0,17,9.592233,0,0
CRELD2,Creld2,1,-4,-3,0,0,0
CREM,Crem,5,5,10,19.135922,0,0
CRH,Crh,-4,-3,-7,7.174757,0,0
CRHBP,Crhbp,-8,2,-6,0,0,0
CRHR1,Crhr1,-3,-11,-14,0,0,0
CRHR2,Crhr2,2,1,3,0,0,0
CRIM1,Crim1,3,5,8,10.873786,0,0
CRIP1,Crip1,-3,-6,-9,28.398058,0,0
CRIP2,Crip2,28,-3,25,31.485437,0,0
CRIP3,Crip3,17,5,22,0,0,0
CRIPT,Cript,3,-1,2,31.126214,0,0
CRISP1,Crisp1,3,6,9,4.407767,0,0
CRISP2,Crisp2,1,-4,-3,0,0,0
CRISP3,Crisp3,0,1,1,2.194175,0,0
CRISPLD1,Crispld1,-3,-4,-7,2.68932,0,0
CRISPLD2,Crispld2,3,6,9,0.640777,0,0
CRK,Crk,-1,-3,-4,6.15534,0,0
CRKL,Crkl,7,-3,4,5.15534,0,0
CRLF1,Crlf1,6,0,6,0,0,0
CRLF2,Crlf2,14,-2,12,0,0,0
CRLF3,Crlf3,1,-9,-8,6.572816,0,0
CRLS1,Crls1,0,-3,-3,9.553398,0,0
CRMP1,Crmp1,4,-1,3,0,0,0
CRNKL1,Crnkl1,8,-3,5,18.786408,0,0
CRNN,Crnn,1,0,1,3.427184,0,0
CROCC,Crocc,3,-4,-1,0,0,0
CROCC2,Crocc2,-1,-1,-2,0,0,0
CROT,Crot,2,-8,-6,8.417476,0,0
CRP,Crp,1,-5,-4,0,0,0
CRPPA,Crppa,0,-10,-10,0,0,0
CRTAC1,Crtac1,3,1,4,0,0,0
CRTAM,Crtam,5,-6,-1,0,0,0
CRTAP,Crtap,6,-5,1,9.92233,0,0
CRTC1,Crtc1,6,-3,3,4.203883,0,0
CRTC2,Crtc2,11,-4,7,5.194175,0,0
CRTC3,Crtc3,8,-1,7,0.728155,0,0
CRX,Crx,3,-4,-1,0,0,0
CRY1,Cry1,2,2,4,3.242718,0,0
CRY2,Cry2,-21,-8,-29,5.067961,0,0
CRYAA,Cryaa,2,-7,-5,4.417476,0,0
CRYAB,Cryab,173,17,190,50.84466,0,0
CRYBA1,Cryba1,4,-5,-1,0,0,0
CRYBA2,Cryba2,17,1,18,0,0,0
CRYBA4,Cryba4,44,8,52,76.864078,3.416667,0
CRYBB1,Crybb1,12,-2,10,0,0,0
CRYBB2,Crybb2,6,9,15,0,0,0
CRYBB3,Crybb3,17,19,36,0,0,0
CRYBG1,Crybg1,3,-8,-5,7.106796,0,0
CRYBG2,Crybg2,-15,-7,-22,0,0,0
CRYBG3,Crybg3,3,-9,-6,8.786408,0,0
CRYGA,Cryga,3,-4,-1,0,0,0
CRYGB,Crygb,-2,4,2,0,0,0
CRYGC,Crygc,5,1,6,3.776699,0,0
CRYGD,Crygd,13,-4,9,3.776699,0,0
CRYGN,Crygn,2,-11,-9,0,0,0
CRYGS,Crygs,16,15,31,0,0,0
CRYL1,Cryl1,6,-1,5,1.019417,0,0
CRYM,Crym,14,3,17,73.92233,0,0
CRYZ,Cryz,10,-6,4,149.475728,0,167
CRYZL1,Cryzl1,7,-6,1,35.893204,0,0
CS,Cs,10,-3,7,8.543689,0,0
CSAD,Csad,1,-6,-5,9.873786,0,0
CSDC2,Csdc2,5,-4,1,0,0,0
CSDE1,Csde1,6,-4,2,3.194175,0,0
CSE1L,Cse1l,2,-2,0,6.281553,0,0
CSF1,Csf1,8,0,8,6.145631,0,0
CSF1R,Csf1r,10,-12,-2,0.650485,0,0
CSF2,Csf2,-4,-1,-5,0,0,0
CSF2RA,Csf2ra,2,1,3,0,0,0
CSF2RB,Csf2rb,2,-1,1,0,0,0
CSF3,Csf3,81,1,82,0,0,0
CSF3R,Csf3r,-6,1,-5,1.242718,0,0
CSGALNACT1,Csgalnact1,-8,0,-8,1.368932,0,0
CSGALNACT2,Csgalnact2,12,-1,11,3.553398,0,0
CSK,Csk,5,1,6,15.514563,0,0
CSMD1,Csmd1,3,0,3,0,0,0
CSMD2,Csmd2,0,0,0,4.601942,0,0
CSMD3,Csmd3,1,-7,-6,3.563107,0,0
CSN1S1,Csn1s1,2,3,5,0,0,0
CSN2,Csn2,0,-6,-6,0,0,0
CSN3,Csn3,0,10,10,0,0,0
CSNK1A1,Csnk1a1,8,-1,7,16.495146,0,0
CSNK1D,Csnk1d,8,0,8,7.708738,0,0
CSNK1E,Csnk1e,6,-6,0,0,0,0
CSNK1G1,Csnk1g1,9,-6,3,2.76699,0,0
CSNK1G2,Csnk1g2,6,-5,1,96.883495,0,0
CSNK1G3,Csnk1g3,5,0,5,3.84466,0,0
CSNK2A1,Csnk2a1,7,0,7,10.805825,0,0
CSNK2A2,Csnk2a2,8,-3,5,5.941748,0,0
CSNK2B,Csnk2b,5,-4,1,4.23301,0,0
CSNKA2IP,Csnka2ip,0,0,0,0,0,0
CSPG4,Cspg4,1,-6,-5,3.68932,0,0
CSPG5,Cspg5,32,8,40,0,0,0
CSPP1,Cspp1,5,-2,3,10.679612,0,0
CSRNP1,Csrnp1,21,6,27,6.747573,0,0
CSRNP2,Csrnp2,10,-3,7,12.728155,0,0
CSRNP3,Csrnp3,9,-3,6,0,0,0
CSRP1,Csrp1,0,3,3,1.902913,0,0
CSRP2,Csrp2,23,-2,21,45.621359,0,0
CSRP3,Csrp3,10,-5,5,0,0,0
CST11,Cst11,3,1,4,0,0,0
CST3,Cst3,11,4,15,0,0,0
CST6,Cst6,22,-4,18,0,0,0
CST7,Cst7,1,-4,-3,1.61165,0,0
CST8,Cst8,-1,-1,-2,0,0,0
CST9,Cst9,7,6,13,0,0,0
CSTB,Cstb,6,7,13,2.543689,0,0
CSTF1,Cstf1,-8,-6,-14,5.902913,0,0
CSTF2,Cstf2,2,-6,-4,2.543689,0,0
CSTF2T,Cstf2t,6,-2,4,17.368932,0,0
CSTF3,Cstf3,6,-2,4,2.533981,0,0
CSTL1,Cstl1,-1,0,-1,0,0,0
CT55,Ct55,-3,2,-1,0,0,0
CTAG2,Ctag2,1,-3,-2,0,0,0
CTBP1,Ctbp1,4,-2,2,3.718447,0,0
CTBP2,Ctbp2,7,-2,5,3.582524,0,0
CTBS,Ctbs,4,2,6,6.553398,0,0
CTC1,Ctc1,1,-2,-1,0,0,0
CTCF,Ctcf,5,-5,0,12.417476,0,0
CTCFL,Ctcfl,5,-5,0,1.223301,0,0
CTDNEP1,Ctdnep1,7,-2,5,1.592233,0,0
CTDP1,Ctdp1,6,-6,0,20.281553,0,0
CTDSP1,Ctdsp1,-8,-2,-10,3.786408,0,0
CTDSP2,Ctdsp2,5,-8,-3,4.893204,0,0
CTDSPL,Ctdspl,7,0,7,0,0,0
CTDSPL2,Ctdspl2,3,-1,2,0.970874,0,0
CTF1,Ctf1,-8,-8,-16,22.718447,0,0
CTH,Cth,1,1,2,1.514563,0,0
CTHRC1,Cthrc1,-9,-4,-13,0,0,0
CTIF,Ctif,7,2,9,1.15534,0,0
CTLA4,Ctla4,-10,7,-3,0,0,0
CTNNA1,Ctnna1,7,2,9,4.038835,0,0
CTNNA2,Ctnna2,-1,0,-1,0,0,0
CTNNA3,Ctnna3,-4,-4,-8,1.970874,0,0
CTNNAL1,Ctnnal1,-1,-2,-3,6,0,0
CTNNB1,Ctnnb1,9,-3,6,19.543689,0,0
CTNNBIP1,Ctnnbip1,5,-3,2,1.174757,0,0
CTNNBL1,Ctnnbl1,4,-4,0,14.990291,0,0
CTNND1,Ctnnd1,8,-4,4,4.019417,0,0
CTNND2,Ctnnd2,6,-4,2,0,0,0
CTNS,Ctns,13,-3,10,4,0,0
CTPS2,Ctps2,4,-4,0,10.165049,0,0
CTR9,Ctr9,7,-4,3,5.990291,0,0
CTRB1,Ctrb1,17,13,30,0,0,0
CTRC,Ctrc,-1,-7,-8,0,0,0
CTRL,Ctrl,6,-2,4,2.718447,0,0
CTSA,Ctsa,6,3,9,7.757282,0,0
CTSB,Ctsb,6,2,8,2.145631,0,0
CTSC,Ctsc,2,1,3,10.436893,0,0
CTSD,Ctsd,6,7,13,1.990291,0,0
CTSE,Ctse,8,-11,-3,0,0,0
CTSF,Ctsf,6,5,11,0,0,0
CTSG,Ctsg,4,3,7,0,0,0
CTSH,Ctsh,6,7,13,2.262136,0,0
CTSK,Ctsk,3,13,16,3.932039,0,0
CTSL,Ctsl,6,-6,0,3.61165,0,0
CTSO,Ctso,2,-1,1,5.533981,0,0
CTSS,Ctss,9,7,16,0,0,0
CTSW,Ctsw,3,-4,-1,0,0,0
CTSZ,Ctsz,3,4,7,26.174757,0,0
CTTN,Cttn,8,0,8,6.592233,0,0
CTTNBP2,Cttnbp2,-5,-6,-11,3.864078,4.5,0
CTTNBP2NL,Cttnbp2nl,5,-12,-7,1.07767,0,0
CTU1,Ctu1,0,-2,-2,61.048544,0,0
CTU2,Ctu2,6,-4,2,8.339806,0,0
CTXN1,Ctxn1,6,-5,1,79.970874,0,0
CTXN2,Ctxn2,-2,1,-1,0,0,0
CTXN3,Ctxn3,1,6,7,0,0,0
CUBN,Cubn,0,1,1,0,0,0
CUEDC1,Cuedc1,-10,1,-9,113.359223,0,0
CUEDC2,Cuedc2,8,-4,4,5.320388,0,0
CUL1,Cul1,0,-9,-9,5.271845,0,0
CUL2,Cul2,1,-2,-1,9.61165,0,0
CUL3,Cul3,4,-4,0,8.368932,0,0
CUL4A,Cul4a,6,-4,2,11.135922,0,0
CUL4B,Cul4b,5,0,5,6.427184,0,0
CUL5,Cul5,7,-3,4,14.747573,0,0
CUL7,Cul7,10,1,11,9.631068,0,0
CUL9,Cul9,12,-1,11,3.029126,0,0
CUTA,Cuta,9,0,9,1.339806,0,0
CUTC,Cutc,8,-12,-4,3.776699,0,0
CUX1,Cux1,10,-1,9,3.116505,0,0
CUX2,Cux2,0,-2,-2,0,0,0
CUZD1,Cuzd1,17,12,29,0,0,0
CWC15,Cwc15,6,-6,0,3.31068,0,0
CWC22,Cwc22,4,-7,-3,0,0,0
CWC25,Cwc25,1,6,7,2.951456,0,0
CWC27,Cwc27,9,-5,4,0,0,0
CWF19L1,Cwf19l1,2,-5,-3,9.213592,0,0
CWF19L2,Cwf19l2,15,-6,9,30.019417,0,0
CWH43,Cwh43,13,3,16,0,0,0
CX3CL1,Cx3cl1,-1,12,11,0,0,0
CX3CR1,Cx3cr1,1,6,7,0,0,0
CXADR,Cxadr,5,-5,0,42.514563,0,0
CXCL1,Cxcl1,4,8,12,0,0,0
CXCL10,Cxcl10,-7,7,0,0,0,0
CXCL11,Cxcl11,20,4,24,0,0,0
CXCL12,Cxcl12,-4,2,-2,0,0,0
CXCL13,Cxcl13,9,7,16,4.990291,0,0
CXCL14,Cxcl14,3,4,7,0,0,0
CXCL16,Cxcl16,3,-8,-5,5.436893,0,0
CXCL17,Cxcl17,-9,2,-7,0,0,0
CXCL2,Cxcl2,-1,8,7,12.533981,0,0
CXCL3,Cxcl3,-2,0,-2,12.126214,0,0
CXCL5,Cxcl5,-4,-6,-10,0,0,0
CXCL9,Cxcl9,0,-7,-7,0,0,0
CXCR1,Cxcr1,2,-3,-1,0,0,0
CXCR2,Cxcr2,-2,8,6,0,0,0
CXCR3,Cxcr3,6,-10,-4,0,0,0
CXCR4,Cxcr4,31,12,43,0,0,0
CXCR5,Cxcr5,7,5,12,10.786408,0,0
CXCR6,Cxcr6,-1,-2,-3,0,0,0
CXXC1,Cxxc1,5,-1,4,5.339806,0,0
CXXC4,Cxxc4,2,7,9,2.883495,0,0
CXXC5,Cxxc5,-4,-3,-7,4.805825,0,0
CYB561,Cyb561,4,3,7,57.300971,0,0
CYB561A3,Cyb561a3,0,-7,-7,6.029126,0,0
CYB561D1,Cyb561d1,-5,-10,-15,9.126214,0,0
CYB561D2,Cyb561d2,3,-7,-4,2.776699,0,0
CYB5A,Cyb5a,1,-3,-2,2.019417,0,0
CYB5B,Cyb5b,2,-1,1,0,0,0
CYB5D1,Cyb5d1,5,-7,-2,4.514563,0,0
CYB5D2,Cyb5d2,6,-4,2,7.825243,0,0
CYB5R1,Cyb5r1,-2,-3,-5,0.660194,0,0
CYB5R2,Cyb5r2,-4,-5,-9,0,0,0
CYB5R3,Cyb5r3,4,0,4,2.31068,0,0
CYB5R4,Cyb5r4,5,-7,-2,6.339806,0,0
CYB5RL,Cyb5rl,1,-5,-4,2.271845,0,0
CYBA,Cyba,-11,0,-11,0,0,0
CYBB,Cybb,0,-1,-1,0,0,0
CYBC1,Cybc1,2,1,3,6.485437,0,0
CYBRD1,Cybrd1,9,-5,4,0.747573,0,0
CYC1,Cyc1,2,-1,1,69.174757,0,0
CYCS,Cycs,2,3,5,18.514563,0,138
CYFIP1,Cyfip1,5,-4,1,5.669903,0,0
CYFIP2,Cyfip2,10,0,10,5.31068,0,0
CYGB,Cygb,8,2,10,4.300971,0,0
CYLC1,Cylc1,0,-3,-3,0,0,0
CYLC2,Cylc2,-2,-3,-5,0,0,0
CYLD,Cyld,7,-3,4,3.864078,0,0
CYP11A1,Cyp11a1,14,0,14,0,0,0
CYP11B1,Cyp11b1,0,5,5,0,0,0
CYP11B2,Cyp11b2,0,2,2,0,0,0
CYP17A1,Cyp17a1,11,1,12,0,0,0
CYP19A1,Cyp19a1,0,-3,-3,1.61165,0,0
CYP1A1,Cyp1a1,-5,-4,-9,8.84466,0,0
CYP1A2,Cyp1a2,1,-4,-3,0,0,0
CYP1B1,Cyp1b1,0,2,2,6.679612,0,0
CYP20A1,Cyp20a1,5,-2,3,11.76699,0,0
CYP24A1,Cyp24a1,-5,-13,-18,0,0,0
CYP26A1,Cyp26a1,8,-1,7,0,0,0
CYP26B1,Cyp26b1,11,1,12,0,0,0
CYP26C1,Cyp26c1,-3,-3,-6,0,0,0
CYP27A1,Cyp27a1,22,5,27,0,0,0
CYP27B1,Cyp27b1,4,-2,2,0,0,0
CYP2R1,Cyp2r1,-1,-12,-13,35.825243,0,0
CYP2S1,Cyp2s1,0,8,8,1.067961,0,0
CYP2U1,Cyp2u1,-1,-4,-5,3.883495,0,0
CYP2W1,Cyp2w1,5,-5,0,0,0,0
CYP39A1,Cyp39a1,56,-6,50,55.368932,0,0
CYP46A1,Cyp46a1,4,0,4,26.271845,0,0
CYP4B1,Cyp4b1,1,2,3,0,0,0
CYP4X1,Cyp4x1,0,2,2,0,0,0
CYP7A1,Cyp7a1,9,-1,8,0,0,0
CYP7B1,Cyp7b1,2,1,3,0,0,0
CYP8B1,Cyp8b1,0,-4,-4,0,0,0
CYREN,Cyren,3,-1,2,20.378641,0,0
CYRIA,Cyria,-2,4,2,0,0,0
CYRIB,Cyrib,1,-5,-4,11.475728,0,0
CYS1,Cys1,-4,20,16,0,0,0
CYSLTR1,Cysltr1,8,-1,7,0,0,0
CYSLTR2,Cysltr2,0,0,0,1.825243,0,0
CYSRT1,Cysrt1,8,13,21,3.184466,0,0
CYSTM1,Cystm1,8,4,12,38.747573,0,0
CYTH1,Cyth1,7,1,8,2.300971,0,0
CYTH2,Cyth2,4,-3,1,23.699029,0,0
CYTH3,Cyth3,5,-3,2,4.873786,0,0
CYTH4,Cyth4,-2,-1,-3,0,0,0
CYTIP,Cytip,13,1,14,0,0,0
CYTL1,Cytl1,-1,2,1,0,0,0
CYYR1,Cyyr1,-5,-4,-9,0,0,0
CZIB,Czib,4,-9,-5,11.252427,0,0
D2HGDH,D2hgdh,-21,-8,-29,2.184466,0,0
DAAM1,Daam1,14,1,15,21.417476,0,0
DAAM2,Daam2,0,-2,-2,0,0,0
DAB1,Dab1,-3,-3,-6,11.61165,0,0
DAB2,Dab2,4,-6,-2,10.048544,0,0
DAB2IP,Dab2ip,-2,-2,-4,0,0,0
DACH1,Dach1,4,2,6,0,0,0
DACH2,Dach2,5,0,5,0,0,0
DACT1,Dact1,17,-1,16,2.07767,0,0
DACT2,Dact2,3,0,3,11.029126,0,0
DACT3,Dact3,9,-2,7,0,0,0
DAD1,Dad1,6,-2,4,12.184466,0,0
DAG1,Dag1,4,0,4,12.417476,0,0
DAGLA,Dagla,-3,-11,-14,70.84466,0,0
DAGLB,Daglb,16,-1,15,18.349515,0,0
DALRD3,Dalrd3,2,1,3,13.796117,0,0
DAND5,Dand5,4,4,8,9.718447,0,0
DAO,Dao,0,4,4,0,0,0
DAP,Dap,4,4,8,8.650485,0,0
DAP3,Dap3,7,-6,1,4.640777,0,0
DAPK1,Dapk1,9,5,14,11.475728,0,0
DAPK2,Dapk2,6,-2,4,1.475728,0,0
DAPK3,Dapk3,4,-5,-1,12.456311,0,0
DAPL1,Dapl1,-1,5,4,0,0,0
DAPP1,Dapp1,2,-5,-3,0,0,0
DARS2,Dars2,4,-9,-5,13.776699,0,0
DAW1,Daw1,-1,-5,-6,0,0,0
DAXX,Daxx,-2,-4,-6,9.757282,0,0
DAZAP1,Dazap1,6,-6,0,2.543689,0,0
DAZAP2,Dazap2,8,-2,6,0,0,0
DAZL,Dazl,44,4,48,114.631068,0,0
DBF4,Dbf4,-2,6,4,7.029126,0,0
DBH,Dbh,0,-1,-1,0,0,0
DBI,Dbi,8,-5,3,4.815534,0,0
DBN1,Dbn1,21,-6,15,10.495146,0,0
DBNDD1,Dbndd1,5,-9,-4,23.951456,0,0
DBNDD2,Dbndd2,1,2,3,3.68932,0,0
DBNL,Dbnl,5,-3,2,4.242718,0,0
DBP,Dbp,31,4,35,48.553398,0,0
DBR1,Dbr1,-9,-8,-17,6.38835,0,0
DBT,Dbt,1,0,1,0,0,0
DBX1,Dbx1,1,3,4,0,0,0
DBX2,Dbx2,0,0,0,0,0,0
DCAF1,Dcaf1,7,-3,4,28.990291,0,0
DCAF10,Dcaf10,5,4,9,23.271845,0,0
DCAF11,Dcaf11,12,-6,6,7.533981,0,0
DCAF12,Dcaf12,5,-5,0,12.174757,0,0
DCAF12L1,Dcaf12l1,2,3,5,0,0,0
DCAF12L2,Dcaf12l2,0,0,0,0,0,0
DCAF13,Dcaf13,4,1,5,17.631068,0,0
DCAF15,Dcaf15,1,-11,-10,20.38835,0,0
DCAF17,Dcaf17,3,0,3,7.747573,0,0
DCAF4,Dcaf4,-6,-2,-8,5.368932,0,0
DCAF5,Dcaf5,10,-5,5,33.31068,0,0
DCAF6,Dcaf6,6,1,7,53.184466,0,0
DCAF7,Dcaf7,8,-4,4,14.883495,0,0
DCAF8,Dcaf8,11,-6,5,12.621359,0,0
DCAKD,Dcakd,5,0,5,10.796117,0,0
DCBLD1,Dcbld1,-6,-7,-13,8.786408,0,80
DCBLD2,Dcbld2,6,-1,5,11.592233,0,0
DCC,Dcc,4,2,6,0,0,0
DCDC2B,Dcdc2b,19,-7,12,65.466019,0,0
DCDC2C,Dcdc2c,0,-5,-5,5.883495,0,0
DCHS1,Dchs1,7,2,9,0,0,0
DCHS2,Dchs2,1,-2,-1,1.058252,0,0
DCK,Dck,12,0,12,11.990291,0,0
DCLK1,Dclk1,9,-5,4,0,0,0
DCLK2,Dclk2,8,-1,7,0,0,0
DCLK3,Dclk3,8,-4,4,13.737864,0,0
DCLRE1A,Dclre1a,0,-1,-1,1.165049,0,0
DCLRE1B,Dclre1b,45,-5,40,107.524272,0,0
DCLRE1C,Dclre1c,4,-3,1,2.067961,0,0
DCN,Dcn,3,1,4,0,0,0
DCP1A,Dcp1a,7,-3,4,43.601942,0,0
DCP1B,Dcp1b,-3,-12,-15,37.912621,0,0
DCP2,Dcp2,8,1,9,0,0,0
DCPS,Dcps,2,-5,-3,5.796117,0,0
DCST1,Dcst1,4,-8,-4,0,0,0
DCST2,Dcst2,18,-10,8,0,0,0
DCSTAMP,Dcstamp,5,8,13,0,0,0
DCT,Dct,-1,1,0,18.757282,0,0
DCTD,Dctd,-1,-7,-8,3.203883,0,0
DCTN1,Dctn1,8,-5,3,9.242718,0,0
DCTN2,Dctn2,5,-6,-1,1.058252,0,0
DCTN3,Dctn3,3,-1,2,0,0,0
DCTN4,Dctn4,9,0,9,0,0,0
DCTN5,Dctn5,5,-3,2,16.135922,0,155
DCTN6,Dctn6,10,-7,3,2.970874,0,0
DCTPP1,Dctpp1,3,-2,1,0,0,0
DCUN1D1,Dcun1d1,5,-9,-4,5.757282,0,0
DCUN1D2,Dcun1d2,5,-2,3,10.737864,0,0
DCUN1D3,Dcun1d3,10,0,10,11.776699,0,0
DCUN1D4,Dcun1d4,6,-9,-3,3.61165,0,0
DCUN1D5,Dcun1d5,8,0,8,6.223301,0,0
DCX,Dcx,5,2,7,0,0,0
DCXR,Dcxr,6,0,6,5.262136,0,0
DDA1,Dda1,3,-3,0,12.932039,0,0
DDAH1,Ddah1,12,2,14,15.38835,0,0
DDAH2,Ddah2,9,-3,6,3.378641,0,0
DDB1,Ddb1,7,-7,0,13.009709,0,0
DDB2,Ddb2,5,-1,4,1.203883,0,0
DDC,Ddc,2,-1,1,0,0,0
DDHD1,Ddhd1,7,-1,6,10.398058,0,0
DDHD2,Ddhd2,0,-6,-6,1.650485,0,0
DDI1,Ddi1,-3,-2,-5,0,0,0
DDI2,Ddi2,1,1,2,15.194175,0,0
DDIAS,Ddias,5,-10,-5,5.61165,0,0
DDIT3,Ddit3,10,7,17,2.213592,0,0
DDIT4,Ddit4,46,26,72,39.349515,0,0
DDIT4L,Ddit4l,8,-6,2,0,0,0
DDN,Ddn,9,6,15,0,0,0
DDO,Ddo,-1,-1,-2,0,0,0
DDOST,Ddost,7,-2,5,3.15534,0,0
DDR1,Ddr1,9,6,15,2.339806,0,0
DDR2,Ddr2,9,0,9,0,0,0
DDRGK1,Ddrgk1,3,-5,-2,0,0,0
DDT,Ddt,1,-5,-4,4.640777,0,0
DDX1,Ddx1,3,-5,-2,25.679612,0,0
DDX10,Ddx10,2,-1,1,1.048544,0,0
DDX11,Ddx11,3,-10,-7,2.524272,0,0
DDX17,Ddx17,9,1,10,0.699029,0,0
DDX18,Ddx18,3,-1,2,11.660194,0,0
DDX19A,Ddx19a,2,-2,0,3.699029,0,0
DDX19B,Ddx19b,3,-3,0,3.524272,0,0
DDX20,Ddx20,2,-9,-7,4.990291,0,0
DDX21,Ddx21,3,-6,-3,3.563107,0,0
DDX23,Ddx23,7,0,7,11.621359,0,0
DDX24,Ddx24,7,2,9,6.368932,0,0
DDX25,Ddx25,0,-8,-8,11.669903,0,0
DDX27,Ddx27,4,0,4,4.067961,0,0
DDX28,Ddx28,-25,-10,-35,10.407767,0,0
DDX31,Ddx31,0,-5,-5,15.990291,0,0
DDX39A,Ddx39a,3,-6,-3,3.145631,0,0
DDX39B,Ddx39b,8,-2,6,0,0,126
DDX3X,Ddx3x,-1,-1,-2,46.873786,0,0
DDX3Y,Ddx3y,2,4,6,0,0,0
DDX4,Ddx4,12,6,18,1.058252,0,0
DDX41,Ddx41,3,1,4,7.737864,0,0
DDX42,Ddx42,7,-5,2,11,0,0
DDX43,Ddx43,6,-2,4,0,0,0
DDX46,Ddx46,6,-3,3,9.407767,0,0
DDX47,Ddx47,13,-3,10,3.805825,0,0
DDX49,Ddx49,2,0,2,4.009709,0,0
DDX5,Ddx5,2,0,2,6.873786,0,0
DDX50,Ddx50,0,0,0,8.349515,0,0
DDX51,Ddx51,6,-2,4,7.543689,0,0
DDX52,Ddx52,2,-4,-2,0.68932,0,0
DDX54,Ddx54,0,-4,-4,7.174757,0,0
DDX55,Ddx55,2,-5,-3,0,0,0
DDX56,Ddx56,7,-1,6,1.825243,0,0
DDX59,Ddx59,3,-6,-3,25.582524,0,0
DDX6,Ddx6,10,-3,7,4.038835,0,0
DDX60,Ddx60,-1,-6,-7,1.281553,0,0
DEAF1,Deaf1,5,-6,-1,3.961165,0,0
DECR1,Decr1,4,-5,-1,8.446602,0,0
DECR2,Decr2,-4,-1,-5,1.864078,0,0
DEDD,Dedd,4,-6,-2,13.864078,0,0
DEDD2,Dedd2,143,22,165,198.970874,39.083333,0
DEF6,Def6,0,-1,-1,9.495146,0,0
DEF8,Def8,10,-8,2,3.466019,0,0
DEFA3,Defa3,-1,13,12,0,0,0
DEFA5,Defa5,0,4,4,0,0,0
DEFB1,Defb1,7,1,8,0,0,0
DEGS1,Degs1,-1,0,-1,8,0,0
DEGS2,Degs2,-1,-7,-8,0,0,0
DEK,Dek,7,-1,6,9.582524,0,0
DELE1,Dele1,0,-3,-3,2.135922,0,0
DENND10,Dennd10,2,-11,-9,4,0,0
DENND11,Dennd11,5,-6,-1,1.31068,0,0
DENND1A,Dennd1a,8,-5,3,34.475728,0,0
DENND1B,Dennd1b,5,2,7,4.961165,0,0
DENND1C,Dennd1c,-3,1,-2,0,0,0
DENND2A,Dennd2a,11,0,11,42.970874,0,0
DENND2C,Dennd2c,-1,-5,-6,0.990291,0,0
DENND2D,Dennd2d,2,-2,0,11.737864,0,0
DENND3,Dennd3,-8,-1,-9,4.407767,0,0
DENND4A,Dennd4a,3,-2,1,2.407767,0,0
DENND4B,Dennd4b,0,-12,-12,8.145631,0,0
DENND4C,Dennd4c,1,-11,-10,0,0,0
DENND5A,Dennd5a,9,-4,5,3.291262,0,0
DENND5B,Dennd5b,11,1,12,8.718447,0,0
DENND6A,Dennd6a,0,-3,-3,8.543689,0,0
DENND6B,Dennd6b,9,-6,3,24.582524,0,0
DENR,Denr,3,-7,-4,13.873786,0,0
DEPDC1B,Depdc1b,3,-13,-10,6.407767,0,0
DEPDC5,Depdc5,3,-11,-8,5.242718,0,0
DEPDC7,Depdc7,2,1,3,0,0,0
DEPP1,Depp1,70,-2,68,0,0,0
DEPTOR,Deptor,2,3,5,5.805825,0,0
DERA,Dera,7,-2,5,6.747573,0,0
DERL1,Derl1,8,-2,6,8.669903,0,0
DERL2,Derl2,4,-3,1,3.029126,0,0
DERL3,Derl3,9,-12,-3,6.271845,0,0
DERPC,Derpc,9,9,18,10.563107,0,0
DES,Des,-3,0,-3,0,0,0
DESI1,Desi1,2,-6,-4,0,0,0
DESI2,Desi2,7,-1,6,7.407767,0,0
DET1,Det1,4,-2,2,0,0,0
DEUP1,Deup1,1,-6,-5,0,0,0
DEXI,Dexi,6,-8,-2,6.728155,0,0
DFFA,Dffa,6,-3,3,59.174757,14.625,0
DFFB,Dffb,3,-6,-3,15.252427,0,0
DGAT1,Dgat1,8,-4,4,57.368932,14.5,0
DGAT2,Dgat2,-21,-11,-32,10.631068,0,0
DGAT2L6,Dgat2l6,1,5,6,0,0,0
DGCR2,Dgcr2,5,-7,-2,0,0,0
DGCR6,Dgcr6,3,-6,-3,0,0,0
DGCR8,Dgcr8,1,-5,-4,7.660194,0,0
DGKA,Dgka,-4,-4,-8,3.92233,0,0
DGKB,Dgkb,5,-2,3,1.495146,0,0
DGKD,Dgkd,5,-4,1,0,0,0
DGKE,Dgke,22,-4,18,417.796117,300.5,0
DGKG,Dgkg,-3,4,1,0,0,0
DGKH,Dgkh,2,0,2,5.271845,0,0
DGKI,Dgki,3,2,5,1.757282,0,0
DGKK,Dgkk,1,-1,0,6.786408,0,0
DGKQ,Dgkq,-8,-5,-13,0,0,0
DGKZ,Dgkz,6,-7,-1,10.61165,0,0
DGLUCY,Dglucy,4,-1,3,16.07767,0,0
DGUOK,Dguok,8,-6,2,0,0,0
DHCR24,Dhcr24,2,-6,-4,6.300971,0,0
DHCR7,Dhcr7,-4,-8,-12,0,0,0
DHDDS,Dhdds,-4,-2,-6,18.621359,0,0
DHDH,Dhdh,82,0,82,0,0,0
DHFR,Dhfr,2,-3,-1,364.68932,117.541667,518
DHH,Dhh,37,6,43,0,0,0
DHODH,Dhodh,-4,1,-3,0,0,0
DHPS,Dhps,6,-4,2,8.504854,0,0
DHRS1,Dhrs1,5,-5,0,5.951456,0,0
DHRS11,Dhrs11,0,-4,-4,1.106796,0,0
DHRS13,Dhrs13,-1,-7,-8,14.067961,0,0
DHRS2,Dhrs2,41,-8,33,5.621359,0,0
DHRS3,Dhrs3,18,-4,14,21.728155,0,0
DHRS4,Dhrs4,9,-8,1,6.864078,0,0
DHRS7,Dhrs7,11,-3,8,8.427184,0,0
DHRS7B,Dhrs7b,4,0,4,2.262136,0,0
DHRS7C,Dhrs7c,2,0,2,0,0,0
DHRS9,Dhrs9,7,0,7,0,0,0
DHTKD1,Dhtkd1,1,-6,-5,0,0,0
DHX15,Dhx15,5,-2,3,0,0,0
DHX16,Dhx16,6,-4,2,16.485437,0,0
DHX29,Dhx29,5,-7,-2,20.737864,0,0
DHX30,Dhx30,8,-4,4,27.38835,0,0
DHX32,Dhx32,-10,-8,-18,0,0,0
DHX33,Dhx33,0,-5,-5,7.84466,0,0
DHX34,Dhx34,9,-2,7,39.786408,0,0
DHX35,Dhx35,-21,-3,-24,0,0,0
DHX36,Dhx36,5,1,6,1.990291,0,0
DHX37,Dhx37,1,-6,-5,11.281553,0,0
DHX38,Dhx38,6,2,8,1.951456,0,0
DHX40,Dhx40,9,0,9,8.330097,0,0
DHX57,Dhx57,2,-3,-1,53.262136,0,0
DHX58,Dhx58,15,-16,-1,0,0,0
DHX8,Dhx8,10,-5,5,10.84466,0,0
DHX9,Dhx9,8,-4,4,23.009709,0,0
DIABLO,Diablo,4,-6,-2,6.194175,0,0
DIAPH1,Diaph1,8,-3,5,13.330097,0,0
DIAPH2,Diaph2,0,-2,-2,2.786408,0,0
DIAPH3,Diaph3,1,-7,-6,1.15534,0,0
DICER1,Dicer1,6,-3,3,43.84466,5.416667,0
DIDO1,Dido1,10,-2,8,21.194175,0,0
DIMT1,Dimt1,1,-5,-4,4.223301,0,0
DIO1,Dio1,8,5,13,26.864078,0,0
DIO2,Dio2,1,1,2,0,0,0
DIO3,Dio3,3,4,7,0,0,0
DIP2A,Dip2a,5,-8,-3,2.776699,0,0
DIP2B,Dip2b,10,-3,7,16.533981,0,0
DIP2C,Dip2c,3,-3,0,0,0,0
DIPK1A,Dipk1a,-9,-12,-21,4.92233,0,0
DIPK1B,Dipk1b,0,-9,-9,0,0,0
DIPK1C,Dipk1c,1,0,1,0,0,0
DIPK2A,Dipk2a,4,1,5,9.84466,0,0
DIPK2B,Dipk2b,0,2,2,0,0,0
DIRAS1,Diras1,36,8,44,0,0,0
DIRAS2,Diras2,30,3,33,1.087379,0,0
DIS3,Dis3,1,-5,-4,3.029126,0,0
DIS3L,Dis3l,5,-6,-1,1.980583,0,0
DIS3L2,Dis3l2,9,-6,3,10.058252,0,0
DISC1,Disc1,5,-7,-2,19.640777,0,0
DISP1,Disp1,2,-11,-9,15.407767,0,0
DISP2,Disp2,2,-3,-1,1.533981,0,0
DISP3,Disp3,2,0,2,8.223301,0,0
DIXDC1,Dixdc1,4,-5,-1,39.582524,0,0
DKC1,Dkc1,2,-5,-3,8.087379,0,0
DKK1,Dkk1,-9,-3,-12,12.582524,0,0
DKK2,Dkk2,11,1,12,0,0,0
DKK3,Dkk3,3,0,3,0,0,0
DKK4,Dkk4,7,-10,-3,0,0,0
DKKL1,Dkkl1,4,3,7,0,0,0
DLAT,Dlat,2,-8,-6,2.728155,0,0
DLC1,Dlc1,-3,-4,-7,2.980583,0,0
DLD,Dld,3,-9,-6,2.980583,0,0
DLEC1,Dlec1,2,-2,0,0,0,0
DLEU7,Dleu7,3,-6,-3,0,0,0
DLG1,Dlg1,4,0,4,6.553398,0,0
DLG2,Dlg2,12,-16,-4,4.087379,0,0
DLG3,Dlg3,1,-6,-5,2.456311,0,0
DLG4,Dlg4,12,2,14,20.543689,0,0
DLG5,Dlg5,11,-3,8,18.708738,8.458333,0
DLGAP1,Dlgap1,8,5,13,0,0,0
DLGAP2,Dlgap2,5,-5,0,0,0,0
DLGAP3,Dlgap3,-1,-6,-7,0,0,0
DLGAP4,Dlgap4,9,-2,7,3.961165,0,0
DLGAP5,Dlgap5,-2,-2,-4,1.475728,0,0
DLK1,Dlk1,-3,11,8,0,0,0
DLK2,Dlk2,-1,-3,-4,0,0,0
DLL1,Dll1,20,6,26,0,0,0
DLL3,Dll3,19,-2,17,1.864078,0,0
DLL4,Dll4,10,2,12,0,0,0
DLST,Dlst,4,-2,2,0,0,0
DLX1,Dlx1,11,-2,9,3.961165,0,0
DLX2,Dlx2,40,8,48,3.650485,0,0
DLX3,Dlx3,7,-5,2,0,0,0
DLX4,Dlx4,8,-10,-2,5.553398,0,0
DLX5,Dlx5,14,-8,6,2.417476,0,0
DLX6,Dlx6,12,-11,1,1.106796,0,0
DMAC1,Dmac1,-1,-5,-6,1.15534,0,0
DMAC2,Dmac2,3,-5,-2,0,0,0
DMAC2L,Dmac2l,2,1,3,6.883495,0,0
DMAP1,Dmap1,6,-4,2,57.980583,0,0
DMBT1,Dmbt1,0,1,1,0,0,0
DMBX1,Dmbx1,5,2,7,14.446602,0,0
DMC1,Dmc1,6,0,6,0,0,0
DMD,Dmd,11,0,11,2.116505,0,0
DMGDH,Dmgdh,-1,1,0,0,0,0
DMKN,Dmkn,7,6,13,0,0,0
DMP1,Dmp1,-1,-3,-4,0,0,0
DMPK,Dmpk,5,-6,-1,0,0,0
DMRT1,Dmrt1,9,-2,7,13.650485,0,0
DMRT2,Dmrt2,4,-3,1,1.572816,0,0
DMRT3,Dmrt3,0,0,0,1.563107,0,0
DMRTA1,Dmrta1,5,0,5,5.213592,0,0
DMRTA2,Dmrta2,8,-13,-5,2.61165,0,0
DMRTB1,Dmrtb1,27,-4,23,68.446602,0,0
DMRTC1B,Dmrtc1b,5,3,8,0,0,0
DMRTC2,Dmrtc2,0,2,2,0,0,0
DMTF1,Dmtf1,3,-6,-3,17.718447,0,0
DMTN,Dmtn,15,-4,11,13.475728,0,0
DMWD,Dmwd,-2,-1,-3,126.970874,0,0
DMXL1,Dmxl1,2,-9,-7,5.398058,0,0
DMXL2,Dmxl2,3,0,3,12.854369,0,0
DNA2,Dna2,6,-8,-2,10.291262,0,0
DNAAF1,Dnaaf1,19,-10,9,106.883495,0,0
DNAAF2,Dnaaf2,-2,-4,-6,8.990291,0,0
DNAAF3,Dnaaf3,7,-7,0,43.970874,0,0
DNAAF4,Dnaaf4,10,-8,2,0,0,0
DNAAF5,Dnaaf5,7,-1,6,0,0,0
DNAAF6,Dnaaf6,-5,-4,-9,0,0,0
DNAH1,Dnah1,2,-9,-7,0,0,0
DNAH10,Dnah10,22,-3,19,5.446602,0,0
DNAH11,Dnah11,7,0,7,5.84466,0,0
DNAH12,Dnah12,17,-9,8,3.029126,0,0
DNAH14,Dnah14,0,-28,-28,7.679612,0,0
DNAH17,Dnah17,0,-8,-8,2.07767,0,0
DNAH2,Dnah2,4,-10,-6,31.796117,0,0
DNAH3,Dnah3,1,-6,-5,5.669903,0,0
DNAH5,Dnah5,-1,-5,-6,2.61165,0,0
DNAH6,Dnah6,0,-7,-7,5.524272,0,0
DNAH8,Dnah8,6,-6,0,0,0,0
DNAH9,Dnah9,2,0,2,1.436893,0,0
DNAI1,Dnai1,3,4,7,2.097087,0,0
DNAI2,Dnai2,8,-5,3,3.514563,0,0
DNAI3,Dnai3,-1,-7,-8,1.436893,0,0
DNAI4,Dnai4,8,-10,-2,42.213592,0,0
DNAJA1,Dnaja1,67,26,93,476.728155,269.166667,218
DNAJA2,Dnaja2,7,-1,6,3.213592,0,0
DNAJA3,Dnaja3,-1,-8,-9,6.194175,0,0
DNAJA4,Dnaja4,106,35,141,143.194175,0,0
DNAJB1,Dnajb1,210,71,281,507.893204,375.083333,0
DNAJB11,Dnajb11,-1,2,1,12.330097,0,0
DNAJB12,Dnajb12,6,-2,4,5.621359,0,0
DNAJB13,Dnajb13,4,-6,-2,0,0,0
DNAJB14,Dnajb14,5,2,7,13.349515,0,0
DNAJB2,Dnajb2,23,-1,22,179.330097,46.208333,0
DNAJB4,Dnajb4,149,20,169,79.815534,12.916667,91
DNAJB5,Dnajb5,11,-12,-1,82.543689,19.083333,0
DNAJB6,Dnajb6,34,1,35,800.660194,425.875,345
DNAJB7,Dnajb7,2,4,6,246.747573,0,0
DNAJB8,Dnajb8,-1,-10,-11,0,0,0
DNAJB9,Dnajb9,8,-1,7,3.203883,0,0
DNAJC1,Dnajc1,1,-4,-3,29.718447,0,0
DNAJC10,Dnajc10,1,-4,-3,28.514563,0,0
DNAJC11,Dnajc11,6,-4,2,27.679612,0,0
DNAJC12,Dnajc12,3,1,4,0,0,0
DNAJC13,Dnajc13,-1,-6,-7,5.621359,0,0
DNAJC14,Dnajc14,5,-6,-1,3.834951,0,0
DNAJC15,Dnajc15,4,-5,-1,0,0,0
DNAJC16,Dnajc16,1,-6,-5,41.776699,0,0
DNAJC17,Dnajc17,-6,0,-6,3.359223,0,0
DNAJC18,Dnajc18,2,-6,-4,0,0,0
DNAJC19,Dnajc19,2,-5,-3,5.76699,0,0
DNAJC2,Dnajc2,2,-5,-3,9.728155,0,0
DNAJC21,Dnajc21,-2,-2,-4,4.524272,0,0
DNAJC22,Dnajc22,-1,-3,-4,9.252427,0,0
DNAJC24,Dnajc24,42,-5,37,25.407767,0,0
DNAJC25,Dnajc25,1,-5,-4,25.592233,0,0
DNAJC27,Dnajc27,-11,-13,-24,14.184466,0,0
DNAJC28,Dnajc28,-7,5,-2,0,0,0
DNAJC3,Dnajc3,8,-4,4,2.038835,0,0
DNAJC30,Dnajc30,-5,-10,-15,9.815534,0,0
DNAJC4,Dnajc4,13,-4,9,0.873786,0,0
DNAJC5,Dnajc5,8,3,11,3.912621,0,0
DNAJC5B,Dnajc5b,5,-4,1,0,0,0
DNAJC5G,Dnajc5g,13,2,15,0,0,0
DNAJC6,Dnajc6,3,-2,1,3.087379,0,0
DNAJC7,Dnajc7,15,-5,10,91.514563,0,0
DNAJC8,Dnajc8,5,-7,-2,0,0,0
DNAJC9,Dnajc9,5,-3,2,40.31068,14.375,0
DNAL1,Dnal1,8,5,13,14.563107,0,0
DNAL4,Dnal4,8,-6,2,8.009709,0,0
DNALI1,Dnali1,4,-6,-2,1.242718,0,0
DNASE1,Dnase1,11,-9,2,0,0,0
DNASE1L1,Dnase1l1,4,-7,-3,2.533981,0,0
DNASE1L2,Dnase1l2,8,-2,6,0,0,0
DNASE1L3,Dnase1l3,1,0,1,0,0,0
DNASE2B,Dnase2b,5,3,8,1.330097,0,0
DND1,Dnd1,6,-10,-4,0,0,0
DNER,Dner,9,0,9,17.563107,0,0
DNHD1,Dnhd1,26,0,26,5.271845,0,0
DNLZ,Dnlz,4,-4,0,0,0,0
DNM1,Dnm1,6,-6,0,6.553398,0,0
DNM1L,Dnm1l,8,0,8,5.718447,0,0
DNM2,Dnm2,7,-2,5,8.864078,0,0
DNM3,Dnm3,4,1,5,0,0,0
DNMBP,Dnmbp,1,0,1,3.815534,0,0
DNMT1,Dnmt1,10,1,11,11.184466,0,0
DNMT3A,Dnmt3a,2,-1,1,1.067961,0,0
DNMT3B,Dnmt3b,-9,-8,-17,62.029126,0,0
DNMT3L,Dnmt3l,35,-6,29,7.271845,6.583333,0
DNPEP,Dnpep,4,-7,-3,0,0,0
DNPH1,Dnph1,-1,-5,-6,13.932039,0,0
DNTT,Dntt,2,-3,-1,0,0,0
DNTTIP1,Dnttip1,2,-3,-1,43.640777,0,0
DNTTIP2,Dnttip2,6,-6,0,47.504854,0,0
DOC2A,Doc2a,7,2,9,1.339806,0,0
DOC2B,Doc2b,3,4,7,0,0,0
DOCK1,Dock1,4,0,4,4.446602,0,0
DOCK10,Dock10,14,2,16,40.543689,0,0
DOCK11,Dock11,0,-2,-2,1,0,0
DOCK2,Dock2,0,0,0,0,0,0
DOCK3,Dock3,7,1,8,4.174757,0,0
DOCK4,Dock4,7,1,8,5.980583,0,0
DOCK5,Dock5,5,-6,-1,18.718447,0,0
DOCK6,Dock6,5,-9,-4,2.699029,0,0
DOCK7,Dock7,6,-9,-3,9.135922,0,0
DOCK8,Dock8,1,2,3,0,0,0
DOCK9,Dock9,-4,0,-4,0,0,0
DOHH,Dohh,1,-4,-3,7.398058,0,0
DOK1,Dok1,-7,-3,-10,6.601942,0,0
DOK2,Dok2,29,-3,26,4.194175,0,0
DOK3,Dok3,4,3,7,0,0,0
DOK4,Dok4,2,0,2,1.592233,0,0
DOK5,Dok5,4,3,7,0,0,0
DOK6,Dok6,7,2,9,0,0,0
DOK7,Dok7,-4,-2,-6,16.07767,0,0
DOLK,Dolk,-17,-6,-23,5.61165,0,0
DOLPP1,Dolpp1,-1,-5,-6,3.902913,0,0
DONSON,Donson,6,-9,-3,45.592233,0,0
DOP1A,Dop1a,-7,-7,-14,6.242718,0,0
DOP1B,Dop1b,1,0,1,1.097087,0,0
DOT1L,Dot1l,2,-11,-9,6.23301,0,0
DPAGT1,Dpagt1,5,-5,0,0,0,0
DPEP1,Dpep1,1,-9,-8,0,0,0
DPEP2,Dpep2,7,-3,4,6.563107,0,0
DPEP2NB,Dpep2nb,29,-8,21,0,0,0
DPEP3,Dpep3,0,0,0,0,0,0
DPF1,Dpf1,3,-9,-6,1.378641,0,0
DPF2,Dpf2,9,-3,6,0.883495,0,0
DPF3,Dpf3,4,2,6,0,0,0
DPH1,Dph1,1,-5,-4,5.019417,0,0
DPH2,Dph2,2,-2,0,1.834951,0,0
DPH3,Dph3,4,-3,1,24.834951,0,0
DPH5,Dph5,-1,3,2,12.339806,0,0
DPH6,Dph6,-5,-8,-13,16.495146,0,0
DPH7,Dph7,5,-8,-3,16.106796,0,0
DPM1,Dpm1,5,2,7,12.893204,0,0
DPM2,Dpm2,13,0,13,3.883495,0,0
DPM3,Dpm3,1,-2,-1,2.174757,0,0
DPP10,Dpp10,-3,-3,-6,13.029126,0,0
DPP3,Dpp3,4,-7,-3,3.07767,0,0
DPP4,Dpp4,20,1,21,5.805825,0,0
DPP6,Dpp6,2,1,3,0,0,0
DPP7,Dpp7,0,9,9,2,0,0
DPP8,Dpp8,3,-4,-1,8.757282,0,0
DPP9,Dpp9,2,-3,-1,79.291262,0,0
DPPA2,Dppa2,15,4,19,0,0,0
DPPA3,Dppa3,-2,7,5,0,0,0
DPPA4,Dppa4,0,2,2,0,0,0
DPT,Dpt,-1,6,5,0,0,0
DPY19L1,Dpy19l1,4,-1,3,70.446602,0,0
DPY19L2,Dpy19l2,8,-8,0,23.281553,0,0
DPY19L3,Dpy19l3,4,3,7,5.067961,0,0
DPY19L4,Dpy19l4,1,-11,-10,68.320388,3.333333,0
DPY30,Dpy30,10,-9,1,5.747573,0,0
DPYD,Dpyd,1,1,2,7.446602,0,0
DPYS,Dpys,34,-4,30,0,0,0
DPYSL2,Dpysl2,10,2,12,25.757282,0,0
DPYSL3,Dpysl3,5,-7,-2,3.61165,0,0
DPYSL4,Dpysl4,11,1,12,0,0,0
DPYSL5,Dpysl5,10,-2,8,0,0,0
DQX1,Dqx1,22,1,23,10.728155,0,0
DR1,Dr1,4,0,4,17.679612,0,0
DRAM1,Dram1,8,-13,-5,7.07767,0,0
DRAM2,Dram2,5,-2,3,3.592233,0,0
DRAP1,Drap1,6,1,7,53.31068,0,0
DRAXIN,Draxin,16,0,16,1.572816,0,0
DRC1,Drc1,-1,-8,-9,0,0,0
DRC3,Drc3,13,-7,6,15.174757,0,0
DRC7,Drc7,20,-5,15,2.145631,0,0
DRD1,Drd1,-1,2,1,0,0,0
DRD2,Drd2,-1,0,-1,0,0,0
DRD3,Drd3,2,0,2,0,0,0
DRD4,Drd4,-4,5,1,0,0,0
DRD5,Drd5,0,-5,-5,0,0,0
DRG1,Drg1,3,-11,-8,2.68932,0,0
DRG2,Drg2,9,-3,6,49.106796,0,0
DROSHA,Drosha,4,1,5,2.621359,0,0
DRP2,Drp2,8,3,11,0,0,0
DSC1,Dsc1,4,0,4,0,0,0
DSC2,Dsc2,1,8,9,0,0,0
DSC3,Dsc3,2,2,4,0,0,0
DSCAM,Dscam,-1,-6,-7,0,0,0
DSCAML1,Dscaml1,16,1,17,202.145631,60.833333,0
DSCC1,Dscc1,1,-19,-18,13.728155,0,0
DSE,Dse,5,-7,-2,53.407767,8.416667,0
DSEL,Dsel,4,-3,1,7.116505,0,0
DSG2,Dsg2,-1,-1,-2,3.38835,0,0
DSG3,Dsg3,2,3,5,0,0,0
DSG4,Dsg4,4,1,5,0,0,0
DSN1,Dsn1,-2,0,-2,3.271845,0,0
DSP,Dsp,4,1,5,6.165049,0,0
DSPP,Dspp,1,1,2,0,0,0
DST,Dst,7,-1,6,8.980583,0,0
DSTN,Dstn,9,1,10,5.058252,0,0
DSTYK,Dstyk,4,-4,0,20.572816,0,0
DTD1,Dtd1,3,-11,-8,6.669903,0,0
DTD2,Dtd2,2,-9,-7,11.873786,0,0
DTHD1,Dthd1,0,-1,-1,0,0,0
DTL,Dtl,0,-7,-7,7.747573,0,0
DTNA,Dtna,8,-6,2,0.941748,0,0
DTNB,Dtnb,8,-4,4,4.786408,0,0
DTNBP1,Dtnbp1,1,-3,-2,2.796117,0,0
DTWD1,Dtwd1,3,1,4,46.533981,0,0
DTWD2,Dtwd2,3,-6,-3,6,0,0
DTX1,Dtx1,2,4,6,0,0,0
DTX2,Dtx2,6,-4,2,81.058252,0,0
DTX3,Dtx3,7,-6,1,0,0,0
DTX3L,Dtx3l,2,-1,1,10.048544,3.333333,0
DTX4,Dtx4,4,7,11,62.961165,5.25,0
DTYMK,Dtymk,6,-5,1,0,0,0
DUOX1,Duox1,-1,-5,-6,0,0,0
DUOX2,Duox2,2,4,6,2.116505,0,0
DUOXA1,Duoxa1,25,2,27,15.106796,0,0
DUOXA2,Duoxa2,2,1,3,2.116505,0,0
DUS1L,Dus1l,7,-1,6,18.572816,0,0
DUS2,Dus2,-8,-5,-13,10.407767,0,0
DUS3L,Dus3l,3,-4,-1,4.495146,0,0
DUS4L,Dus4l,-8,-1,-9,11.174757,0,0
DUSP1,Dusp1,87,9,96,150.223301,0,0
DUSP10,Dusp10,13,-5,8,34.203883,0,0
DUSP11,Dusp11,0,-1,-1,0,0,0
DUSP12,Dusp12,2,1,3,10.339806,0,0
DUSP13,Dusp13,10,-3,7,29.893204,4.583333,0
DUSP14,Dusp14,0,0,0,1.970874,0,0
DUSP15,Dusp15,5,-3,2,0,0,0
DUSP16,Dusp16,12,0,12,4.941748,0,0
DUSP18,Dusp18,2,-3,-1,41.359223,0,0
DUSP19,Dusp19,4,-5,-1,0,0,0
DUSP2,Dusp2,43,2,45,34.786408,0,0
DUSP21,Dusp21,3,-4,-1,0,0,0
DUSP22,Dusp22,9,0,9,6.485437,0,0
DUSP23,Dusp23,-3,0,-3,0.873786,0,0
DUSP26,Dusp26,1,5,6,0,0,0
DUSP28,Dusp28,1,1,2,4.174757,0,0
DUSP3,Dusp3,7,3,10,62.320388,0,0
DUSP4,Dusp4,26,4,30,1.990291,0,0
DUSP5,Dusp5,26,1,27,12.553398,0,0
DUSP6,Dusp6,1,0,1,18.514563,0,0
DUSP7,Dusp7,-5,-2,-7,1.203883,0,0
DUSP8,Dusp8,10,13,23,0,0,0
DUSP9,Dusp9,-4,2,-2,0,0,0
DUT,Dut,8,-1,7,3.834951,0,0
DVL1,Dvl1,2,0,2,4.757282,0,0
DVL2,Dvl2,9,0,9,1.038835,0,0
DVL3,Dvl3,7,-3,4,3.048544,0,0
DXO,Dxo,8,1,9,16.427184,0,0
DYDC1,Dydc1,7,-11,-4,0,0,0
DYDC2,Dydc2,6,2,8,0,0,0
DYM,Dym,5,-5,0,11.621359,0,0
DYNAP,Dynap,5,-1,4,0,0,0
DYNC1H1,Dync1h1,9,1,10,9.009709,0,0
DYNC1I1,Dync1i1,4,-3,1,1.320388,0,0
DYNC1I2,Dync1i2,5,-5,0,32.893204,0,0
DYNC1LI1,Dync1li1,1,-2,-1,5.398058,0,0
DYNC1LI2,Dync1li2,6,-5,1,22.737864,0,0
DYNC2H1,Dync2h1,1,1,2,155.174757,0,0
DYNC2I1,Dync2i1,-2,-3,-5,63.407767,0,121
DYNC2I2,Dync2i2,6,-2,4,63.679612,0,0
DYNC2LI1,Dync2li1,4,0,4,62.23301,0,0
DYNLL1,Dynll1,9,3,12,107.359223,0,0
DYNLL2,Dynll2,6,0,6,8.61165,0,0
DYNLRB1,Dynlrb1,11,4,15,15.436893,0,0
DYNLRB2,Dynlrb2,21,-7,14,52.097087,0,0
DYNLT2B,Dynlt2b,8,-6,2,0,0,0
DYNLT3,Dynlt3,5,-1,4,5.864078,0,0
DYRK1A,Dyrk1a,12,-1,11,62.543689,0,0
DYRK1B,Dyrk1b,10,0,10,7.184466,0,0
DYRK2,Dyrk2,4,0,4,6.553398,0,0
DYRK3,Dyrk3,3,-3,0,61.893204,0,0
DYRK4,Dyrk4,3,-2,1,4.883495,0,0
DYSF,Dysf,3,3,6,0,0,0
DYTN,Dytn,2,-2,0,0,0,0
DZANK1,Dzank1,6,0,6,11.737864,0,0
DZIP1,Dzip1,4,-4,0,0,0,0
DZIP1L,Dzip1l,-3,-8,-11,2.932039,0,0
DZIP3,Dzip3,5,-3,2,28.485437,0,0
E2F1,E2f1,0,-4,-4,3.504854,0,0
E2F2,E2f2,-1,-7,-8,1.737864,0,0
E2F3,E2f3,-3,-4,-7,16.126214,0,0
E2F4,E2f4,3,-4,-1,3.76699,0,0
E2F5,E2f5,8,1,9,10.61165,0,0
E2F6,E2f6,-3,2,-1,20.563107,0,0
E2F7,E2f7,4,-6,-2,12.563107,0,0
E2F8,E2f8,-14,-12,-26,18.61165,0,0
E4F1,E4f1,-8,-3,-11,48.912621,0,0
EAF1,Eaf1,10,-4,6,2.524272,0,0
EAF2,Eaf2,4,-3,1,5.368932,0,0
EAPP,Eapp,4,-5,-1,6.592233,0,0
EARS2,Ears2,11,0,11,144.23301,22.166667,0
EBAG9,Ebag9,3,-9,-6,19.932039,0,0
EBF1,Ebf1,0,3,3,3.116505,0,0
EBF2,Ebf2,4,-5,-1,0,0,0
EBF3,Ebf3,1,-3,-2,0,0,0
EBF4,Ebf4,10,-2,8,0,0,0
EBI3,Ebi3,-1,-9,-10,0,0,0
EBNA1BP2,Ebna1bp2,6,-3,3,21.475728,0,0
EBP,Ebp,6,1,7,2,0,0
EBPL,Ebpl,1,-3,-2,1.902913,0,0
ECD,Ecd,-4,-2,-6,26.213592,0,0
ECE1,Ece1,0,-4,-4,6.242718,0,0
ECE2,Ece2,9,0,9,0,0,0
ECEL1,Ecel1,2,-5,-3,0,0,0
ECH1,Ech1,14,-1,13,1.84466,0,0
ECHDC1,Echdc1,9,-6,3,3.349515,0,0
ECHDC2,Echdc2,-1,7,6,3.135922,0,0
ECHDC3,Echdc3,-7,-2,-9,0,0,0
ECHS1,Echs1,10,-3,7,4.106796,0,0
ECI1,Eci1,6,-1,5,12.61165,0,0
ECI2,Eci2,5,0,5,1.621359,0,0
ECM1,Ecm1,8,2,10,0,0,0
ECM2,Ecm2,5,-6,-1,1.728155,0,0
ECPAS,Ecpas,7,-1,6,3.330097,0,0
ECRG4,Ecrg4,7,3,10,0,0,0
ECSCR,Ecscr,5,4,9,0,0,0
ECSIT,Ecsit,10,-5,5,14.281553,0,0
ECT2,Ect2,5,-4,1,2.747573,0,0
ECT2L,Ect2l,6,-1,5,1.834951,0,0
EDA,Eda,-5,0,-5,0,0,0
EDA2R,Eda2r,-2,9,7,0,0,0
EDAR,Edar,-3,-2,-5,0,0,0
EDARADD,Edaradd,6,-2,4,0,0,0
EDC3,Edc3,5,-4,1,1.281553,0,0
EDC4,Edc4,9,-1,8,20.84466,0,0
EDDM3B,Eddm3b,0,2,2,0,0,0
EDEM1,Edem1,6,-1,5,2.650485,0,0
EDEM2,Edem2,1,-7,-6,9.68932,0,0
EDEM3,Edem3,6,-5,1,0,0,0
EDF1,Edf1,7,-1,6,2.747573,0,0
EDIL3,Edil3,-5,-6,-11,1.019417,0,0
EDN1,Edn1,23,45,68,0,0,0
EDN2,Edn2,25,11,36,6.213592,0,0
EDN3,Edn3,-2,2,0,0,0,0
EDNRA,Ednra,2,1,3,0,0,0
EDNRB,Ednrb,10,5,15,0,0,0
EDRF1,Edrf1,9,-3,6,0,0,0
EEA1,Eea1,3,-5,-2,5.533981,0,0
EED,Eed,12,2,14,5.009709,0,0
EEF1A1,Eef1a1,10,-5,5,22.223301,236.625,0
EEF1A2,Eef1a2,13,3,16,0,0,0
EEF1AKMT1,Eef1akmt1,6,1,7,0,0,0
EEF1AKMT2,Eef1akmt2,4,-5,-1,4.84466,0,0
EEF1AKMT3,Eef1akmt3,2,1,3,0.84466,0,0
EEF1AKMT4,Eef1akmt4,-3,-5,-8,13.893204,0,0
EEF1B2,Eef1b2,3,-3,0,7.631068,0,0
EEF1D,Eef1d,8,-1,7,3.009709,0,0
EEF1E1,Eef1e1,4,-7,-3,3.106796,0,0
EEF1G,Eef1g,10,-3,7,121.669903,15.208333,0
EEF2,Eef2,11,-3,8,6.84466,0,0
EEF2K,Eef2k,-1,-8,-9,13.427184,0,0
EEF2KMT,Eef2kmt,-10,-6,-16,13.417476,0,0
EEFSEC,Eefsec,-3,-6,-9,12.553398,0,0
EEPD1,Eepd1,7,-3,4,14.038835,0,0
EFCAB10,Efcab10,13,-4,9,1.815534,0,0
EFCAB11,Efcab11,3,-10,-7,18.359223,0,0
EFCAB12,Efcab12,66,-7,59,47.932039,0,0
EFCAB14,Efcab14,4,-5,-1,10.058252,0,0
EFCAB2,Efcab2,2,0,2,7.116505,0,0
EFCAB3,Efcab3,-5,-6,-11,7.300971,0,0
EFCAB5,Efcab5,-13,-4,-17,4.708738,0,0
EFCAB6,Efcab6,8,-9,-1,38.728155,0,0
EFCAB7,Efcab7,27,-13,14,91.563107,0,0
EFCAB8,Efcab8,-6,-26,-32,0,0,0
EFCAB9,Efcab9,9,-8,1,0,0,0
EFCC1,Efcc1,0,3,3,1.980583,0,0
EFEMP1,Efemp1,33,6,39,14.679612,0,0
EFEMP2,Efemp2,10,-5,5,1.504854,0,0
EFHB,Efhb,-5,-11,-16,10.747573,0,0
EFHC1,Efhc1,7,-6,1,97.07767,0,0
EFHC2,Efhc2,-3,-1,-4,0,0,0
EFHD1,Efhd1,12,0,12,1.524272,0,0
EFHD2,Efhd2,6,0,6,4.932039,0,0
EFL1,Efl1,2,-2,0,33.271845,0,0
EFNA1,Efna1,-3,-2,-5,8.456311,0,0
EFNA2,Efna2,48,5,53,1.834951,0,0
EFNA3,Efna3,-8,-10,-18,0,0,0
EFNA4,Efna4,-20,-23,-43,0,0,0
EFNA5,Efna5,7,7,14,24.640777,0,0
EFNB1,Efnb1,16,3,19,0,0,0
EFNB2,Efnb2,20,3,23,0,0,0
EFNB3,Efnb3,19,2,21,10.563107,0,0
EFR3A,Efr3a,-1,7,6,10.203883,3.791667,0
EFR3B,Efr3b,7,3,10,2.271845,0,0
EFS,Efs,3,0,3,0,0,0
EFTUD2,Eftud2,7,-3,4,26.864078,0,0
EGF,Egf,3,-9,-6,0,0,0
EGFL6,Egfl6,1,3,4,0,0,0
EGFL7,Egfl7,-5,-6,-11,0,0,0
EGFL8,Egfl8,-1,-11,-12,0,0,0
EGFLAM,Egflam,-3,1,-2,12.563107,0,114
EGFR,Egfr,-11,4,-7,1.582524,0,0
EGLN1,Egln1,12,2,14,14.194175,0,0
EGLN2,Egln2,9,-3,6,3.68932,0,0
EGLN3,Egln3,12,3,15,5.718447,0,0
EGR1,Egr1,87,44,131,3.407767,0,0
EGR2,Egr2,104,28,132,15.990291,0,0
EGR3,Egr3,69,-1,68,17.368932,0,0
EGR4,Egr4,21,7,28,1.300971,0,0
EHBP1,Ehbp1,8,-2,6,3.291262,0,0
EHBP1L1,Ehbp1l1,5,-3,2,4.165049,0,0
EHD1,Ehd1,10,-2,8,65.815534,0,0
EHD2,Ehd2,7,-1,6,0,0,0
EHD3,Ehd3,3,3,6,1.213592,0,0
EHD4,Ehd4,-5,0,-5,2.786408,0,0
EHF,Ehf,5,9,14,31.951456,0,0
EHHADH,Ehhadh,8,-4,4,3.213592,0,0
EHMT1,Ehmt1,7,-4,3,1.087379,0,0
EHMT2,Ehmt2,11,-10,1,7.097087,0,0
EI24,Ei24,8,-8,0,0,0,0
EID1,Eid1,7,4,11,1.126214,0,0
EID2,Eid2,-5,-4,-9,3.592233,0,0
EID2B,Eid2b,-3,-2,-5,1.883495,0,0
EID3,Eid3,54,-1,53,0,0,0
EIF1,Eif1,11,-2,9,6.805825,0,0
EIF1AD,Eif1ad,13,-1,12,237.961165,85.625,0
EIF1AX,Eif1ax,7,-3,4,2.048544,0,0
EIF1B,Eif1b,6,-9,-3,9.417476,0,0
EIF2A,Eif2a,10,-7,3,18.504854,0,0
EIF2AK1,Eif2ak1,6,-4,2,4.990291,0,0
EIF2AK2,Eif2ak2,6,-5,1,20.932039,0,0
EIF2AK3,Eif2ak3,4,2,6,4.07767,0,0
EIF2AK4,Eif2ak4,10,-2,8,8.883495,0,0
EIF2B1,Eif2b1,5,-5,0,3.679612,0,0
EIF2B2,Eif2b2,6,-1,5,13.825243,0,0
EIF2B3,Eif2b3,5,-10,-5,21.582524,0,0
EIF2B4,Eif2b4,6,-4,2,24.048544,0,0
EIF2B5,Eif2b5,14,-5,9,94.203883,5.458333,0
EIF2D,Eif2d,1,-4,-3,67.31068,5.916667,0
EIF2S1,Eif2s1,4,-4,0,7.796117,0,0
EIF2S2,Eif2s2,7,0,7,34.029126,0,0
EIF3A,Eif3a,10,-3,7,2.990291,0,0
EIF3B,Eif3b,8,-1,7,3.495146,0,0
EIF3C,Eif3c,6,-1,5,43.990291,13.166667,0
EIF3D,Eif3d,1,-4,-3,3.417476,0,0
EIF3E,Eif3e,4,-3,1,9.485437,0,0
EIF3F,Eif3f,10,0,10,15.660194,0,0
EIF3G,Eif3g,1,-3,-2,14.398058,0,0
EIF3H,Eif3h,9,-4,5,7.553398,0,0
EIF3I,Eif3i,6,-2,4,14.621359,0,0
EIF3K,Eif3k,6,-4,2,0.708738,0,0
EIF3L,Eif3l,8,-1,7,21.446602,0,0
EIF3M,Eif3m,7,-3,4,3.145631,0,0
EIF4A1,Eif4a1,8,-4,4,7.747573,0,0
EIF4A2,Eif4a2,10,-4,6,89.708738,5.5,0
EIF4A3,Eif4a3,10,-4,6,3.213592,0,0
EIF4B,Eif4b,8,-2,6,5.951456,0,0
EIF4E,Eif4e,3,-1,2,1.912621,0,0
EIF4E1B,Eif4e1b,2,-2,0,0,0,0
EIF4E2,Eif4e2,5,0,5,17.737864,0,0
EIF4E3,Eif4e3,-2,-1,-3,0,0,0
EIF4EBP1,Eif4ebp1,0,-2,-2,0,0,0
EIF4EBP2,Eif4ebp2,8,-6,2,13.242718,0,0
EIF4EBP3,Eif4ebp3,18,4,22,3.533981,0,0
EIF4ENIF1,Eif4enif1,3,-5,-2,7.145631,0,0
EIF4G1,Eif4g1,7,-2,5,8.815534,0,0
EIF4G2,Eif4g2,11,-6,5,21,0,0
EIF4G3,Eif4g3,7,-5,2,12.213592,0,0
EIF4H,Eif4h,4,-2,2,10.728155,0,0
EIF5,Eif5,12,1,13,180.980583,106.208333,0
EIF5A,Eif5a,11,-3,8,2.980583,0,0
EIF5A2,Eif5a2,1,-11,-10,4.038835,0,0
EIF5B,Eif5b,9,-3,6,25.572816,0,0
EIF6,Eif6,8,0,8,0,0,0
EIPR1,Eipr1,4,0,4,6.116505,0,0
ELAC1,Elac1,0,-10,-10,7.262136,0,0
ELAC2,Elac2,3,-2,1,2.582524,0,0
ELANE,Elane,8,6,14,2.291262,0,0
ELAPOR1,Elapor1,1,-10,-9,7.135922,0,0
ELAPOR2,Elapor2,1,1,2,4.330097,0,0
ELAVL1,Elavl1,7,-1,6,9.058252,0,0
ELAVL2,Elavl2,8,3,11,3.786408,0,0
ELAVL3,Elavl3,31,9,40,21.873786,0,0
ELAVL4,Elavl4,7,-8,-1,0,0,0
ELF1,Elf1,8,0,8,12.640777,0,0
ELF2,Elf2,4,-4,0,10.941748,0,0
ELF3,Elf3,-1,16,15,1.359223,0,0
ELF4,Elf4,1,-1,0,4.466019,0,0
ELF5,Elf5,0,-4,-4,0,0,0
ELFN1,Elfn1,7,-8,-1,0,0,0
ELFN2,Elfn2,3,-5,-2,1.893204,0,0
ELK1,Elk1,4,-1,3,1.864078,0,0
ELK3,Elk3,12,-4,8,18.407767,0,0
ELK4,Elk4,8,-6,2,6.951456,0,0
ELL,Ell,-4,-10,-14,3.990291,0,0
ELL2,Ell2,3,-4,-1,3.786408,0,0
ELL3,Ell3,0,-4,-4,0.601942,0,0
ELMO1,Elmo1,-1,0,-1,1.15534,0,0
ELMO2,Elmo2,2,-6,-4,2.135922,0,0
ELMO3,Elmo3,-1,-3,-4,0,0,0
ELMOD1,Elmod1,7,-4,3,11.320388,0,0
ELMOD2,Elmod2,5,-2,3,48.048544,0,0
ELMOD3,Elmod3,8,0,8,0,0,0
ELN,Eln,2,2,4,22.757282,0,0
ELOA,Eloa,10,-3,7,4.174757,0,0
ELOB,Elob,5,-2,3,9.203883,0,0
ELOC,Eloc,6,-2,4,9.145631,5.166667,0
ELOF1,Elof1,5,-2,3,1.31068,0,0
ELOVL1,Elovl1,8,0,8,5.815534,0,0
ELOVL2,Elovl2,3,3,6,3.048544,0,0
ELOVL3,Elovl3,12,4,16,0,0,0
ELOVL4,Elovl4,1,-3,-2,4.582524,0,0
ELOVL5,Elovl5,14,9,23,88.31068,21.541667,0
ELOVL6,Elovl6,3,-5,-2,2.048544,0,0
ELOVL7,Elovl7,3,4,7,0,0,0
ELP1,Elp1,6,-2,4,50.194175,0,0
ELP2,Elp2,7,1,8,0,0,0
ELP3,Elp3,-6,-2,-8,1.281553,0,0
ELP4,Elp4,1,-1,0,0,0,0
ELP5,Elp5,3,-3,0,1.592233,0,0
ELP6,Elp6,5,-8,-3,13.368932,0,0
EMB,Emb,-1,9,8,0,0,0
EMC1,Emc1,6,-3,3,11.466019,0,0
EMC10,Emc10,9,-2,7,4.359223,0,0
EMC2,Emc2,-9,-5,-14,4.864078,0,0
EMC3,Emc3,8,-2,6,22.058252,0,0
EMC4,Emc4,4,-2,2,1.378641,0,0
EMC6,Emc6,-5,-2,-7,3.378641,0,0
EMC7,Emc7,4,-1,3,9.300971,0,0
EMC8,Emc8,-1,-3,-4,12.941748,0,0
EMC9,Emc9,5,-9,-4,3.165049,0,0
EMCN,Emcn,-2,3,1,0,0,0
EMD,Emd,6,-3,3,0.805825,0,0
EME1,Eme1,-4,-5,-9,2.572816,0,0
EME2,Eme2,3,-3,0,6.165049,0,0
EMG1,Emg1,3,-2,1,0,0,0
EMID1,Emid1,-2,-9,-11,1.601942,0,0
EMILIN1,Emilin1,-9,-13,-22,0,0,0
EMILIN2,Emilin2,0,0,0,107.135922,85.916667,425
EMILIN3,Emilin3,-6,-5,-11,0,0,0
EML1,Eml1,-23,-1,-24,20.825243,0,0
EML2,Eml2,7,6,13,15.398058,0,0
EML3,Eml3,7,-2,5,17.145631,0,0
EML4,Eml4,2,-2,0,5.592233,0,0
EML5,Eml5,-1,1,0,10.07767,0,0
EML6,Eml6,8,-6,2,15.592233,0,0
EMP1,Emp1,1,1,2,3.339806,0,0
EMP2,Emp2,5,-9,-4,29.262136,0,0
EMP3,Emp3,11,1,12,3.679612,0,0
EMSY,Emsy,8,2,10,2.990291,0,0
EMX1,Emx1,29,-4,25,12.07767,0,0
EMX2,Emx2,11,-11,0,0,0,0
EN1,En1,-1,4,3,1.106796,0,0
EN2,En2,18,-1,17,4.854369,0,0
ENAH,Enah,9,0,9,12.504854,0,0
ENAM,Enam,1,0,1,0,0,0
ENC1,Enc1,13,3,16,0,0,0
ENDOD1,Endod1,1,1,2,7.145631,0,0
ENDOG,Endog,11,-1,10,7.330097,0,0
ENDOU,Endou,12,-1,11,0,0,0
ENDOV,Endov,6,-6,0,38.76699,0,0
ENG,Eng,1,5,6,17.679612,0,0
ENGASE,Engase,83,-9,74,197,0,0
ENHO,Enho,10,-5,5,1.631068,0,0
ENKD1,Enkd1,1,-8,-7,0,0,0
ENKUR,Enkur,5,-20,-15,0,0,0
ENO1,Eno1,9,0,9,9.514563,0,0
ENO2,Eno2,9,-1,8,2.194175,0,0
ENO3,Eno3,15,-2,13,2.592233,0,0
ENO4,Eno4,-11,-11,-22,5.747573,0,0
ENOPH1,Enoph1,6,-3,3,4.38835,0,0
ENOX1,Enox1,5,-4,1,0,0,0
ENOX2,Enox2,-2,-2,-4,3.436893,0,0
ENPEP,Enpep,2,7,9,12.106796,0,0
ENPP1,Enpp1,1,0,1,1.349515,0,0
ENPP2,Enpp2,11,6,17,0,0,0
ENPP3,Enpp3,13,1,14,0,0,0
ENPP4,Enpp4,3,-4,-1,0,0,0
ENPP5,Enpp5,-3,2,-1,1.834951,0,0
ENPP6,Enpp6,1,4,5,0,0,0
ENPP7,Enpp7,-2,0,-2,0,0,0
ENSA,Ensa,3,-2,1,1.339806,0,0
ENTHD1,Enthd1,-1,-4,-5,0,0,0
ENTPD1,Entpd1,1,6,7,0,0,0
ENTPD2,Entpd2,-2,5,3,0,0,0
ENTPD3,Entpd3,11,-1,10,0,0,0
ENTPD4,Entpd4,5,-4,1,14.747573,0,0
ENTPD5,Entpd5,5,-5,0,73.165049,0,0
ENTPD6,Entpd6,4,-7,-3,4.087379,0,0
ENTPD7,Entpd7,3,-3,0,6.524272,0,0
ENTPD8,Entpd8,-1,0,-1,7.116505,0,0
ENTR1,Entr1,10,-8,2,1.349515,0,0
ENY2,Eny2,6,-4,2,0,0,0
EOGT,Eogt,2,-8,-6,0,0,0
EOLA1,Eola1,-1,-1,-2,2.31068,0,0
EOMES,Eomes,23,-2,21,3.252427,0,0
EP300,Ep300,7,1,8,2.300971,0,0
EP400,Ep400,11,-4,7,7.669903,0,0
EPAS1,Epas1,3,4,7,0.92233,0,0
EPB41,Epb41,3,-3,0,6.495146,0,0
EPB41L1,Epb41l1,4,2,6,0.796117,0,0
EPB41L2,Epb41l2,5,-4,1,10.679612,0,0
EPB41L3,Epb41l3,8,-2,6,0,0,0
EPB41L4A,Epb41l4a,0,-9,-9,0,0,0
EPB41L4B,Epb41l4b,10,0,10,4.203883,0,0
EPB41L5,Epb41l5,5,0,5,4.805825,0,0
EPB42,Epb42,17,2,19,2.262136,0,0
EPC1,Epc1,4,2,6,3.631068,0,0
EPC2,Epc2,2,-5,-3,5.61165,0,0
EPCAM,Epcam,1,4,5,79.339806,0,0
EPDR1,Epdr1,10,4,14,7.747573,0,0
EPG5,Epg5,6,-2,4,0.728155,0,0
EPGN,Epgn,31,-5,26,0,0,0
EPHA1,Epha1,0,-1,-1,1.165049,0,0
EPHA10,Epha10,2,-10,-8,0,0,0
EPHA2,Epha2,5,6,11,1.669903,0,0
EPHA3,Epha3,0,2,2,3.873786,0,0
EPHA4,Epha4,16,7,23,0.76699,0,0
EPHA5,Epha5,4,-7,-3,3.087379,0,0
EPHA6,Epha6,9,-7,2,3.058252,0,0
EPHA7,Epha7,2,-4,-2,2.165049,0,0
EPHA8,Epha8,1,0,1,0,0,0
EPHB1,Ephb1,7,0,7,0,0,0
EPHB2,Ephb2,6,-8,-2,0,0,0
EPHB3,Ephb3,11,-7,4,1.067961,0,0
EPHB4,Ephb4,3,-6,-3,4.07767,0,0
EPHB6,Ephb6,10,1,11,38.582524,0,0
EPHX1,Ephx1,16,-11,5,18.990291,0,0
EPHX2,Ephx2,7,1,8,6.553398,0,0
EPHX3,Ephx3,-3,11,8,0,0,0
EPHX4,Ephx4,-4,1,-3,2.019417,0,0
EPM2A,Epm2a,1,-12,-11,10.446602,0,0
EPM2AIP1,Epm2aip1,16,0,16,72.436893,0,0
EPN1,Epn1,9,4,13,22.368932,0,0
EPN2,Epn2,7,1,8,3.378641,0,0
EPN3,Epn3,0,-4,-4,0,0,0
EPO,Epo,-1,1,0,0,0,0
EPOP,Epop,-10,1,-9,54.893204,0,0
EPOR,Epor,1,-8,-7,0,0,0
EPPIN,Eppin,-2,7,5,0,0,0
EPS15,Eps15,5,-5,0,12.019417,0,0
EPS15L1,Eps15l1,2,-4,-2,18.330097,0,0
EPS8,Eps8,4,4,8,29.126214,0,0
EPS8L1,Eps8l1,-5,6,1,0,0,0
EPS8L2,Eps8l2,1,-4,-3,1.893204,0,0
EPS8L3,Eps8l3,0,-12,-12,0,0,0
EPSTI1,Epsti1,-12,-10,-22,0,0,0
EPX,Epx,-1,-2,-3,0,0,0
EPYC,Epyc,-3,-9,-12,0,0,0
EQTN,Eqtn,-7,-7,-14,0,0,0
ERAL1,Eral1,0,-8,-8,0,0,0
ERAP1,Erap1,5,-10,-5,9.300971,0,0
ERAS,Eras,10,4,14,2.932039,0,0
ERBB2,Erbb2,3,-6,-3,6.339806,0,0
ERBB3,Erbb3,14,1,15,4.718447,0,0
ERBB4,Erbb4,9,-2,7,0,0,0
ERBIN,Erbin,7,0,7,0,0,0
ERC1,Erc1,3,-6,-3,0,0,0
ERC2,Erc2,3,-2,1,0,0,0
ERCC1,Ercc1,-1,1,0,48.300971,0,0
ERCC2,Ercc2,8,-2,6,0,0,0
ERCC3,Ercc3,8,-4,4,3.553398,0,0
ERCC4,Ercc4,3,-4,-1,6.378641,0,0
ERCC5,Ercc5,1,-5,-4,31.650485,0,0
ERCC6,Ercc6,3,-4,-1,12.07767,0,0
ERCC6L,Ercc6l,-7,-3,-10,0,0,0
ERCC6L2,Ercc6l2,0,-5,-5,15.097087,0,0
ERCC8,Ercc8,3,-2,1,0,0,0
EREG,Ereg,-1,-2,-3,1.631068,0,0
ERF,Erf,0,-5,-5,32.932039,0,0
ERFE,Erfe,-2,2,0,5.271845,0,0
ERFL,Erfl,8,-7,1,0,0,0
ERG,Erg,1,2,3,0,0,0
ERG28,Erg28,4,-9,-5,25.378641,0,0
ERGIC1,Ergic1,8,1,9,8.281553,0,0
ERGIC2,Ergic2,3,-5,-2,2.980583,0,0
ERGIC3,Ergic3,8,-2,6,13.262136,0,0
ERH,Erh,5,-8,-3,2,0,0
ERI1,Eri1,1,0,1,9.883495,0,0
ERI2,Eri2,4,-9,-5,4.126214,0,0
ERI3,Eri3,6,-4,2,32.378641,0,0
ERICH1,Erich1,-1,-1,-2,0,0,0
ERICH2,Erich2,12,-9,3,5.728155,0,0
ERICH3,Erich3,11,-5,6,0,0,0
ERICH4,Erich4,18,6,24,0,0,0
ERICH5,Erich5,52,-6,46,0,0,0
ERICH6,Erich6,-4,-3,-7,43.990291,0,0
ERICH6B,Erich6b,1,-7,-6,0,0,0
ERLEC1,Erlec1,5,-5,0,9.07767,0,0
ERLIN1,Erlin1,6,-5,1,10.184466,0,0
ERLIN2,Erlin2,4,-6,-2,6.165049,0,0
ERMAP,Ermap,5,2,7,6.242718,0,0
ERMARD,Ermard,-4,-7,-11,69.796117,0,0
ERMN,Ermn,12,2,14,0,0,0
ERMP1,Ermp1,5,-3,2,3.436893,0,0
ERN1,Ern1,3,4,7,27.349515,0,0
ERN2,Ern2,5,-9,-4,0,0,0
ERO1A,Ero1a,3,-6,-3,4.475728,0,0
ERO1B,Ero1b,20,-2,18,1.320388,0,0
ERP27,Erp27,-2,0,-2,1.533981,0,0
ERP29,Erp29,10,-2,8,3.679612,0,0
ERP44,Erp44,4,-1,3,8.504854,0,0
ERRFI1,Errfi1,25,-4,21,8.145631,0,0
ESAM,Esam,28,3,31,0,0,0
ESCO1,Esco1,2,0,2,13.23301,0,0
ESCO2,Esco2,1,-9,-8,7.805825,0,0
ESD,Esd,5,2,7,1.466019,0,0
ESF1,Esf1,1,-9,-8,12.126214,0,0
ESM1,Esm1,0,-2,-2,0,0,0
ESPL1,Espl1,-15,-20,-35,1.485437,0,0
ESPN,Espn,4,12,16,0,0,0
ESPNL,Espnl,18,2,20,0,0,0
ESR1,Esr1,67,3,70,0,0,0
ESR2,Esr2,3,-12,-9,2.747573,0,0
ESRP1,Esrp1,7,2,9,2.116505,0,0
ESRP2,Esrp2,7,-4,3,4.009709,0,0
ESRRA,Esrra,5,-3,2,1.475728,0,115
ESRRB,Esrrb,6,-3,3,0,0,0
ESRRG,Esrrg,-2,-1,-3,13.747573,0,0
ESS2,Ess2,1,-4,-3,0,0,0
ESX1,Esx1,9,-6,3,4.68932,0,0
ESYT1,Esyt1,3,-2,1,1.902913,0,0
ESYT2,Esyt2,3,-1,2,7.980583,0,0
ESYT3,Esyt3,1,-3,-2,0,0,0
ETAA1,Etaa1,-15,-3,-18,1.728155,0,0
ETF1,Etf1,1,-4,-3,2.679612,0,0
ETFA,Etfa,2,-10,-8,1.116505,0,0
ETFB,Etfb,7,-4,3,6.349515,0,0
ETFBKMT,Etfbkmt,3,-12,-9,5.495146,0,0
ETFDH,Etfdh,9,-3,6,8.514563,0,0
ETFRF1,Etfrf1,0,-1,-1,69.485437,0,0
ETHE1,Ethe1,3,-7,-4,2.601942,0,0
ETNK1,Etnk1,9,-3,6,13.23301,0,0
ETNK2,Etnk2,2,5,7,1.339806,0,0
ETNPPL,Etnppl,2,2,4,0,0,0
ETS1,Ets1,0,-3,-3,9.145631,0,0
ETS2,Ets2,4,7,11,0,0,0
ETV1,Etv1,3,-4,-1,0,0,0
ETV2,Etv2,9,11,20,1.631068,0,0
ETV3,Etv3,9,-7,2,5.883495,0,0
ETV3L,Etv3l,4,5,9,0,0,0
ETV4,Etv4,10,-1,9,21.990291,0,0
ETV5,Etv5,3,-3,0,6.349515,0,0
ETV6,Etv6,-3,-1,-4,4.446602,0,0
EVA1A,Eva1a,15,-12,3,3.23301,0,0
EVA1B,Eva1b,2,4,6,2.660194,0,0
EVA1C,Eva1c,-9,-1,-10,7.029126,0,0
EVC,Evc,0,-1,-1,1.213592,0,0
EVC2,Evc2,0,-2,-2,1.213592,0,0
EVI2A,Evi2a,-12,-19,-31,0,0,0
EVI2B,Evi2b,-13,8,-5,0,0,0
EVI5,Evi5,6,-1,5,6.582524,0,0
EVI5L,Evi5l,9,-4,5,2.398058,0,0
EVL,Evl,9,-5,4,3.145631,0,0
EVPL,Evpl,20,12,32,12.116505,0,0
EVX1,Evx1,2,3,5,0,0,0
EVX2,Evx2,1,-4,-3,0,0,0
EWSR1,Ewsr1,5,-4,1,155.621359,37.791667,0
EXD1,Exd1,3,-2,1,4.970874,0,0
EXD2,Exd2,6,-2,4,15.398058,0,0
EXO1,Exo1,2,-5,-3,7.398058,0,0
EXO5,Exo5,3,-17,-14,0,0,0
EXOC1,Exoc1,2,0,2,1.466019,0,0
EXOC2,Exoc2,-2,-1,-3,14.980583,0,0
EXOC3,Exoc3,12,-7,5,3.398058,0,0
EXOC3L2,Exoc3l2,4,-4,0,0,0,0
EXOC3L4,Exoc3l4,-12,-6,-18,0,0,0
EXOC4,Exoc4,4,2,6,1.009709,0,0
EXOC5,Exoc5,9,-2,7,24.126214,4.208333,0
EXOC6,Exoc6,-12,-1,-13,3.194175,0,0
EXOC6B,Exoc6b,9,-8,1,4.533981,0,0
EXOC7,Exoc7,10,-3,7,4.427184,0,0
EXOC8,Exoc8,2,-5,-3,4.456311,0,0
EXOG,Exog,11,-4,7,5.834951,0,0
EXOSC1,Exosc1,6,-3,3,2.398058,0,0
EXOSC10,Exosc10,6,-2,4,2.76699,0,0
EXOSC2,Exosc2,1,-4,-3,0,0,0
EXOSC3,Exosc3,5,-5,0,1.378641,0,0
EXOSC4,Exosc4,-1,-2,-3,8.514563,0,0
EXOSC5,Exosc5,-1,-8,-9,1.796117,0,0
EXOSC6,Exosc6,5,-5,0,5.912621,0,0
EXOSC7,Exosc7,1,-9,-8,9.776699,0,0
EXOSC8,Exosc8,-2,-6,-8,8.009709,0,0
EXOSC9,Exosc9,-2,-11,-13,3.339806,0,0
EXPH5,Exph5,5,-4,1,3.563107,0,0
EXT1,Ext1,7,-2,5,14.203883,0,0
EXT2,Ext2,5,-9,-4,4.417476,0,0
EXTL1,Extl1,0,-1,-1,0,0,0
EXTL2,Extl2,0,-5,-5,7.038835,0,0
EXTL3,Extl3,-2,-2,-4,0,0,0
EYA1,Eya1,-2,-2,-4,7.048544,0,0
EYA2,Eya2,2,5,7,0,0,0
EYA3,Eya3,8,1,9,13.708738,0,0
EYA4,Eya4,9,-7,2,0,0,0
EZH1,Ezh1,9,-5,4,2.563107,0,0
EZH2,Ezh2,6,-7,-1,8.796117,0,0
EZHIP,Ezhip,4,10,14,0,0,0
EZR,Ezr,10,-2,8,2.708738,0,0
F10,F10,3,-15,-12,0,0,0
F11,F11,14,-1,13,0,0,0
F11R,F11r,0,1,1,3.834951,0,0
F12,F12,-1,-1,-2,1.281553,0,0
F13A1,F13a1,-4,-1,-5,0,0,0
F13B,F13b,21,0,21,0,0,0
F2,F2,22,7,29,0,0,0
F2R,F2r,3,0,3,4.194175,0,0
F2RL1,F2rl1,2,3,5,3.533981,0,0
F2RL2,F2rl2,-2,10,8,0,0,0
F2RL3,F2rl3,3,4,7,1.213592,0,0
F3,F3,-7,9,2,6.932039,0,0
F5,F5,-1,-3,-4,0,0,0
F7,F7,3,-2,1,0,0,0
F8,F8,2,-1,1,13.184466,0,0
F9,F9,-2,-2,-4,0,0,0
FA2H,Fa2h,1,-8,-7,3.660194,0,0
FAAH,Faah,17,-4,13,0,0,0
FAAP100,Faap100,3,-2,1,0,0,0
FAAP20,Faap20,-1,-4,-5,7.398058,0,0
FAAP24,Faap24,-2,0,-2,2.961165,0,0
FABP1,Fabp1,1,-5,-4,0,0,0
FABP12,Fabp12,3,-4,-1,0,0,0
FABP2,Fabp2,6,6,12,0,0,0
FABP3,Fabp3,28,2,30,0,0,0
FABP4,Fabp4,12,4,16,0,0,0
FABP5,Fabp5,4,2,6,15.737864,0,0
FABP6,Fabp6,3,1,4,1.592233,0,0
FABP7,Fabp7,8,-5,3,0,0,0
FABP9,Fabp9,8,8,16,0,0,0
FADD,Fadd,-15,-3,-18,2.058252,0,0
FADS1,Fads1,5,0,5,7.398058,0,0
FADS2,Fads2,5,-2,3,7.854369,0,0
FADS3,Fads3,5,1,6,3.359223,0,0
FADS6,Fads6,1,-1,0,0,0,0
FAF1,Faf1,5,-2,3,14.650485,0,0
FAF2,Faf2,9,0,9,11.058252,0,0
FAH,Fah,-8,-1,-9,0,0,0
FAHD1,Fahd1,5,-3,2,4.796117,0,0
FAHD2A,Fahd2a,6,-1,5,2.524272,0,0
FAIM,Faim,4,-10,-6,9.15534,0,0
FAIM2,Faim2,7,3,10,0,0,0
FAM104A,Fam104a,3,0,3,3.92233,0,0
FAM107A,Fam107a,-1,-4,-5,64.699029,0,0
FAM107B,Fam107b,6,4,10,75.864078,0,0
FAM110A,Fam110a,-8,-5,-13,33.184466,0,0
FAM110B,Fam110b,7,-5,2,1.631068,0,0
FAM110C,Fam110c,-3,2,-1,0,0,0
FAM111A,Fam111a,-2,-8,-10,4.466019,0,0
FAM114A1,Fam114a1,1,-6,-5,4.271845,0,0
FAM114A2,Fam114a2,7,-5,2,4.436893,0,0
FAM117A,Fam117a,8,-3,5,3.203883,0,0
FAM117B,Fam117b,7,1,8,7.718447,0,0
FAM118A,Fam118a,4,-12,-8,12.902913,0,0
FAM118B,Fam118b,-5,-8,-13,7.650485,0,0
FAM120A,Fam120a,9,1,10,1.291262,0,0
FAM120B,Fam120b,-6,-4,-10,87.776699,0,0
FAM120C,Fam120c,8,2,10,3.252427,0,0
FAM124A,Fam124a,7,0,7,1.184466,0,0
FAM124B,Fam124b,5,-3,2,0,0,0
FAM131A,Fam131a,8,-1,7,5.92233,0,0
FAM131B,Fam131b,10,-3,7,14.300971,0,0
FAM131C,Fam131c,5,-3,2,0.912621,0,0
FAM133B,Fam133b,1,-8,-7,13.436893,0,0
FAM135A,Fam135a,6,-7,-1,3.213592,0,0
FAM135B,Fam135b,-4,-6,-10,3.601942,0,0
FAM136A,Fam136a,3,-4,-1,6.524272,0,0
FAM13A,Fam13a,13,6,19,29.679612,0,0
FAM13B,Fam13b,6,2,8,4.165049,0,0
FAM13C,Fam13c,3,-7,-4,3.660194,0,0
FAM149A,Fam149a,17,-4,13,99.825243,0,0
FAM151A,Fam151a,-6,-1,-7,0,0,0
FAM151B,Fam151b,14,1,15,30.805825,0,0
FAM161A,Fam161a,13,1,14,55.514563,0,0
FAM161B,Fam161b,0,-2,-2,15.38835,0,0
FAM162A,Fam162a,7,-2,5,26.019417,3.916667,0
FAM162B,Fam162b,15,-1,14,0,0,0
FAM163A,Fam163a,4,9,13,0,0,0
FAM163B,Fam163b,-4,0,-4,0,0,0
FAM166A,Fam166a,17,-13,4,0,0,0
FAM166B,Fam166b,0,-9,-9,0,0,0
FAM166C,Fam166c,5,3,8,11.504854,0,0
FAM167A,Fam167a,0,3,3,0,0,0
FAM167B,Fam167b,34,7,41,0,0,0
FAM168A,Fam168a,10,0,10,8.728155,0,0
FAM168B,Fam168b,5,-2,3,4.446602,0,0
FAM169A,Fam169a,5,-6,-1,0.92233,0,0
FAM170A,Fam170a,2,-5,-3,2.048544,0,0
FAM170B,Fam170b,1,-4,-3,0,0,0
FAM171A1,Fam171a1,5,0,5,5.087379,0,0
FAM171A2,Fam171a2,5,-3,2,7.029126,0,0
FAM171B,Fam171b,7,-2,5,2.776699,0,0
FAM172A,Fam172a,4,-1,3,2.203883,0,0
FAM174A,Fam174a,1,-3,-2,4.300971,0,0
FAM174B,Fam174b,3,2,5,9.970874,0,0
FAM174C,Fam174c,2,-3,-1,3.815534,0,0
FAM178B,Fam178b,-3,-11,-14,1.097087,0,0
FAM180A,Fam180a,9,11,20,0,0,0
FAM181A,Fam181a,0,-3,-3,0,0,0
FAM181B,Fam181b,13,-3,10,0,0,0
FAM184A,Fam184a,13,-9,4,7.796117,0,0
FAM184B,Fam184b,4,-3,1,0,0,0
FAM185A,Fam185a,3,-2,1,3.087379,0,0
FAM186A,Fam186a,3,-11,-8,17.097087,0,0
FAM186B,Fam186b,8,-4,4,0,0,0
FAM187A,Fam187a,-3,-10,-13,26.864078,0,0
FAM187B,Fam187b,9,1,10,0,0,0
FAM193A,Fam193a,9,-4,5,6.368932,0,0
FAM193B,Fam193b,7,-1,6,3.466019,0,0
FAM199X,Fam199x,8,-1,7,10.582524,3.583333,0
FAM204A,Fam204a,3,-9,-6,30.466019,0,0
FAM205C,Fam205c,4,0,4,0,0,0
FAM207A,Fam207a,-3,-4,-7,27.174757,0,0
FAM20A,Fam20a,-2,-7,-9,0,0,0
FAM20B,Fam20b,2,-10,-8,1.184466,0,0
FAM20C,Fam20c,1,-1,0,0,0,0
FAM210A,Fam210a,12,-3,9,10.252427,0,0
FAM210B,Fam210b,1,0,1,4,0,0
FAM216A,Fam216a,4,-4,0,5.728155,0,0
FAM216B,Fam216b,-3,-6,-9,0,0,0
FAM217A,Fam217a,3,-2,1,0,0,0
FAM217B,Fam217b,4,-5,-1,7.23301,0,0
FAM219A,Fam219a,1,-6,-5,2.097087,0,0
FAM219B,Fam219b,7,-7,0,3.165049,0,0
FAM220A,Fam220a,2,-5,-3,5.718447,0,0
FAM221A,Fam221a,4,-8,-4,2.456311,0,0
FAM221B,Fam221b,14,-7,7,4.631068,0,0
FAM222A,Fam222a,32,-1,31,50.864078,0,0
FAM222B,Fam222b,8,-3,5,2.514563,0,0
FAM227A,Fam227a,6,-10,-4,3.058252,0,0
FAM227B,Fam227b,5,-11,-6,46.533981,0,0
FAM228A,Fam228a,0,-5,-5,0,0,0
FAM228B,Fam228b,-3,-13,-16,15.990291,0,0
FAM229A,Fam229a,5,4,9,0,0,0
FAM229B,Fam229b,8,-16,-8,22.61165,0,0
FAM234A,Fam234a,10,-6,4,10.359223,0,0
FAM234B,Fam234b,3,-7,-4,15.592233,0,0
FAM240A,Fam240a,2,7,9,0,0,0
FAM240B,Fam240b,3,-2,1,0,0,0
FAM241A,Fam241a,5,-4,1,6.864078,0,0
FAM241B,Fam241b,12,-9,3,12.980583,0,0
FAM24A,Fam24a,1,-18,-17,0,0,0
FAM24B,Fam24b,2,-33,-31,3.436893,0,0
FAM32A,Fam32a,8,1,9,0,0,0
FAM3A,Fam3a,7,-3,4,3.572816,0,0
FAM3B,Fam3b,-6,-7,-13,0,0,0
FAM3C,Fam3c,7,-7,0,14.825243,0,0
FAM43A,Fam43a,14,6,20,7.466019,0,0
FAM43B,Fam43b,4,2,6,0,0,0
FAM47C,Fam47c,-1,-8,-9,0,0,0
FAM47E,Fam47e,0,-8,-8,8.058252,0,0
FAM50A,Fam50a,-2,3,1,2.145631,0,0
FAM50B,Fam50b,2,-5,-3,0,0,0
FAM53A,Fam53a,27,-4,23,5.941748,0,0
FAM53B,Fam53b,9,-10,-1,2.378641,0,0
FAM53C,Fam53c,-1,-7,-8,5.932039,0,0
FAM72A,Fam72a,-6,-7,-13,2.135922,0,0
FAM76A,Fam76a,3,-6,-3,5.92233,0,0
FAM76B,Fam76b,0,-1,-1,5.786408,0,0
FAM78A,Fam78a,9,-11,-2,0,0,0
FAM78B,Fam78b,0,1,1,0,0,0
FAM81A,Fam81a,4,-10,-6,37.932039,0,0
FAM81B,Fam81b,-2,-7,-9,0,0,0
FAM83A,Fam83a,15,0,15,22.718447,0,0
FAM83B,Fam83b,2,9,11,0,0,0
FAM83C,Fam83c,51,1,52,6.466019,0,0
FAM83D,Fam83d,1,-2,-1,27.990291,0,0
FAM83E,Fam83e,27,-2,25,112.524272,9,0
FAM83F,Fam83f,1,3,4,2.466019,0,0
FAM83G,Fam83g,7,3,10,0,0,0
FAM83H,Fam83h,-3,-10,-13,6.951456,0,0
FAM89A,Fam89a,-11,-6,-17,3.757282,0,0
FAM89B,Fam89b,9,-10,-1,12.291262,0,0
FAM8A1,Fam8a1,5,-1,4,7.116505,0,0
FAM91A1,Fam91a1,7,-1,6,7.058252,0,0
FAM98A,Fam98a,10,-4,6,5.728155,0,0
FAM98B,Fam98b,3,-4,-1,19.640777,0,0
FAM98C,Fam98c,5,-6,-1,7.213592,0,0
FAN1,Fan1,5,-1,4,12.223301,0,0
FANCA,Fanca,-1,-5,-6,3.533981,0,0
FANCB,Fancb,3,-7,-4,2.213592,0,0
FANCC,Fancc,3,-4,-1,13.456311,0,0
FANCD2,Fancd2,2,-7,-5,11.106796,0,0
FANCD2OS,Fancd2os,2,-18,-16,0,0,0
FANCE,Fance,-11,0,-11,2.23301,0,0
FANCF,Fancf,-2,-9,-11,0.980583,0,0
FANCG,Fancg,9,-5,4,17.359223,0,0
FANCI,Fanci,3,-10,-7,21.126214,0,0
FANCL,Fancl,5,-7,-2,22.23301,0,0
FANCM,Fancm,7,-2,5,10.864078,0,0
FANK1,Fank1,12,2,14,51.038835,0,0
FAP,Fap,16,-1,15,1.38835,0,0
FAR1,Far1,4,-5,-1,5.349515,0,0
FAR2,Far2,-3,-9,-12,12.640777,0,0
FARP1,Farp1,-1,-1,-2,2.242718,0,0
FARP2,Farp2,6,-1,5,5.563107,0,0
FARS2,Fars2,7,-2,5,46.23301,0,0
FARSA,Farsa,0,-2,-2,14.737864,0,0
FARSB,Farsb,1,-5,-4,0,0,0
FAS,Fas,-2,4,2,0,0,0
FASN,Fasn,6,-3,3,34.466019,0,0
FASTK,Fastk,0,-7,-7,2.223301,0,0
FASTKD1,Fastkd1,6,-3,3,0,0,136
FASTKD2,Fastkd2,-20,-5,-25,5.990291,0,0
FASTKD3,Fastkd3,-5,-3,-8,9.543689,0,0
FASTKD5,Fastkd5,-2,-6,-8,7.242718,0,246
FAT1,Fat1,10,-4,6,0,0,0
FAT2,Fat2,6,1,7,0,0,0
FAT3,Fat3,6,-5,1,0,0,0
FAT4,Fat4,4,-8,-4,0,0,0
FATE1,Fate1,1,2,3,5.184466,0,0
FAU,Fau,9,0,9,29.097087,0,0
FAXC,Faxc,7,-7,0,10.252427,0,0
FBF1,Fbf1,5,-4,1,46.31068,0,0
FBH1,Fbh1,4,-9,-5,6.669903,0,0
FBL,Fbl,3,0,3,1.990291,0,0
FBLIM1,Fblim1,-3,0,-3,0.747573,0,0
FBLL1,Fbll1,116,1,117,0,0,0
FBLN1,Fbln1,4,5,9,0,0,0
FBLN2,Fbln2,-5,4,-1,0,0,0
FBLN5,Fbln5,11,-5,6,0,0,0
FBLN7,Fbln7,2,-1,1,0,0,0
FBN1,Fbn1,0,-3,-3,0,0,0
FBN2,Fbn2,18,-5,13,0,0,0
FBP1,Fbp1,-1,-3,-4,0,0,0
FBP2,Fbp2,2,8,10,0,0,0
FBRS,Fbrs,7,-6,1,17.116505,0,0
FBRSL1,Fbrsl1,8,7,15,0,0,0
FBXL12,Fbxl12,2,-4,-2,3.349515,0,0
FBXL13,Fbxl13,1,-6,-5,85.126214,0,0
FBXL14,Fbxl14,58,-1,57,205.883495,0,0
FBXL15,Fbxl15,1,-3,-2,3.019417,0,0
FBXL16,Fbxl16,5,-1,4,58.893204,0,0
FBXL17,Fbxl17,6,-1,5,6.271845,0,0
FBXL18,Fbxl18,4,-2,2,4.446602,0,0
FBXL19,Fbxl19,13,-7,6,2.07767,0,0
FBXL2,Fbxl2,3,-1,2,23.650485,0,0
FBXL20,Fbxl20,7,-8,-1,3.699029,0,0
FBXL22,Fbxl22,5,4,9,5.097087,0,0
FBXL3,Fbxl3,2,-2,0,2.621359,0,0
FBXL4,Fbxl4,2,-3,-1,6.621359,0,0
FBXL5,Fbxl5,-3,-4,-7,4.174757,4.333333,0
FBXL6,Fbxl6,-6,-1,-7,42.349515,11.208333,0
FBXL7,Fbxl7,7,0,7,0,0,0
FBXL8,Fbxl8,-1,-7,-8,4.106796,0,0
FBXO10,Fbxo10,12,-3,9,0,0,0
FBXO11,Fbxo11,9,2,11,7.524272,0,0
FBXO15,Fbxo15,37,-11,26,307.864078,266.708333,229
FBXO16,Fbxo16,-2,5,3,3.504854,0,0
FBXO17,Fbxo17,3,0,3,0,0,0
FBXO2,Fbxo2,8,-7,1,4.563107,0,0
FBXO21,Fbxo21,3,-1,2,3.873786,0,0
FBXO22,Fbxo22,5,-6,-1,7.271845,0,0
FBXO24,Fbxo24,12,-7,5,7.631068,0,0
FBXO25,Fbxo25,1,-4,-3,0,0,0
FBXO27,Fbxo27,10,0,10,0,0,0
FBXO28,Fbxo28,4,0,4,0,0,0
FBXO3,Fbxo3,2,-5,-3,6.165049,0,0
FBXO30,Fbxo30,7,-3,4,5.699029,0,0
FBXO31,Fbxo31,-1,-1,-2,72.660194,0,0
FBXO32,Fbxo32,14,0,14,19.262136,0,0
FBXO33,Fbxo33,8,1,9,2.398058,0,0
FBXO34,Fbxo34,-6,0,-6,10.912621,0,0
FBXO36,Fbxo36,1,-11,-10,12.058252,0,0
FBXO38,Fbxo38,4,-7,-3,4.834951,0,0
FBXO39,Fbxo39,2,-8,-6,0,0,0
FBXO4,Fbxo4,3,-4,-1,5.174757,0,0
FBXO40,Fbxo40,1,-1,0,0,0,0
FBXO41,Fbxo41,4,-3,1,0,0,0
FBXO42,Fbxo42,2,-2,0,8.271845,0,0
FBXO43,Fbxo43,-3,-7,-10,6.747573,0,0
FBXO44,Fbxo44,10,-3,7,4.563107,0,0
FBXO45,Fbxo45,3,-4,-1,15.951456,0,0
FBXO46,Fbxo46,7,-8,-1,19.970874,0,0
FBXO47,Fbxo47,8,-7,1,73.834951,0,0
FBXO48,Fbxo48,4,-4,0,6.524272,0,0
FBXO5,Fbxo5,-10,-16,-26,2.126214,0,0
FBXO6,Fbxo6,-1,-3,-4,2.941748,0,0
FBXO7,Fbxo7,7,-4,3,5.650485,0,0
FBXO8,Fbxo8,6,0,6,0,0,0
FBXO9,Fbxo9,5,-1,4,4.427184,0,0
FBXW10,Fbxw10,51,-6,45,0,0,0
FBXW11,Fbxw11,5,-2,3,4.84466,0,0
FBXW2,Fbxw2,7,-2,5,19.106796,4.416667,0
FBXW4,Fbxw4,3,-4,-1,1.320388,0,0
FBXW5,Fbxw5,3,-6,-3,7.058252,0,0
FBXW7,Fbxw7,9,-3,6,26.368932,0,0
FBXW8,Fbxw8,6,-1,5,11.961165,0,0
FBXW9,Fbxw9,3,2,5,29.300971,0,0
FCAMR,Fcamr,4,-3,1,0,0,0
FCER1A,Fcer1a,2,-1,1,0,0,0
FCER1G,Fcer1g,-10,0,-10,0,0,0
FCF1,Fcf1,5,-5,0,0,0,0
FCGBP,Fcgbp,8,-1,7,0,0,0
FCGR2B,Fcgr2b,7,10,17,0,0,0
FCGRT,Fcgrt,11,-9,2,2.533981,0,0
FCHO1,Fcho1,8,0,8,11.825243,0,0
FCHO2,Fcho2,2,-3,-1,4.631068,0,0
FCHSD1,Fchsd1,7,6,13,0,0,0
FCHSD2,Fchsd2,8,-1,7,10.398058,0,0
FCMR,Fcmr,10,-10,0,0,0,0
FCRL1,Fcrl1,-1,8,7,0,0,0
FCRL5,Fcrl5,1,1,2,0,0,0
FCRL6,Fcrl6,6,0,6,4.31068,0,0
FCRLA,Fcrla,0,-9,-9,0,0,0
FCRLB,Fcrlb,0,-1,-1,16.796117,0,0
FCSK,Fcsk,8,2,10,10.466019,0,0
FDFT1,Fdft1,7,-3,4,2.631068,0,0
FDPS,Fdps,-3,0,-3,0,0,0
FDX1,Fdx1,3,-1,2,17.805825,0,0
FDX2,Fdx2,6,1,7,5.796117,0,0
FDXACB1,Fdxacb1,-6,-8,-14,12.951456,0,0
FDXR,Fdxr,0,-3,-3,3.601942,0,0
FECH,Fech,1,-4,-3,6.970874,0,0
FEM1A,Fem1a,4,-1,3,4.213592,0,0
FEM1B,Fem1b,-3,-5,-8,12.097087,0,101
FEM1C,Fem1c,13,-2,11,7.466019,0,0
FEN1,Fen1,3,0,3,4.961165,0,0
FER,Fer,4,-4,0,38.631068,0,0
FER1L5,Fer1l5,6,-9,-3,45.601942,0,0
FER1L6,Fer1l6,-1,-3,-4,0,0,0
FERD3L,Ferd3l,2,-1,1,0,0,0
FERMT1,Fermt1,-12,2,-10,4.728155,0,0
FERMT2,Fermt2,9,1,10,4.563107,0,0
FERMT3,Fermt3,53,15,68,0,0,0
FES,Fes,33,3,36,0,0,0
FETUB,Fetub,9,3,12,3.621359,0,0
FEV,Fev,0,-5,-5,0,0,0
FEZ1,Fez1,3,-8,-5,0,0,0
FEZ2,Fez2,2,0,2,6.514563,0,0
FEZF1,Fezf1,0,-1,-1,0,0,0
FEZF2,Fezf2,5,0,5,0,0,0
FFAR1,Ffar1,3,-7,-4,0,0,0
FFAR2,Ffar2,-1,-10,-11,0,0,0
FFAR3,Ffar3,2,1,3,1.067961,0,0
FFAR4,Ffar4,6,-2,4,0,0,0
FGA,Fga,0,9,9,0,0,0
FGB,Fgb,4,-3,1,0,0,0
FGD1,Fgd1,9,-3,6,1.291262,0,0
FGD2,Fgd2,6,-6,0,0,0,0
FGD3,Fgd3,-15,-6,-21,4.135922,0,0
FGD4,Fgd4,10,0,10,4.864078,0,0
FGD5,Fgd5,0,0,0,7.417476,0,0
FGD6,Fgd6,10,-1,9,4.281553,0,0
FGF1,Fgf1,10,6,16,0,0,0
FGF10,Fgf10,0,-8,-8,1.194175,0,0
FGF11,Fgf11,18,-3,15,10.718447,0,0
FGF12,Fgf12,4,-4,0,1.92233,0,0
FGF13,Fgf13,4,-3,1,2.330097,0,0
FGF14,Fgf14,0,-4,-4,0,0,0
FGF16,Fgf16,1,7,8,0,0,0
FGF17,Fgf17,8,17,25,0,0,0
FGF18,Fgf18,34,12,46,0,0,0
FGF2,Fgf2,3,-6,-3,5.087379,0,0
FGF20,Fgf20,-9,-4,-13,7.252427,0,0
FGF21,Fgf21,26,33,59,1.805825,0,0
FGF22,Fgf22,8,-6,2,6.058252,0,0
FGF23,Fgf23,4,-7,-3,0,0,0
FGF3,Fgf3,0,-7,-7,1.601942,0,0
FGF4,Fgf4,0,1,1,0,0,0
FGF5,Fgf5,2,-6,-4,1.058252,0,0
FGF6,Fgf6,15,-1,14,0,0,0
FGF7,Fgf7,1,-9,-8,0,0,0
FGF8,Fgf8,22,13,35,0,0,0
FGF9,Fgf9,12,0,12,2.524272,0,0
FGFBP1,Fgfbp1,3,1,4,0,0,0
FGFBP3,Fgfbp3,7,2,9,12.980583,0,0
FGFR1,Fgfr1,13,0,13,21.893204,0,0
FGFR1OP2,Fgfr1op2,7,-4,3,6.330097,0,0
FGFR2,Fgfr2,6,-2,4,2.436893,0,0
FGFR3,Fgfr3,8,2,10,0,0,0
FGFR4,Fgfr4,5,5,10,3.864078,0,0
FGFRL1,Fgfrl1,2,-6,-4,0,0,0
FGG,Fgg,-4,7,3,0,0,0
FGGY,Fggy,0,-5,-5,6.728155,0,0
FGL1,Fgl1,7,10,17,0,0,0
FGL2,Fgl2,-2,1,-1,0,0,0
FGR,Fgr,-2,-4,-6,0,0,0
FHAD1,Fhad1,1,1,2,13.291262,0,0
FHDC1,Fhdc1,-3,-4,-7,1,0,0
FHIT,Fhit,9,1,10,1.718447,0,0
FHL1,Fhl1,20,4,24,12.135922,0,0
FHL2,Fhl2,0,7,7,5.126214,0,0
FHL3,Fhl3,1,-2,-1,6.446602,0,0
FHL5,Fhl5,39,-5,34,0,0,0
FHOD1,Fhod1,-2,-6,-8,2.631068,0,0
FHOD3,Fhod3,3,-5,-2,0,0,0
FIBCD1,Fibcd1,-6,12,6,0,0,0
FIBIN,Fibin,-2,1,-1,0,0,0
FIBP,Fibp,7,-3,4,9.475728,0,0
FICD,Ficd,-1,-2,-3,2.271845,0,0
FIG4,Fig4,5,0,5,8.029126,0,0
FIGLA,Figla,1,-1,0,0,0,0
FIGN,Fign,4,-4,0,3.699029,0,0
FIGNL1,Fignl1,-2,-20,-22,4.902913,0,0
FIGNL2,Fignl2,-1,-2,-3,1.330097,0,0
FILIP1,Filip1,1,0,1,1.116505,0,0
FILIP1L,Filip1l,21,1,22,0,0,0
FIP1L1,Fip1l1,-1,-3,-4,15.291262,3.458333,0
FIS1,Fis1,7,-3,4,4.970874,0,0
FITM1,Fitm1,20,-5,15,2.407767,0,0
FITM2,Fitm2,2,0,2,9.262136,0,0
FIZ1,Fiz1,-3,-9,-12,7.417476,0,0
FJX1,Fjx1,-23,-4,-27,2.320388,0,0
FKBP10,Fkbp10,5,-7,-2,2.679612,0,0
FKBP11,Fkbp11,2,7,9,0,0,0
FKBP14,Fkbp14,1,2,3,0,0,0
FKBP15,Fkbp15,3,-2,1,9.135922,0,0
FKBP1A,Fkbp1a,7,-2,5,6.825243,0,0
FKBP1B,Fkbp1b,14,-10,4,0,0,0
FKBP2,Fkbp2,2,-7,-5,0.796117,0,0
FKBP3,Fkbp3,3,-1,2,10.864078,0,0
FKBP4,Fkbp4,129,8,137,505.126214,269.208333,0
FKBP5,Fkbp5,-1,-3,-4,8.728155,0,0
FKBP6,Fkbp6,2,4,6,1.349515,0,113
FKBP7,Fkbp7,4,-2,2,3.834951,0,0
FKBP8,Fkbp8,11,-12,-1,2.718447,0,0
FKBP9,Fkbp9,3,0,3,5.087379,0,0
FKBPL,Fkbpl,-7,-3,-10,11.84466,0,0
FKRP,Fkrp,-10,-4,-14,1.854369,0,0
FKTN,Fktn,1,-6,-5,6.718447,0,0
FLACC1,Flacc1,9,-11,-2,0,0,0
FLAD1,Flad1,5,-1,4,0,0,0
FLCN,Flcn,5,0,5,1.174757,0,0
FLG,Flg,0,10,10,0,0,0
FLG2,Flg2,0,1,1,0,0,0
FLI1,Fli1,-18,0,-18,2.475728,0,0
FLII,Flii,7,-5,2,1,0,0
FLNA,Flna,3,-10,-7,2.252427,0,0
FLNB,Flnb,7,2,9,16.252427,0,0
FLNC,Flnc,8,-2,6,3.864078,0,0
FLOT1,Flot1,3,-5,-2,12.640777,0,0
FLOT2,Flot2,7,-2,5,8.563107,0,0
FLRT1,Flrt1,4,5,9,0,0,0
FLRT2,Flrt2,2,-4,-2,0,0,0
FLRT3,Flrt3,5,-9,-4,0,0,0
FLT1,Flt1,6,-1,5,0,0,0
FLT3,Flt3,2,-2,0,0,0,0
FLT4,Flt4,4,-2,2,8.796117,0,0
FLVCR1,Flvcr1,2,1,3,1.805825,0,0
FLVCR2,Flvcr2,-3,-7,-10,7.679612,0,0
FLYWCH1,Flywch1,-2,-10,-12,9.378641,0,0
FLYWCH2,Flywch2,0,-5,-5,0,0,0
FMC1,Fmc1,9,-10,-1,38.601942,0,0
FMN1,Fmn1,-2,-6,-8,0,0,0
FMN2,Fmn2,8,-1,7,0,0,0
FMNL1,Fmnl1,-2,2,0,1.466019,0,0
FMNL2,Fmnl2,8,-7,1,6.330097,0,0
FMNL3,Fmnl3,7,-6,1,15.902913,0,0
FMO1,Fmo1,-2,-5,-7,0,0,0
FMO2,Fmo2,0,7,7,0,0,0
FMO3,Fmo3,6,1,7,0,0,0
FMO4,Fmo4,4,3,7,0,0,0
FMO5,Fmo5,1,3,4,0,0,0
FMOD,Fmod,0,9,9,0,0,0
FMR1,Fmr1,4,7,11,2,0,0
FMR1NB,Fmr1nb,27,0,27,81.815534,0,0
FN1,Fn1,5,3,8,0,0,0
FN3K,Fn3k,4,-9,-5,0.776699,0,0
FN3KRP,Fn3krp,6,-8,-2,0,0,0
FNBP1,Fnbp1,13,0,13,4.650485,0,0
FNBP1L,Fnbp1l,11,-7,4,10.368932,0,0
FNBP4,Fnbp4,-2,-4,-6,5.61165,0,0
FNDC1,Fndc1,3,-3,0,2.165049,0,0
FNDC10,Fndc10,3,-3,0,0,0,0
FNDC11,Fndc11,5,-14,-9,0,0,0
FNDC3A,Fndc3a,6,-5,1,1.15534,0,0
FNDC3B,Fndc3b,4,-1,3,9.194175,0,0
FNDC4,Fndc4,2,-1,1,0,0,0
FNDC5,Fndc5,1,-1,0,1.116505,0,0
FNDC7,Fndc7,13,-2,11,0,0,0
FNDC8,Fndc8,-2,-7,-9,1.61165,0,0
FNDC9,Fndc9,4,-5,-1,7.563107,0,0
FNIP1,Fnip1,-1,-1,-2,2.213592,0,0
FNIP2,Fnip2,12,-3,9,1.203883,0,0
FNTA,Fnta,6,-7,-1,7.213592,0,0
FNTB,Fntb,5,0,5,7.669903,0,0
FOCAD,Focad,3,-3,0,3.757282,0,0
FOLH1,Folh1,-6,4,-2,0,0,0
FOLR1,Folr1,-2,8,6,0,0,0
FOLR2,Folr2,1,-3,-2,0,0,0
FOS,Fos,165,51,216,84.893204,0,0
FOSB,Fosb,118,13,131,24.320388,0,0
FOSL1,Fosl1,-11,1,-10,7.495146,0,0
FOSL2,Fosl2,-5,9,4,29.067961,0,0
FOXA1,Foxa1,13,-1,12,3.737864,0,0
FOXA2,Foxa2,2,7,9,0,0,0
FOXA3,Foxa3,18,5,23,0.737864,0,0
FOXB1,Foxb1,3,8,11,1.067961,0,0
FOXB2,Foxb2,-3,-4,-7,0,0,0
FOXC1,Foxc1,11,2,13,1.106796,0,0
FOXC2,Foxc2,10,8,18,12.621359,0,0
FOXD1,Foxd1,-5,0,-5,1.252427,0,0
FOXD2,Foxd2,-1,5,4,2.223301,0,0
FOXD3,Foxd3,30,-4,26,20.194175,0,0
FOXD4,Foxd4,27,6,33,1.854369,7,0
FOXE1,Foxe1,7,-1,6,0,0,0
FOXE3,Foxe3,12,-5,7,0,0,0
FOXF1,Foxf1,6,6,12,0,0,0
FOXF2,Foxf2,4,-6,-2,0,0,0
FOXG1,Foxg1,6,2,8,0,0,0
FOXH1,Foxh1,-3,-7,-10,85.84466,0,0
FOXI1,Foxi1,4,3,7,0,0,0
FOXI2,Foxi2,0,-7,-7,0,0,0
FOXI3,Foxi3,5,-1,4,0,0,0
FOXJ1,Foxj1,83,2,85,120.116505,0,163
FOXJ2,Foxj2,6,-1,5,8.796117,0,0
FOXJ3,Foxj3,9,-3,6,24.097087,0,0
FOXK1,Foxk1,9,-3,6,10.951456,0,0
FOXK2,Foxk2,9,0,9,9.320388,0,0
FOXL1,Foxl1,1,-1,0,1.631068,0,0
FOXL2,Foxl2,-2,-1,-3,0,0,0
FOXL3,Foxl3,21,-3,18,0,0,0
FOXM1,Foxm1,10,-9,1,4.194175,0,0
FOXN1,Foxn1,-2,4,2,0,0,0
FOXN2,Foxn2,8,-1,7,64.84466,0,0
FOXN3,Foxn3,5,2,7,27.941748,0,0
FOXN4,Foxn4,4,-4,0,0.980583,0,0
FOXO1,Foxo1,15,3,18,0,0,0
FOXO3,Foxo3,9,1,10,5.553398,0,0
FOXO4,Foxo4,5,-7,-2,0,0,0
FOXO6,Foxo6,3,1,4,36.281553,0,0
FOXP1,Foxp1,5,0,5,9.961165,0,0
FOXP2,Foxp2,10,-15,-5,0,0,0
FOXP3,Foxp3,11,-3,8,0,0,0
FOXP4,Foxp4,6,0,6,1.262136,0,0
FOXQ1,Foxq1,3,9,12,0,0,0
FOXR1,Foxr1,15,8,23,0,0,0
FOXR2,Foxr2,0,-1,-1,0,0,0
FOXRED1,Foxred1,7,-5,2,0,0,0
FOXRED2,Foxred2,3,5,8,2.951456,0,0
FOXS1,Foxs1,-2,1,-1,1.174757,0,0
FPGS,Fpgs,3,-10,-7,9.990291,0,0
FPGT,Fpgt,-5,-3,-8,2.582524,0,0
FPR1,Fpr1,9,1,10,0,0,0
FPR2,Fpr2,8,13,21,0,0,0
FPR3,Fpr3,-2,1,-1,0,0,0
FRA10AC1,Fra10ac1,0,-10,-10,22.873786,0,0
FRAS1,Fras1,3,-1,2,0.825243,0,0
FRAT1,Frat1,-12,-4,-16,1.359223,0,0
FRAT2,Frat2,2,-3,-1,2.38835,0,0
FREM1,Frem1,-1,-5,-6,0,0,0
FREM2,Frem2,3,-1,2,1.621359,0,0
FREM3,Frem3,-2,1,-1,0,0,0
FRG1,Frg1,6,0,6,24.902913,0,0
FRK,Frk,4,5,9,12.23301,0,0
FRMD3,Frmd3,-1,-3,-4,6.223301,0,0
FRMD4A,Frmd4a,6,-1,5,0,0,0
FRMD4B,Frmd4b,0,-9,-9,0,0,0
FRMD5,Frmd5,2,-4,-2,4.485437,0,0
FRMD6,Frmd6,3,-5,-2,10.320388,0,0
FRMD7,Frmd7,0,4,4,0,0,0
FRMD8,Frmd8,1,1,2,12.815534,0,0
FRMPD1,Frmpd1,-4,-1,-5,0,0,0
FRMPD2,Frmpd2,-5,-3,-8,2.368932,0,0
FRMPD3,Frmpd3,1,1,2,0,0,0
FRMPD4,Frmpd4,0,1,1,0,0,0
FRRS1,Frrs1,0,5,5,0,0,0
FRRS1L,Frrs1l,3,-2,1,0,0,0
FRS2,Frs2,16,-3,13,5.466019,0,0
FRS3,Frs3,-4,-14,-18,17.961165,0,0
FRY,Fry,5,-1,4,0,0,0
FRYL,Fryl,11,-3,8,0,0,0
FRZB,Frzb,17,5,22,0,0,0
FSBP,Fsbp,0,-7,-7,1.932039,0,0
FSCB,Fscb,0,0,0,0,0,0
FSCN1,Fscn1,12,-2,10,1.92233,0,0
FSCN2,Fscn2,0,3,3,0,0,0
FSCN3,Fscn3,46,-1,45,0,0,0
FSD1,Fsd1,8,-3,5,0,0,0
FSD1L,Fsd1l,1,-3,-2,52.912621,0,0
FSD2,Fsd2,8,-3,5,3.61165,0,0
FSHB,Fshb,0,0,0,0,0,0
FSHR,Fshr,0,6,6,0,0,0
FSIP1,Fsip1,1,-14,-13,47.38835,3.833333,0
FSIP2,Fsip2,3,-6,-3,0.980583,0,0
FST,Fst,4,9,13,0,0,0
FSTL1,Fstl1,6,-12,-6,9.815534,0,0
FSTL3,Fstl3,0,-6,-6,0,0,0
FSTL4,Fstl4,8,0,8,0,0,0
FSTL5,Fstl5,-3,-2,-5,0,0,0
FTCD,Ftcd,31,0,31,80.699029,0,0
FTH1,Fth1,11,-1,10,6.796117,0,0
FTMT,Ftmt,0,-7,-7,0,0,0
FTO,Fto,8,-2,6,34.349515,0,0
FTSJ1,Ftsj1,4,1,5,3.223301,0,0
FTSJ3,Ftsj3,9,-2,7,47.466019,0,0
FUBP1,Fubp1,9,0,9,5.728155,0,0
FUBP3,Fubp3,9,-3,6,10.61165,0,0
FUCA1,Fuca1,2,0,2,3.864078,0,0
FUCA2,Fuca2,5,-2,3,8.058252,0,0
FUNDC1,Fundc1,5,-2,3,2.61165,0,0
FUNDC2,Fundc2,8,3,11,10.873786,0,0
FUOM,Fuom,5,2,7,0,0,0
FURIN,Furin,7,-1,6,1.048544,0,0
FUS,Fus,7,-9,-2,3.961165,0,0
FUT1,Fut1,5,14,19,1.805825,0,0
FUT10,Fut10,7,-2,5,50.271845,4.875,0
FUT11,Fut11,4,3,7,28.592233,19.541667,0
FUT2,Fut2,0,5,5,0,0,0
FUT4,Fut4,-4,-2,-6,5.126214,0,0
FUT7,Fut7,11,9,20,0,0,0
FUT8,Fut8,8,0,8,17.660194,0,0
FUT9,Fut9,-2,0,-2,0,0,0
FUZ,Fuz,0,0,0,3.330097,0,0
FXN,Fxn,6,3,9,12.84466,0,0
FXR1,Fxr1,17,0,17,201.320388,0,0
FXR2,Fxr2,3,-5,-2,2.582524,0,0
FXYD1,Fxyd1,2,0,2,0,0,0
FXYD2,Fxyd2,16,5,21,0,0,0
FXYD3,Fxyd3,4,0,4,0,0,0
FXYD4,Fxyd4,-5,11,6,0,0,0
FXYD5,Fxyd5,1,-6,-5,0,0,0
FXYD6,Fxyd6,13,2,15,0,0,0
FXYD7,Fxyd7,-12,0,-12,0,0,0
FYB2,Fyb2,-5,-1,-6,0,0,0
FYCO1,Fyco1,0,-2,-2,6.339806,0,0
FYN,Fyn,5,2,7,4.757282,0,0
FYTTD1,Fyttd1,3,-5,-2,7.262136,0,0
FZD1,Fzd1,18,-3,15,25.213592,0,0
FZD10,Fzd10,-2,-5,-7,11.563107,0,0
FZD2,Fzd2,-6,-4,-10,0,0,0
FZD3,Fzd3,3,-2,1,3.504854,0,0
FZD4,Fzd4,1,-1,0,6.07767,0,0
FZD5,Fzd5,5,5,10,3.864078,0,0
FZD6,Fzd6,-3,-15,-18,5.223301,0,0
FZD7,Fzd7,2,5,7,1.514563,0,0
FZD8,Fzd8,73,-6,67,8.456311,0,0
FZD9,Fzd9,-2,0,-2,0,0,0
FZR1,Fzr1,-7,-5,-12,45.718447,0,0
G0S2,G0s2,1,7,8,6.291262,0,0
G2E3,G2e3,6,-6,0,13.446602,0,0
G3BP1,G3bp1,7,-5,2,9.61165,0,0
G3BP2,G3bp2,4,-2,2,2.213592,0,0
G6PC,G6pc,3,5,8,0,0,0
G6PC2,G6pc2,1,-3,-2,0,0,0
G6PC3,G6pc3,3,-1,2,12.893204,0,0
GAA,Gaa,11,1,12,27.058252,0,0
GAB1,Gab1,10,-2,8,3.291262,0,0
GAB2,Gab2,10,-3,7,2.543689,0,0
GAB3,Gab3,5,-4,1,0,0,0
GABARAP,Gabarap,10,-3,7,4.368932,0,0
GABARAPL1,Gabarapl1,10,0,10,0,0,0
GABARAPL2,Gabarapl2,9,-1,8,16.359223,0,0
GABBR1,Gabbr1,2,-4,-2,0,0,0
GABBR2,Gabbr2,-1,-6,-7,0,0,0
GABPA,Gabpa,7,-1,6,1.427184,0,0
GABPB1,Gabpb1,6,-4,2,11.631068,0,0
GABPB2,Gabpb2,6,-3,3,4.601942,0,0
GABRA1,Gabra1,-5,-11,-16,0,0,0
GABRA2,Gabra2,-4,0,-4,0,0,0
GABRA3,Gabra3,1,10,11,0,0,0
GABRA4,Gabra4,1,2,3,0,0,0
GABRA5,Gabra5,0,-5,-5,0,0,0
GABRA6,Gabra6,3,1,4,0,0,0
GABRB1,Gabrb1,2,0,2,0,0,0
GABRB2,Gabrb2,-1,2,1,0,0,0
GABRB3,Gabrb3,7,3,10,0,0,0
GABRD,Gabrd,1,-4,-3,0,0,0
GABRE,Gabre,40,-1,39,7.854369,0,0
GABRG1,Gabrg1,0,0,0,0,0,0
GABRG2,Gabrg2,24,1,25,0,0,0
GABRG3,Gabrg3,0,-4,-4,0,0,0
GABRP,Gabrp,8,3,11,0,0,0
GABRQ,Gabrq,-2,0,-2,0,0,0
GABRR1,Gabrr1,3,3,6,0,0,0
GABRR2,Gabrr2,5,13,18,0,0,0
GABRR3,Gabrr3,3,0,3,0,0,0
GAD1,Gad1,5,-5,0,4.737864,0,0
GAD2,Gad2,3,2,5,0,0,0
GADD45A,Gadd45a,6,12,18,6.902913,0,0
GADD45B,Gadd45b,35,11,46,19.145631,0,0
GADD45G,Gadd45g,48,16,64,0,0,0
GADD45GIP1,Gadd45gip1,4,-4,0,11.601942,0,0
GADL1,Gadl1,5,-7,-2,1.058252,0,0
GAK,Gak,7,-1,6,8.572816,0,0
GAL,Gal,6,14,20,7.456311,0,0
GAL3ST1,Gal3st1,72,4,76,3.281553,0,0
GAL3ST2,Gal3st2,11,9,20,10.291262,0,0
GAL3ST3,Gal3st3,0,-1,-1,10.427184,0,0
GAL3ST4,Gal3st4,-3,-1,-4,0,0,0
GALC,Galc,9,-1,8,1.203883,0,0
GALE,Gale,1,-3,-2,14.252427,0,0
GALK1,Galk1,3,-7,-4,1.485437,0,0
GALK2,Galk2,5,2,7,11.456311,0,0
GALM,Galm,3,-3,0,0,0,0
GALNS,Galns,3,1,4,79.601942,0,0
GALNT1,Galnt1,4,-2,2,0,0,0
GALNT10,Galnt10,5,-4,1,1.466019,0,0
GALNT11,Galnt11,5,-6,-1,6.252427,0,0
GALNT12,Galnt12,-2,-4,-6,5.262136,0,0
GALNT13,Galnt13,-1,-10,-11,12.165049,0,0
GALNT14,Galnt14,4,-3,1,5.970874,0,0
GALNT15,Galnt15,7,6,13,1.466019,0,0
GALNT16,Galnt16,9,-5,4,0,0,0
GALNT17,Galnt17,0,-5,-5,0,0,0
GALNT18,Galnt18,-5,-2,-7,2.165049,0,0
GALNT2,Galnt2,7,-2,5,31.475728,0,0
GALNT3,Galnt3,5,-10,-5,6.145631,0,0
GALNT4,Galnt4,-3,-1,-4,4.174757,0,0
GALNT5,Galnt5,-2,0,-2,0,0,0
GALNT6,Galnt6,-2,3,1,11.466019,0,0
GALNT7,Galnt7,-1,-4,-5,0.893204,0,0
GALNT9,Galnt9,28,-5,23,0,0,0
GALNTL5,Galntl5,0,-4,-4,0,0,0
GALNTL6,Galntl6,0,-13,-13,0,0,0
GALP,Galp,6,9,15,0,0,0
GALR1,Galr1,0,0,0,0,0,0
GALR2,Galr2,16,8,24,10.61165,0,0
GALR3,Galr3,13,4,17,0,0,0
GALT,Galt,4,-6,-2,1.087379,0,0
GAMT,Gamt,2,-2,0,6.330097,0,0
GAN,Gan,4,-6,-2,6.504854,0,0
GANAB,Ganab,11,-3,8,0.805825,0,0
GANC,Ganc,-3,-1,-4,3.339806,0,0
GAP43,Gap43,0,3,3,0,0,0
GAPDH,Gapdh,4,-5,-1,5.213592,0,0
GAPDHS,Gapdhs,-1,-6,-7,0,0,0
GAPT,Gapt,12,-6,6,0,0,0
GAPVD1,Gapvd1,3,2,5,3.417476,0,0
GAR1,Gar1,2,-3,-1,0,0,0
GAREM1,Garem1,3,-1,2,4.737864,0,0
GAREM2,Garem2,10,-6,4,0,0,0
GARNL3,Garnl3,-10,0,-10,0,0,0
GARRE1,Garre1,3,-1,2,1,0,0
GART,Gart,8,-4,4,0,0,0
GAS1,Gas1,62,-3,59,0,0,0
GAS2,Gas2,-2,-4,-6,0,0,0
GAS2L1,Gas2l1,2,-1,1,19.446602,0,0
GAS2L2,Gas2l2,1,1,2,0,0,0
GAS2L3,Gas2l3,3,-2,1,7.281553,0,0
GAS6,Gas6,6,2,8,2.825243,0,0
GAS7,Gas7,5,5,10,0,0,0
GAS8,Gas8,3,-10,-7,29.194175,0,0
GASK1A,Gask1a,-6,-9,-15,0,0,0
GASK1B,Gask1b,-4,-11,-15,0,0,0
GAST,Gast,53,9,62,0,0,0
GATA1,Gata1,5,2,7,0,0,0
GATA2,Gata2,5,-2,3,12.543689,0,0
GATA3,Gata3,8,7,15,0,0,0
GATA4,Gata4,7,5,12,1.737864,0,0
GATA5,Gata5,33,-3,30,0,0,0
GATA6,Gata6,1,6,7,1.048544,0,0
GATAD1,Gatad1,4,-1,3,6.708738,0,0
GATAD2A,Gatad2a,8,1,9,21.126214,0,0
GATAD2B,Gatad2b,3,-2,1,11.339806,0,0
GATB,Gatb,-4,-7,-11,10.941748,0,0
GATC,Gatc,5,-3,2,0,0,0
GATD1,Gatd1,1,-4,-3,0,0,0
GATD3A,Gatd3a,8,-3,5,0.873786,0,0
GATM,Gatm,4,-7,-3,2.912621,0,0
GBA,Gba,10,6,16,51.097087,0,0
GBA2,Gba2,9,-4,5,2.815534,0,0
GBE1,Gbe1,2,0,2,9.417476,0,0
GBF1,Gbf1,10,-1,9,0.834951,0,0
GBGT1,Gbgt1,7,0,7,0,0,0
GBP2,Gbp2,0,7,7,0,0,0
GBP3,Gbp3,5,-1,4,4.669903,0,0
GBP4,Gbp4,1,-5,-4,0,0,0
GBP5,Gbp5,21,-2,19,0,0,0
GBP6,Gbp6,1,5,6,0,0,0
GBP7,Gbp7,0,3,3,0,0,0
GBX1,Gbx1,-1,2,1,0,0,0
GBX2,Gbx2,-1,3,2,0,0,0
GC,Gc,2,6,8,0,0,0
GCA,Gca,-3,4,1,3.058252,0,0
GCAT,Gcat,0,-2,-2,0.92233,0,0
GCC1,Gcc1,8,-1,7,4.932039,0,0
GCC2,Gcc2,3,-6,-3,0,0,0
GCDH,Gcdh,4,4,8,2.038835,0,0
GCFC2,Gcfc2,6,-3,3,19.330097,0,0
GCG,Gcg,2,12,14,0,0,0
GCGR,Gcgr,56,-1,55,29.349515,0,0
GCH1,Gch1,5,6,11,7.165049,0,0
GCHFR,Gchfr,14,-12,2,3.31068,0,0
GCK,Gck,6,7,13,1.320388,0,0
GCKR,Gckr,14,4,18,0,0,0
GCLC,Gclc,-12,2,-10,15.417476,0,0
GCLM,Gclm,-3,4,1,17.592233,0,0
GCM1,Gcm1,9,-1,8,0,0,0
GCM2,Gcm2,3,-3,0,0,0,0
GCN1,Gcn1,8,-2,6,11.912621,0,0
GCNT1,Gcnt1,-7,0,-7,5.718447,0,0
GCNT2,Gcnt2,2,5,7,2.854369,0,0
GCNT3,Gcnt3,-2,-3,-5,0,0,0
GCNT4,Gcnt4,22,-7,15,4.194175,0,0
GCNT7,Gcnt7,0,4,4,0,0,0
GCSAM,Gcsam,1,-10,-9,0,0,0
GCSH,Gcsh,1,-8,-7,0,0,0
GDA,Gda,3,-3,0,2.145631,0,0
GDAP1,Gdap1,-2,-4,-6,10.582524,0,0
GDAP1L1,Gdap1l1,4,-1,3,0,0,0
GDAP2,Gdap2,7,2,9,4.68932,0,0
GDE1,Gde1,4,-3,1,0,0,0
GDF1,Gdf1,6,-17,-11,7.92233,0,0
GDF10,Gdf10,-6,-2,-8,0,0,0
GDF11,Gdf11,8,-10,-2,4.970874,0,0
GDF15,Gdf15,-13,22,9,8.07767,0,0
GDF2,Gdf2,0,0,0,0,0,0
GDF3,Gdf3,0,-3,-3,0,0,0
GDF5,Gdf5,-9,-3,-12,11.23301,0,0
GDF6,Gdf6,4,0,4,0,0,0
GDF7,Gdf7,15,-5,10,2.786408,0,0
GDF9,Gdf9,37,7,44,5.951456,0,0
GDI1,Gdi1,8,0,8,16.941748,0,0
GDI2,Gdi2,5,-5,0,12.087379,0,0
GDNF,Gdnf,8,0,8,0,0,0
GDPD1,Gdpd1,8,-3,5,2.398058,0,0
GDPD2,Gdpd2,9,-1,8,0,0,0
GDPD3,Gdpd3,-10,1,-9,0,0,0
GDPD4,Gdpd4,0,-8,-8,0,0,0
GDPD5,Gdpd5,7,-7,0,4.504854,0,0
GDPGP1,Gdpgp1,3,-11,-8,16.281553,0,0
GEM,Gem,69,9,78,15.174757,0,0
GEMIN2,Gemin2,0,-3,-3,2.796117,0,0
GEMIN4,Gemin4,-10,-14,-24,4.009709,0,0
GEMIN5,Gemin5,-2,-2,-4,8.38835,0,0
GEMIN6,Gemin6,-2,-2,-4,0,0,0
GEMIN7,Gemin7,-8,-4,-12,18.116505,0,0
GEMIN8,Gemin8,3,-4,-1,67.524272,0,0
GEN1,Gen1,0,-8,-8,4.281553,0,0
GET1,Get1,7,-8,-1,4.951456,0,0
GET3,Get3,6,1,7,19.242718,0,0
GET4,Get4,8,-3,5,22.23301,0,0
GFAP,Gfap,0,1,1,0,0,0
GFER,Gfer,-1,-7,-8,31.786408,0,0
GFI1,Gfi1,-3,0,-3,0,0,0
GFI1B,Gfi1b,10,-2,8,13.708738,0,0
GFM1,Gfm1,1,-1,0,3.76699,0,0
GFM2,Gfm2,17,-4,13,34.572816,0,0
GFOD1,Gfod1,-1,3,2,3.300971,0,0
GFOD2,Gfod2,9,3,12,4.834951,0,0
GFPT1,Gfpt1,7,-6,1,9.427184,0,0
GFPT2,Gfpt2,33,1,34,39.796117,0,0
GFRA1,Gfra1,3,5,8,18.718447,0,0
GFRA2,Gfra2,13,-7,6,0,0,0
GFRA3,Gfra3,12,0,12,0,0,0
GFRA4,Gfra4,9,-3,6,0,0,0
GFRAL,Gfral,0,-2,-2,0,0,0
GFUS,Gfus,9,-1,8,19.990291,0,0
GFY,Gfy,1,4,5,0,0,0
GGA1,Gga1,7,-3,4,8.097087,0,0
GGA2,Gga2,8,-1,7,7.456311,0,0
GGA3,Gga3,-2,-1,-3,7.533981,0,0
GGACT,Ggact,-19,-3,-22,6.572816,0,0
GGCT,Ggct,-1,1,0,0,0,0
GGCX,Ggcx,3,3,6,5.834951,0,0
GGH,Ggh,5,-6,-1,18.533981,0,0
GGN,Ggn,34,-4,30,9.184466,0,0
GGNBP2,Ggnbp2,-9,-6,-15,3.514563,0,0
GGPS1,Ggps1,-1,0,-1,0.815534,0,0
GGT1,Ggt1,21,-4,17,0,0,0
GGT5,Ggt5,21,6,27,0,0,0
GGT6,Ggt6,1,-3,-2,1.038835,0,0
GGT7,Ggt7,10,-10,0,3.621359,0,0
GGTA1,Ggta1,15,0,15,7.68932,0,0
GHDC,Ghdc,3,2,5,0,0,0
GHITM,Ghitm,7,-2,5,1.349515,0,0
GHR,Ghr,-1,-1,-2,3.417476,0,0
GHRH,Ghrh,12,10,22,0,0,0
GHRHR,Ghrhr,1,1,2,0,0,0
GHRL,Ghrl,17,-8,9,0,0,0
GHSR,Ghsr,7,3,10,0,0,0
GID4,Gid4,0,-3,-3,4.669903,0,0
GID8,Gid8,6,-5,1,9.737864,0,0
GIGYF1,Gigyf1,9,-1,8,3.543689,0,0
GIGYF2,Gigyf2,3,-2,1,0,0,0
GIMAP1,Gimap1,-1,0,-1,0,0,0
GIMAP4,Gimap4,2,-3,-1,0,0,0
GIMAP5,Gimap5,-3,1,-2,0,0,0
GIMAP6,Gimap6,2,-7,-5,0,0,0
GIMAP7,Gimap7,1,-1,0,0,0,0
GIMAP8,Gimap8,8,-1,7,18.92233,0,0
GIMD1,Gimd1,17,2,19,0,0,0
GIN1,Gin1,8,-11,-3,4.970874,0,0
GINM1,Ginm1,7,-4,3,4.757282,0,0
GINS1,Gins1,-2,-9,-11,2.76699,0,0
GINS2,Gins2,6,-5,1,1.776699,0,0
GINS3,Gins3,3,-10,-7,5.242718,0,0
GINS4,Gins4,4,-2,2,3,0,0
GIP,Gip,4,-5,-1,0,0,0
GIPC1,Gipc1,16,-3,13,29.466019,0,0
GIPC2,Gipc2,20,5,25,0,0,0
GIPC3,Gipc3,16,7,23,11.145631,0,0
GIPR,Gipr,-5,-5,-10,0,0,0
GIT1,Git1,6,-6,0,13.339806,0,0
GIT2,Git2,4,-2,2,2.300971,0,0
GJA1,Gja1,9,-11,-2,4.912621,0,0
GJA10,Gja10,4,0,4,0,0,0
GJA3,Gja3,1,1,2,0,0,0
GJA4,Gja4,7,-1,6,0,0,0
GJA5,Gja5,-8,-11,-19,0,0,0
GJA8,Gja8,11,-3,8,0,0,0
GJB1,Gjb1,0,1,1,0,0,0
GJB2,Gjb2,2,6,8,11.737864,0,0
GJB3,Gjb3,8,-1,7,0,0,0
GJB4,Gjb4,1,-4,-3,0,0,0
GJB5,Gjb5,1,-6,-5,0,0,0
GJB6,Gjb6,2,0,2,0,0,0
GJC1,Gjc1,10,-8,2,7.281553,0,0
GJC2,Gjc2,21,12,33,0,0,0
GJC3,Gjc3,1,-1,0,0,0,0
GJD2,Gjd2,-1,-2,-3,0,0,0
GJD3,Gjd3,3,-5,-2,0,0,0
GJD4,Gjd4,44,3,47,0,0,0
GJE1,Gje1,1,-4,-3,0,0,0
GK,Gk,7,0,7,0.834951,0,0
GK2,Gk2,0,-4,-4,0,0,0
GK5,Gk5,7,0,7,0,0,0
GKAP1,Gkap1,21,-5,16,20.194175,0,0
GKN1,Gkn1,2,-2,0,0,0,0
GKN2,Gkn2,-2,-4,-6,0,0,0
GLA,Gla,1,1,2,0,0,0
GLB1,Glb1,6,-2,4,4.087379,0,0
GLB1L,Glb1l,5,-14,-9,6.038835,0,0
GLB1L2,Glb1l2,3,5,8,32.242718,0,0
GLB1L3,Glb1l3,5,-2,3,0,0,0
GLCCI1,Glcci1,11,-4,7,5.961165,0,0
GLCE,Glce,-16,-22,-38,4.009709,0,0
GLDC,Gldc,14,-9,5,6.631068,0,0
GLDN,Gldn,-10,1,-9,0.825243,0,0
GLE1,Gle1,6,-3,3,3.718447,0,0
GLG1,Glg1,8,-1,7,6.359223,0,0
GLI1,Gli1,-10,-3,-13,1.339806,0,0
GLI2,Gli2,-23,-5,-28,18.116505,0,0
GLI3,Gli3,-6,-3,-9,4.446602,0,0
GLIPR1,Glipr1,-7,1,-6,0,0,0
GLIPR1L1,Glipr1l1,-2,-7,-9,15.815534,0,0
GLIPR1L2,Glipr1l2,6,-3,3,1.135922,0,0
GLIPR2,Glipr2,7,-7,0,0,0,0
GLIS1,Glis1,0,-5,-5,10.058252,0,0
GLIS2,Glis2,3,-4,-1,0,0,0
GLIS3,Glis3,11,1,12,4.174757,0,0
GLMN,Glmn,0,-11,-11,10.718447,0,0
GLMP,Glmp,3,8,11,1.320388,0,0
GLO1,Glo1,6,-1,5,1.398058,0,0
GLOD4,Glod4,1,-5,-4,12.320388,0,0
GLOD5,Glod5,-1,10,9,0,0,0
GLP1R,Glp1r,-1,-4,-5,1.38835,0,0
GLP2R,Glp2r,-9,-7,-16,0,0,0
GLRA1,Glra1,2,1,3,0,0,0
GLRA2,Glra2,9,0,9,0,0,0
GLRA3,Glra3,5,-2,3,29.349515,0,0
GLRB,Glrb,12,-1,11,0,0,0
GLRX,Glrx,6,-2,4,0,0,0
GLRX2,Glrx2,-2,-2,-4,1.058252,0,0
GLRX3,Glrx3,4,-9,-5,2.970874,0,0
GLRX5,Glrx5,5,-7,-2,33.553398,0,0
GLS,Gls,6,-1,5,0.834951,0,0
GLS2,Gls2,2,-2,0,0,0,0
GLT1D1,Glt1d1,2,3,5,0,0,0
GLT6D1,Glt6d1,3,-3,0,4.631068,0,0
GLT8D1,Glt8d1,4,-12,-8,47.786408,0,0
GLT8D2,Glt8d2,5,-7,-2,13.92233,0,0
GLTP,Gltp,7,-3,4,7.135922,0,0
GLTPD2,Gltpd2,4,2,6,6.116505,0,0
GLUD1,Glud1,6,3,9,2.15534,0,0
GLUL,Glul,9,-11,-2,35.747573,0,0
GLYAT,Glyat,29,4,33,0,0,0
GLYATL3,Glyatl3,8,4,12,0,0,0
GLYCTK,Glyctk,9,-8,1,5.029126,0,0
GLYR1,Glyr1,12,-2,10,3.825243,0,0
GM2A,Gm2a,4,-2,2,0,0,0
GMCL1,Gmcl1,1,-2,-1,5.339806,0,0
GMDS,Gmds,2,-2,0,3.932039,0,0
GMEB1,Gmeb1,3,0,3,2.029126,0,0
GMEB2,Gmeb2,-9,-3,-12,4.92233,0,0
GMFB,Gmfb,7,-3,4,17.184466,0,0
GMFG,Gmfg,9,-4,5,1.31068,0,0
GMIP,Gmip,10,-7,3,1.514563,0,0
GML,Gml,1,30,31,23.708738,0,0
GMNC,Gmnc,-1,-7,-8,3.058252,0,0
GMNN,Gmnn,-1,-4,-5,1.796117,0,0
GMPPA,Gmppa,7,-8,-1,0,0,0
GMPPB,Gmppb,0,-3,-3,20.582524,0,0
GMPR,Gmpr,0,-4,-4,1.359223,0,0
GMPR2,Gmpr2,12,-2,10,0,0,0
GMPS,Gmps,4,-6,-2,3.737864,0,0
GNA11,Gna11,7,-1,6,3.126214,0,0
GNA12,Gna12,7,-6,1,3.815534,0,0
GNA13,Gna13,4,-2,2,10.165049,0,0
GNA14,Gna14,-1,-4,-5,0,0,0
GNA15,Gna15,22,-4,18,124.07767,5.541667,0
GNAI1,Gnai1,4,6,10,3.747573,0,0
GNAI2,Gnai2,6,-4,2,10.951456,0,0
GNAI3,Gnai3,2,-7,-5,2.330097,0,0
GNAL,Gnal,7,-7,0,20.087379,0,0
GNAO1,Gnao1,6,-4,2,0,0,0
GNAQ,Gnaq,8,4,12,3.582524,0,0
GNAS,Gnas,9,1,10,17.23301,0,0
GNAT1,Gnat1,5,10,15,0,0,0
GNAT2,Gnat2,-3,-2,-5,30.456311,0,0
GNAT3,Gnat3,-2,-3,-5,0,0,0
GNAZ,Gnaz,6,-1,5,8.417476,0,0
GNB1,Gnb1,10,-3,7,4.485437,0,0
GNB1L,Gnb1l,16,-13,3,4.456311,0,0
GNB2,Gnb2,13,0,13,23.126214,0,0
GNB3,Gnb3,12,-14,-2,9.466019,0,0
GNB4,Gnb4,6,-10,-4,14.359223,0,0
GNB5,Gnb5,8,1,9,5.592233,0,0
GNE,Gne,6,-1,5,0.84466,0,0
GNG10,Gng10,2,-1,1,2.815534,0,0
GNG11,Gng11,-3,0,-3,1.495146,0,0
GNG12,Gng12,8,4,12,10.038835,0,0
GNG13,Gng13,3,-19,-16,0,0,0
GNG2,Gng2,3,-4,-1,1.300971,0,0
GNG3,Gng3,13,-7,6,54.466019,0,0
GNG4,Gng4,2,4,6,0,0,0
GNG5,Gng5,7,0,7,5.864078,0,0
GNG7,Gng7,6,-3,3,2.368932,0,0
GNG8,Gng8,6,2,8,0,0,0
GNGT1,Gngt1,2,-10,-8,2.145631,0,0
GNGT2,Gngt2,14,-2,12,0,0,0
GNL1,Gnl1,0,-2,-2,6.864078,0,0
GNL2,Gnl2,1,-4,-3,11.718447,0,0
GNL3,Gnl3,-2,-4,-6,16.592233,0,0
GNL3L,Gnl3l,7,3,10,2.631068,0,0
GNMT,Gnmt,9,2,11,0,0,0
GNPAT,Gnpat,5,-5,0,10.757282,6.041667,0
GNPDA1,Gnpda1,7,-3,4,9.048544,0,0
GNPDA2,Gnpda2,7,-7,0,1.097087,0,0
GNPNAT1,Gnpnat1,4,-3,1,13.427184,0,0
GNPTAB,Gnptab,0,-9,-9,6.223301,0,0
GNPTG,Gnptg,5,-3,2,9.339806,0,0
GNRH1,Gnrh1,12,2,14,0,0,0
GNRHR,Gnrhr,-1,0,-1,0,0,0
GNS,Gns,7,1,8,2.368932,0,0
GOLGA1,Golga1,5,-1,4,18.31068,0,0
GOLGA2,Golga2,3,-2,1,16.864078,0,0
GOLGA3,Golga3,6,-4,2,13.669903,0,0
GOLGA4,Golga4,7,0,7,5.262136,0,0
GOLGA5,Golga5,2,-4,-2,18.747573,0,0
GOLGA7,Golga7,8,-3,5,5.728155,0,0
GOLGA7B,Golga7b,3,-12,-9,0,0,0
GOLGB1,Golgb1,12,-4,8,18.553398,0,0
GOLIM4,Golim4,4,-2,2,6.825243,0,0
GOLM1,Golm1,6,-3,3,23.669903,0,0
GOLM2,Golm2,4,2,6,0,0,0
GOLPH3,Golph3,9,0,9,7.398058,0,0
GOLPH3L,Golph3l,10,-2,8,8.592233,0,0
GOLT1A,Golt1a,11,8,19,0,0,0
GOLT1B,Golt1b,7,0,7,0,0,0
GON4L,Gon4l,7,-3,4,0,0,0
GON7,Gon7,6,-1,5,44.990291,0,0
GOPC,Gopc,4,-8,-4,8.776699,0,0
GORAB,Gorab,3,0,3,3.029126,0,0
GORASP1,Gorasp1,11,-4,7,12.203883,0,0
GORASP2,Gorasp2,2,-6,-4,23.271845,0,0
GOSR1,Gosr1,7,-3,4,0,0,0
GOSR2,Gosr2,13,-3,10,12.563107,0,0
GOT1,Got1,1,-3,-2,0.805825,0,0
GOT1L1,Got1l1,2,-5,-3,0,0,0
GOT2,Got2,7,2,9,14.84466,0,0
GP1BA,Gp1ba,-2,-7,-9,0,0,0
GP1BB,Gp1bb,-3,-8,-11,0,0,0
GP2,Gp2,6,0,6,0,0,0
GP5,Gp5,9,-3,6,0,0,0
GP6,Gp6,3,0,3,1.019417,0,0
GP9,Gp9,9,8,17,0,0,0
GPA33,Gpa33,57,-4,53,0,0,0
GPAA1,Gpaa1,10,-2,8,8.514563,0,0
GPALPP1,Gpalpp1,4,-2,2,1.427184,0,0
GPAM,Gpam,0,-4,-4,8.417476,0,0
GPANK1,Gpank1,9,-3,6,5.747573,0,0
GPAT2,Gpat2,-4,-7,-11,1.805825,0,0
GPAT3,Gpat3,9,-2,7,8.854369,0,0
GPAT4,Gpat4,0,-5,-5,2.815534,0,0
GPATCH1,Gpatch1,1,-7,-6,6.145631,0,0
GPATCH11,Gpatch11,5,-11,-6,4.796117,0,0
GPATCH2,Gpatch2,7,-7,0,1.893204,0,0
GPATCH2L,Gpatch2l,7,-3,4,1.359223,0,0
GPATCH3,Gpatch3,-7,-6,-13,2.669903,0,0
GPATCH4,Gpatch4,-1,-5,-6,0,0,0
GPATCH8,Gpatch8,-1,0,-1,9.097087,0,0
GPBAR1,Gpbar1,41,-2,39,0,0,0
GPBP1,Gpbp1,29,-1,28,183.485437,15.75,0
GPBP1L1,Gpbp1l1,5,-3,2,3.718447,0,0
GPC1,Gpc1,4,3,7,2.912621,0,0
GPC2,Gpc2,-7,-8,-15,2.815534,0,0
GPC3,Gpc3,2,8,10,0,0,0
GPC4,Gpc4,4,3,7,0.747573,0,0
GPC5,Gpc5,6,2,8,0,0,0
GPC6,Gpc6,3,0,3,3.990291,0,0
GPCPD1,Gpcpd1,-8,-11,-19,14.330097,0,0
GPD1,Gpd1,11,6,17,0,0,0
GPD1L,Gpd1l,-3,2,-1,6.76699,0,0
GPD2,Gpd2,4,-5,-1,8.242718,0,0
GPER1,Gper1,7,-4,3,1.796117,0,0
GPHA2,Gpha2,6,-10,-4,0,0,0
GPHB5,Gphb5,9,3,12,0,0,0
GPHN,Gphn,-2,-8,-10,6.213592,0,0
GPIHBP1,Gpihbp1,1,1,2,0,0,0
GPKOW,Gpkow,5,-2,3,0,0,0
GPLD1,Gpld1,3,0,3,0,0,0
GPM6A,Gpm6a,9,2,11,1.281553,0,0
GPM6B,Gpm6b,4,2,6,2.339806,0,0
GPN1,Gpn1,26,-2,24,130.640777,9.583333,0
GPN2,Gpn2,2,-2,0,3.679612,0,0
GPN3,Gpn3,5,-1,4,5.728155,0,0
GPNMB,Gpnmb,6,13,19,0,0,0
GPR101,Gpr101,3,0,3,0,0,0
GPR107,Gpr107,8,-5,3,24.786408,0,0
GPR108,Gpr108,8,-4,4,10.106796,0,0
GPR119,Gpr119,5,0,5,0,0,0
GPR12,Gpr12,2,2,4,0,0,0
GPR132,Gpr132,9,11,20,0,0,0
GPR135,Gpr135,1,-4,-3,4.048544,0,0
GPR137,Gpr137,9,-10,-1,60.854369,0,0
GPR137B,Gpr137b,11,-1,10,0,0,0
GPR137C,Gpr137c,14,3,17,3.61165,0,0
GPR139,Gpr139,0,-7,-7,0,0,0
GPR141,Gpr141,-3,1,-2,0,0,0
GPR142,Gpr142,5,-3,2,0,0,0
GPR143,Gpr143,1,-1,0,0,0,0
GPR146,Gpr146,-15,3,-12,10.631068,0,0
GPR149,Gpr149,0,0,0,0,0,0
GPR15,Gpr15,2,-4,-2,0,0,0
GPR150,Gpr150,-5,-1,-6,0,0,0
GPR151,Gpr151,4,1,5,0,0,0
GPR152,Gpr152,2,-1,1,0,0,0
GPR153,Gpr153,1,-1,0,1.07767,0,0
GPR155,Gpr155,0,-5,-5,1.427184,0,0
GPR156,Gpr156,6,-7,-1,3.165049,0,0
GPR157,Gpr157,3,-3,0,8.757282,0,0
GPR158,Gpr158,-3,-10,-13,0,0,0
GPR160,Gpr160,1,-5,-4,4.834951,0,0
GPR161,Gpr161,7,0,7,2.223301,0,0
GPR162,Gpr162,10,-20,-10,4.368932,0,0
GPR17,Gpr17,13,1,14,0,0,0
GPR171,Gpr171,2,3,5,0,0,0
GPR173,Gpr173,13,-5,8,0.883495,0,0
GPR174,Gpr174,1,2,3,0,0,0
GPR176,Gpr176,2,4,6,3.349515,0,0
GPR179,Gpr179,8,1,9,0,0,0
GPR18,Gpr18,1,-3,-2,0,0,0
GPR180,Gpr180,1,-3,-2,22.854369,0,0
GPR182,Gpr182,-4,-9,-13,0,0,0
GPR183,Gpr183,-14,-19,-33,0,0,0
GPR19,Gpr19,-8,-6,-14,0,0,0
GPR20,Gpr20,-2,-1,-3,0,0,0
GPR21,Gpr21,7,4,11,0,0,0
GPR22,Gpr22,-2,0,-2,0,0,0
GPR25,Gpr25,19,-1,18,2.019417,0,0
GPR26,Gpr26,-1,-5,-6,0,0,0
GPR27,Gpr27,4,2,6,0,0,0
GPR3,Gpr3,-21,10,-11,5.291262,0,0
GPR33,Gpr33,0,-2,-2,0,0,0
GPR34,Gpr34,1,-2,-1,0,0,0
GPR35,Gpr35,15,-3,12,0,0,0
GPR37,Gpr37,3,-5,-2,5.019417,0,0
GPR37L1,Gpr37l1,2,-3,-1,0,0,0
GPR39,Gpr39,-13,-6,-19,0,0,0
GPR4,Gpr4,9,1,10,0,0,0
GPR45,Gpr45,0,-1,-1,0,0,0
GPR50,Gpr50,27,-1,26,0,0,0
GPR52,Gpr52,-2,2,0,0,0,0
GPR55,Gpr55,2,3,5,9.718447,0,0
GPR6,Gpr6,1,5,6,26.23301,0,0
GPR61,Gpr61,1,-10,-9,0,0,0
GPR62,Gpr62,4,4,8,0,0,0
GPR63,Gpr63,2,-6,-4,2.417476,0,0
GPR65,Gpr65,-1,-8,-9,0,0,0
GPR68,Gpr68,-18,0,-18,0.893204,0,0
GPR75,Gpr75,11,18,29,0,0,0
GPR82,Gpr82,13,-1,12,0,0,0
GPR83,Gpr83,20,8,28,0,0,0
GPR84,Gpr84,25,6,31,0,0,0
GPR85,Gpr85,1,-6,-5,0,0,0
GPR87,Gpr87,-2,4,2,0,0,0
GPR88,Gpr88,-4,2,-2,0,0,0
GPRASP1,Gprasp1,2,3,5,6.650485,0,0
GPRASP2,Gprasp2,5,3,8,58.203883,0,0
GPRC5A,Gprc5a,8,9,17,7.048544,0,0
GPRC5B,Gprc5b,23,2,25,4.252427,0,0
GPRC5C,Gprc5c,0,7,7,4.067961,0,0
GPRC5D,Gprc5d,27,2,29,0,0,0
GPRC6A,Gprc6a,7,-1,6,0,0,0
GPRIN1,Gprin1,2,3,5,2.145631,0,0
GPRIN2,Gprin2,-5,-9,-14,0,0,0
GPRIN3,Gprin3,2,-3,-1,0.825243,0,0
GPS1,Gps1,6,-1,5,2.213592,0,0
GPS2,Gps2,2,-6,-4,4.650485,0,0
GPSM1,Gpsm1,3,-7,-4,1.660194,0,0
GPSM2,Gpsm2,6,-9,-3,7.475728,0,0
GPSM3,Gpsm3,-7,-7,-14,11.621359,0,0
GPT,Gpt,16,1,17,8.650485,0,0
GPT2,Gpt2,4,8,12,2.747573,0,0
GPX1,Gpx1,10,3,13,11.174757,0,0
GPX2,Gpx2,6,-5,1,0,0,0
GPX3,Gpx3,13,3,16,5.116505,0,0
GPX4,Gpx4,9,3,12,2.339806,0,0
GPX5,Gpx5,-3,1,-2,0,0,0
GPX6,Gpx6,-3,0,-3,0,0,0
GPX7,Gpx7,5,-3,2,0,0,0
GPX8,Gpx8,7,-6,1,0,0,0
GRAMD1A,Gramd1a,3,-7,-4,5.495146,0,0
GRAMD1B,Gramd1b,1,-1,0,3.572816,0,0
GRAMD1C,Gramd1c,5,-7,-2,9.990291,0,0
GRAMD4,Gramd4,5,-3,2,0,0,0
GRAP,Grap,-1,-5,-6,9.087379,0,0
GRAP2,Grap2,-3,1,-2,0,0,0
GRB10,Grb10,11,-3,8,10.349515,0,0
GRB14,Grb14,10,8,18,5.601942,0,0
GRB2,Grb2,7,-6,1,9.805825,0,0
GRB7,Grb7,6,-2,4,0,0,0
GREB1,Greb1,3,3,6,1.359223,0,0
GREB1L,Greb1l,2,-4,-2,4.019417,0,0
GREM1,Grem1,5,-1,4,0,0,0
GREM2,Grem2,-1,6,5,0,0,0
GRHL1,Grhl1,26,3,29,19.980583,0,0
GRHL2,Grhl2,1,0,1,5.281553,0,0
GRHL3,Grhl3,-7,0,-7,1.184466,0,0
GRHPR,Grhpr,7,3,10,0,0,0
GRIA1,Gria1,9,0,9,0,0,0
GRIA2,Gria2,15,2,17,0,0,0
GRIA3,Gria3,18,-1,17,0,0,0
GRIA4,Gria4,6,-3,3,0,0,0
GRID1,Grid1,8,-8,0,0,0,0
GRID2,Grid2,3,-1,2,10.504854,0,0
GRID2IP,Grid2ip,1,-1,0,0,0,0
GRIFIN,Grifin,6,3,9,1.660194,0,0
GRIK1,Grik1,1,-6,-5,0,0,0
GRIK2,Grik2,7,-6,1,5.15534,0,0
GRIK3,Grik3,1,-3,-2,0,0,0
GRIK4,Grik4,3,0,3,1.563107,0,0
GRIK5,Grik5,11,-3,8,0,0,0
GRIN1,Grin1,1,2,3,0,0,0
GRIN2A,Grin2a,8,-1,7,0,0,0
GRIN2B,Grin2b,10,3,13,0,0,0
GRIN2C,Grin2c,4,1,5,0,0,0
GRIN2D,Grin2d,-1,-13,-14,2.417476,0,0
GRIN3A,Grin3a,1,-3,-2,0,0,0
GRIN3B,Grin3b,0,-14,-14,45.786408,20.583333,0
GRINA,Grina,5,-4,1,3.834951,0,0
GRIP1,Grip1,34,-2,32,7.048544,0,0
GRIP2,Grip2,2,-5,-3,0,0,0
GRIPAP1,Gripap1,12,-4,8,0,0,0
GRK1,Grk1,2,-7,-5,0,0,0
GRK2,Grk2,7,-3,4,56.475728,0,0
GRK3,Grk3,4,-6,-2,0,0,0
GRK4,Grk4,7,-6,1,15.271845,0,0
GRK5,Grk5,1,-1,0,3.84466,0,0
GRK6,Grk6,10,-2,8,0.990291,0,0
GRM1,Grm1,-1,-13,-14,0.951456,0,0
GRM2,Grm2,13,1,14,0,0,0
GRM3,Grm3,-6,-2,-8,0,0,0
GRM4,Grm4,6,3,9,0,0,0
GRM5,Grm5,-7,-5,-12,0,0,0
GRM6,Grm6,5,-3,2,0,0,0
GRM7,Grm7,-5,1,-4,0,0,0
GRM8,Grm8,0,-3,-3,1.116505,0,0
GRN,Grn,9,8,17,1.572816,0,0
GRP,Grp,3,9,12,0,0,0
GRPEL1,Grpel1,3,-3,0,2.504854,0,0
GRPEL2,Grpel2,7,-6,1,21.368932,0,0
GRPR,Grpr,-11,-3,-14,0,0,0
GRSF1,Grsf1,10,1,11,12.446602,0,0
GRTP1,Grtp1,7,-13,-6,32.61165,0,0
GRWD1,Grwd1,-6,-3,-9,1.31068,0,0
GRXCR1,Grxcr1,-1,-5,-6,0,0,0
GRXCR2,Grxcr2,-6,0,-6,0,0,0
GSAP,Gsap,-4,-3,-7,4.135922,0,0
GSC,Gsc,-1,-10,-11,1.165049,0,0
GSC2,Gsc2,6,0,6,0,0,0
GSDMA,Gsdma,2,-4,-2,0,0,0
GSDMC,Gsdmc,4,-1,3,0,0,0
GSDMD,Gsdmd,0,-5,-5,2.271845,0,0
GSDME,Gsdme,1,-4,-3,4.572816,0,0
GSE1,Gse1,9,4,13,0,0,0
GSG1,Gsg1,2,2,4,146.485437,0,0
GSG1L,Gsg1l,-2,-1,-3,0,0,0
GSG1L2,Gsg1l2,-3,-2,-5,0,0,0
GSK3A,Gsk3a,8,-2,6,7.067961,0,0
GSK3B,Gsk3b,5,0,5,25.417476,10.458333,0
GSKIP,Gskip,2,-2,0,8.116505,0,0
GSN,Gsn,12,-2,10,7.165049,0,0
GSPT1,Gspt1,5,0,5,11.737864,0,0
GSPT2,Gspt2,-6,0,-6,1.165049,0,0
GSR,Gsr,6,-3,3,10.669903,0,0
GSS,Gss,7,-4,3,7.68932,0,0
GSTA1,Gsta1,-2,4,2,0,0,0
GSTA2,Gsta2,4,13,17,0,0,0
GSTA3,Gsta3,-4,-7,-11,0,0,0
GSTA4,Gsta4,7,2,9,86.902913,10.25,0
GSTA5,Gsta5,1,2,3,0,0,0
GSTCD,Gstcd,7,-5,2,13.980583,0,0
GSTK1,Gstk1,4,3,7,6,0,0
GSTM1,Gstm1,3,-2,1,0,0,0
GSTM2,Gstm2,11,2,13,0,0,0
GSTM3,Gstm3,7,9,16,0,0,0
GSTM4,Gstm4,4,2,6,0,0,0
GSTM5,Gstm5,9,-14,-5,0,0,0
GSTO1,Gsto1,6,-6,0,2.553398,0,0
GSTO2,Gsto2,9,-10,-1,2.300971,0,0
GSTP1,Gstp1,11,4,15,11.106796,0,0
GSTT2,Gstt2,-1,-7,-8,0,0,0
GSTT4,Gstt4,14,10,24,0,0,0
GSTZ1,Gstz1,6,-3,3,53.650485,4.916667,0
GSX1,Gsx1,5,2,7,0,0,0
GSX2,Gsx2,8,1,9,0,0,0
GTDC1,Gtdc1,4,-7,-3,16.07767,0,0
GTF2A1,Gtf2a1,-3,0,-3,14.145631,0,0
GTF2A1L,Gtf2a1l,28,5,33,0,0,0
GTF2A2,Gtf2a2,2,0,2,1.941748,0,0
GTF2B,Gtf2b,-2,-10,-12,2.31068,0,0
GTF2E1,Gtf2e1,3,-4,-1,10.699029,0,0
GTF2E2,Gtf2e2,9,-5,4,22.145631,0,0
GTF2F1,Gtf2f1,6,-1,5,36.601942,0,0
GTF2F2,Gtf2f2,5,-3,2,3.592233,0,0
GTF2H1,Gtf2h1,8,0,8,6.68932,0,0
GTF2H2,Gtf2h2,1,-12,-11,27.029126,0,0
GTF2H3,Gtf2h3,2,-4,-2,3.679612,0,0
GTF2H4,Gtf2h4,1,-8,-7,12.058252,0,0
GTF2H5,Gtf2h5,5,-7,-2,2.970874,0,0
GTF2I,Gtf2i,8,-6,2,10.058252,0,0
GTF2IRD1,Gtf2ird1,6,-1,5,0.883495,0,0
GTF2IRD2,Gtf2ird2,9,-4,5,35.407767,0,0
GTF3A,Gtf3a,2,0,2,8.728155,0,0
GTF3C1,Gtf3c1,9,-7,2,53.92233,0,0
GTF3C2,Gtf3c2,0,-3,-3,8.786408,0,0
GTF3C3,Gtf3c3,16,-3,13,261.262136,41.166667,257
GTF3C4,Gtf3c4,7,-5,2,15.990291,0,0
GTF3C5,Gtf3c5,5,-10,-5,8.737864,0,0
GTF3C6,Gtf3c6,0,-5,-5,13.223301,0,0
GTPBP1,Gtpbp1,4,-6,-2,44.106796,6.791667,0
GTPBP10,Gtpbp10,6,-3,3,7.427184,0,0
GTPBP2,Gtpbp2,5,-7,-2,6.281553,0,0
GTPBP3,Gtpbp3,0,-4,-4,20.417476,0,0
GTPBP4,Gtpbp4,2,-2,0,2.417476,0,0
GTPBP6,Gtpbp6,3,-4,-1,9.145631,0,0
GTPBP8,Gtpbp8,6,-5,1,2.368932,0,0
GTSE1,Gtse1,-1,-9,-10,0.68932,0,0
GTSF1,Gtsf1,-3,-1,-4,0,0,0
GTSF1L,Gtsf1l,17,-8,9,1.126214,0,0
GUCA1A,Guca1a,9,-6,3,3.407767,0,0
GUCA1B,Guca1b,33,11,44,0,0,0
GUCA2A,Guca2a,28,-3,25,0,0,0
GUCA2B,Guca2b,4,5,9,0,0,0
GUCD1,Gucd1,5,-6,-1,12.203883,0,0
GUCY1A1,Gucy1a1,2,0,2,2.68932,0,0
GUCY1A2,Gucy1a2,2,-4,-2,3.990291,0,0
GUCY1B1,Gucy1b1,4,4,8,1.320388,0,0
GUCY2C,Gucy2c,6,1,7,0,0,0
GUCY2D,Gucy2d,-2,0,-2,0,0,0
GUCY2F,Gucy2f,3,0,3,0,0,0
GUF1,Guf1,4,-8,-4,0,0,0
GUK1,Guk1,5,-15,-10,11.825243,0,0
GULP1,Gulp1,-2,-5,-7,1.242718,0,0
GUSB,Gusb,4,-1,3,0,0,0
GXYLT1,Gxylt1,4,-2,2,10.873786,0,0
GXYLT2,Gxylt2,9,-4,5,12.145631,0,0
GYPA,Gypa,4,6,10,0,0,0
GYPC,Gypc,0,-1,-1,0,0,0
GYS1,Gys1,13,1,14,32.194175,0,0
GYS2,Gys2,20,-21,-1,0,0,0
GZF1,Gzf1,7,-1,6,7.932039,0,0
GZMA,Gzma,5,-9,-4,0,0,0
GZMB,Gzmb,7,-4,3,0,0,0
GZMK,Gzmk,-1,1,0,0,0,0
GZMM,Gzmm,57,-9,48,1.242718,0,0
H2AB1,H2ab1,20,-8,12,9.165049,0,0
H2AB2,H2ab2,8,-1,7,9.165049,0,0
H2AC1,H2ac1,40,-11,29,0,0,0
H2AC11,H2ac11,5,-20,-15,4.106796,0,0
H2AC12,H2ac12,16,6,22,6.776699,0,0
H2AC13,H2ac13,-5,6,1,9.291262,0,0
H2AC15,H2ac15,12,12,24,12.009709,0,0
H2AC18,H2ac18,-12,-5,-17,19.757282,0,0
H2AC19,H2ac19,22,4,26,19.757282,0,0
H2AC20,H2ac20,-8,-7,-15,5.970874,0,0
H2AC21,H2ac21,-20,-14,-34,5.970874,0,0
H2AC4,H2ac4,2,-6,-4,5.660194,0,0
H2AC6,H2ac6,-2,-1,-3,8,0,0
H2AC7,H2ac7,-2,3,1,2.466019,0,0
H2AC8,H2ac8,36,-9,27,0,0,0
H2AJ,H2aj,3,-1,2,2.631068,0,0
H2AP,H2ap,0,2,2,0,0,0
H2AX,H2ax,2,-2,0,45.553398,0,0
H2AZ1,H2az1,5,-2,3,5,0,0
H2AZ2,H2az2,8,-7,1,6.68932,0,0
H2BC1,H2bc1,42,2,44,0,0,0
H2BC11,H2bc11,5,-5,0,4.106796,0,0
H2BC12,H2bc12,5,4,9,6.776699,0,0
H2BC13,H2bc13,-3,-10,-13,9.291262,0,0
H2BC14,H2bc14,0,1,1,7.902913,0,0
H2BC15,H2bc15,1,8,9,12.009709,0,0
H2BC18,H2bc18,9,4,13,7.68932,0,0
H2BC21,H2bc21,2,-6,-4,5.970874,0,0
H2BC3,H2bc3,7,-4,3,5.009709,0,0
H2BC4,H2bc4,-6,-1,-7,8,0,0
H2BC6,H2bc6,12,0,12,1.475728,0,0
H2BC7,H2bc7,0,7,7,2.466019,0,0
H2BC8,H2bc8,9,0,9,0,0,0
H2BC9,H2bc9,-1,-7,-8,1.601942,0,0
H2BW2,H2bw2,0,9,9,0,0,0
H3C1,H3c1,-16,2,-14,2.601942,0,0
H3C10,H3c10,8,-13,-5,10.621359,0,0
H3C11,H3c11,-2,2,0,16.76699,0,0
H3C13,H3c13,-13,-3,-16,7.68932,0,0
H3C14,H3c14,11,-1,10,19.757282,0,0
H3C2,H3c2,-10,13,3,7.116505,0,0
H3C3,H3c3,1,4,5,5.009709,0,0
H3C4,H3c4,-8,0,-8,2.466019,0,0
H3C6,H3c6,-8,-3,-11,0,0,0
H3C7,H3c7,-14,-6,-20,1.601942,0,0
H3C8,H3c8,31,16,47,4.252427,0,0
H4C1,H4c1,-10,-1,-11,2.601942,0,0
H4C11,H4c11,14,1,15,16.485437,0,0
H4C12,H4c12,1,10,11,14.466019,0,0
H4C14,H4c14,9,6,15,15.495146,0,0
H4C2,H4c2,11,8,19,7.116505,0,0
H4C3,H4c3,12,7,19,3.407767,0,0
H4C4,H4c4,23,7,30,1.980583,0,0
H4C6,H4c6,8,8,16,0,0,0
H4C8,H4c8,6,4,10,30.543689,0,0
H4C9,H4c9,25,0,25,6.970874,0,0
H6PD,H6pd,4,2,6,8.048544,0,0
HAAO,Haao,2,7,9,10.718447,0,0
HABP2,Habp2,1,8,9,0,0,0
HABP4,Habp4,3,-2,1,4.543689,0,0
HACD1,Hacd1,-4,-2,-6,1.07767,0,0
HACD2,Hacd2,4,-10,-6,10.893204,0,0
HACD3,Hacd3,7,-5,2,24.213592,0,0
HACD4,Hacd4,0,-5,-5,44.31068,0,0
HACE1,Hace1,7,-3,4,7.980583,0,0
HACL1,Hacl1,2,-3,-1,3.893204,0,0
HADH,Hadh,2,0,2,3.572816,0,0
HADHA,Hadha,4,-2,2,6.805825,0,0
HADHB,Hadhb,10,-7,3,6.805825,0,0
HAGH,Hagh,8,-7,1,4.796117,0,0
HAGHL,Haghl,7,-8,-1,1.194175,0,0
HAL,Hal,14,2,16,0,0,0
HAMP,Hamp,16,10,26,0,0,0
HAND1,Hand1,7,-4,3,2.213592,0,0
HAND2,Hand2,6,-4,2,0,0,0
HAO1,Hao1,0,-15,-15,0,0,0
HAO2,Hao2,0,3,3,155,0,0
HAP1,Hap1,6,-6,0,0,0,0
HAPLN1,Hapln1,-5,-5,-10,3.174757,0,0
HAPLN2,Hapln2,1,-4,-3,0,0,0
HAPLN3,Hapln3,12,4,16,0,0,0
HAPLN4,Hapln4,5,4,9,4.15534,0,0
HARBI1,Harbi1,2,-2,0,5.165049,0,0
HARS2,Hars2,2,-3,-1,3.990291,0,0
HAS1,Has1,0,7,7,0,0,0
HAS2,Has2,-24,-8,-32,0,0,0
HAS3,Has3,0,-7,-7,1.854369,0,0
HASPIN,Haspin,-9,-18,-27,11.223301,0,0
HAT1,Hat1,7,1,8,13.631068,0,0
HAUS1,Haus1,-1,-17,-18,0,0,0
HAUS2,Haus2,0,3,3,9.407767,0,0
HAUS3,Haus3,2,-10,-8,2.893204,0,0
HAUS4,Haus4,15,-4,11,9.398058,0,0
HAUS5,Haus5,4,-6,-2,2.184466,0,0
HAUS6,Haus6,4,1,5,2.058252,0,0
HAUS7,Haus7,-7,-3,-10,0.980583,0,0
HAUS8,Haus8,-9,-6,-15,13.097087,0,0
HAVCR1,Havcr1,11,14,25,0,0,0
HAVCR2,Havcr2,8,-8,0,0,0,0
HAX1,Hax1,5,1,6,1.359223,0,0
HBEGF,Hbegf,9,0,9,9.601942,0,0
HBP1,Hbp1,5,-6,-1,7.300971,0,0
HBS1L,Hbs1l,8,-1,7,13.854369,0,0
HCAR1,Hcar1,0,-6,-6,0,0,0
HCAR2,Hcar2,5,-4,1,0,0,0
HCCS,Hccs,3,3,6,3.339806,0,0
HCFC1,Hcfc1,8,-1,7,3.349515,0,0
HCFC1R1,Hcfc1r1,2,3,5,3.669903,0,0
HCFC2,Hcfc2,-4,-4,-8,13.92233,0,0
HCK,Hck,0,-10,-10,0,0,0
HCLS1,Hcls1,-1,4,3,0,0,0
HCN1,Hcn1,1,-2,-1,0,0,0
HCN2,Hcn2,15,0,15,0,0,0
HCN3,Hcn3,4,-2,2,7.349515,0,0
HCN4,Hcn4,-1,4,3,0,0,0
HCRT,Hcrt,2,6,8,0,0,0
HCRTR1,Hcrtr1,1,-1,0,0,0,0
HCRTR2,Hcrtr2,6,0,6,0,0,0
HCST,Hcst,-14,-4,-18,43.68932,0,0
HDAC1,Hdac1,8,-9,-1,6.320388,0,0
HDAC10,Hdac10,1,-1,0,0,0,0
HDAC11,Hdac11,2,-5,-3,0.912621,0,0
HDAC2,Hdac2,6,-4,2,13.38835,0,0
HDAC3,Hdac3,8,-6,2,0,0,0
HDAC4,Hdac4,-3,3,0,2.213592,0,0
HDAC5,Hdac5,9,-2,7,2.84466,0,0
HDAC6,Hdac6,6,-5,1,2.805825,0,0
HDAC7,Hdac7,11,-3,8,10.271845,0,0
HDAC8,Hdac8,5,2,7,0,0,0
HDAC9,Hdac9,5,0,5,2.145631,0,0
HDC,Hdc,5,0,5,0,0,0
HDDC2,Hddc2,2,-6,-4,9.757282,0,0
HDDC3,Hddc3,6,-3,3,2.553398,0,0
HDGF,Hdgf,9,-5,4,21.058252,0,0
HDGFL1,Hdgfl1,3,-5,-2,0,0,0
HDGFL2,Hdgfl2,6,-2,4,3.106796,0,0
HDGFL3,Hdgfl3,4,-6,-2,8.563107,0,0
HDHD2,Hdhd2,6,-10,-4,8.427184,0,0
HDHD3,Hdhd3,-2,-26,-28,2.941748,0,0
HDHD5,Hdhd5,4,-6,-2,2.718447,0,0
HDLBP,Hdlbp,10,-5,5,6.38835,0,0
HDX,Hdx,5,0,5,0,0,0
HEATR1,Heatr1,2,-10,-8,0,0,0
HEATR3,Heatr3,-4,-3,-7,2.660194,0,0
HEATR4,Heatr4,15,-6,9,0,0,0
HEATR5A,Heatr5a,3,-2,1,18.126214,0,156
HEATR5B,Heatr5b,2,1,3,4.796117,0,0
HEATR6,Heatr6,-5,-2,-7,41.427184,0,0
HEATR9,Heatr9,3,-7,-4,0,0,0
HEBP1,Hebp1,1,-8,-7,3.825243,0,0
HEBP2,Hebp2,-1,5,4,5.825243,0,0
HECA,Heca,7,-1,6,12.223301,0,0
HECTD1,Hectd1,5,-3,2,14.650485,0,0
HECTD2,Hectd2,3,0,3,2.456311,0,0
HECTD3,Hectd3,6,0,6,3.533981,0,0
HECTD4,Hectd4,9,-6,3,3.23301,0,0
HECW1,Hecw1,0,-4,-4,6.475728,0,0
HECW2,Hecw2,3,6,9,2.097087,0,0
HEG1,Heg1,4,1,5,4.68932,0,0
HELB,Helb,1,0,1,0,0,0
HELLS,Hells,3,-5,-2,3.194175,0,0
HELQ,Helq,3,-1,2,8.699029,0,0
HELT,Helt,-2,-2,-4,0,0,0
HELZ,Helz,9,-2,7,2.854369,0,0
HELZ2,Helz2,0,-2,-2,17.291262,0,0
HEMGN,Hemgn,10,-9,1,0,0,0
HEMK1,Hemk1,8,-5,3,12.563107,0,0
HENMT1,Henmt1,0,-11,-11,0,0,0
HEPACAM,Hepacam,8,-4,4,0,0,0
HEPACAM2,Hepacam2,3,-22,-19,2.262136,0,0
HEPH,Heph,-1,3,2,0,0,0
HEPHL1,Hephl1,4,-4,0,0,0,0
HERC1,Herc1,4,-1,3,2.106796,0,0
HERC2,Herc2,8,-8,0,9.864078,0,0
HERC3,Herc3,-2,-5,-7,25.223301,0,0
HERC4,Herc4,6,-2,4,28.174757,2.875,0
HERC6,Herc6,0,7,7,1.893204,0,0
HERPUD1,Herpud1,29,7,36,2.980583,0,0
HERPUD2,Herpud2,3,0,3,6.834951,0,0
HES1,Hes1,33,3,36,14.456311,0,0
HES2,Hes2,3,1,4,0,0,0
HES3,Hes3,15,-6,9,5.330097,0,0
HES5,Hes5,20,-3,17,6.07767,0,0
HES6,Hes6,5,-1,4,0,0,0
HES7,Hes7,8,1,9,20.485437,0,0
HESX1,Hesx1,-4,9,5,6.902913,0,0
HEXA,Hexa,8,-1,7,2.786408,0,0
HEXB,Hexb,3,1,4,12.07767,0,0
HEXIM1,Hexim1,13,-6,7,11.621359,0,0
HEXIM2,Hexim2,5,-1,4,18.38835,0,0
HEY1,Hey1,51,10,61,24.242718,0,0
HEY2,Hey2,8,-5,3,3.407767,0,0
HEYL,Heyl,1,3,4,0,0,0
HFE,Hfe,-1,3,2,0,0,0
HFM1,Hfm1,-11,4,-7,0,0,0
HGD,Hgd,29,5,34,1.349515,0,0
HGF,Hgf,-6,-1,-7,0,0,0
HGFAC,Hgfac,7,1,8,17.417476,0,0
HGH1,Hgh1,-2,-6,-8,4.446602,0,0
HGS,Hgs,5,-6,-1,4.213592,0,0
HGSNAT,Hgsnat,4,-1,3,2.048544,0,0
HHAT,Hhat,6,-6,0,3.097087,0,0
HHATL,Hhatl,22,14,36,0,0,0
HHEX,Hhex,9,1,10,1.067961,0,0
HHIP,Hhip,3,2,5,0,0,0
HHIPL1,Hhipl1,4,-3,1,9.436893,0,0
HHIPL2,Hhipl2,20,12,32,0,0,0
HHLA1,Hhla1,0,-4,-4,0,0,0
HIBADH,Hibadh,3,-6,-3,7.650485,0,0
HIBCH,Hibch,59,-11,48,105.349515,12.791667,0
HIC1,Hic1,28,5,33,30.252427,0,0
HIC2,Hic2,-4,-9,-13,1.203883,0,0
HID1,Hid1,-1,5,4,4.126214,0,0
HIF1A,Hif1a,5,0,5,9.543689,0,0
HIF1AN,Hif1an,7,-6,1,4.165049,0,0
HIF3A,Hif3a,4,3,7,3.262136,0,0
HIGD1A,Higd1a,6,-5,1,1.747573,0,0
HIGD1B,Higd1b,14,-2,12,4.951456,0,0
HIGD1C,Higd1c,14,0,14,0,0,0
HIGD2A,Higd2a,4,3,7,2.514563,0,0
HIKESHI,Hikeshi,24,3,27,114.718447,0,144
HILPDA,Hilpda,-22,-13,-35,7.398058,0,0
HINFP,Hinfp,11,-5,6,14.601942,0,0
HINT1,Hint1,7,-4,3,3.417476,0,0
HINT2,Hint2,-2,-8,-10,6.932039,0,0
HINT3,Hint3,2,-3,-1,9.68932,0,0
HIP1,Hip1,9,-1,8,3.718447,0,0
HIP1R,Hip1r,7,-1,6,1.048544,0,0
HIPK1,Hipk1,11,-5,6,9.38835,0,0
HIPK2,Hipk2,8,-1,7,12.300971,0,0
HIPK3,Hipk3,7,0,7,5.737864,0,0
HIPK4,Hipk4,22,-9,13,0,0,0
HIRA,Hira,2,-6,-4,27.029126,0,0
HIRIP3,Hirip3,5,-10,-5,6.757282,0,0
HIVEP1,Hivep1,6,-2,4,4.941748,0,0
HIVEP2,Hivep2,5,6,11,8.533981,0,0
HIVEP3,Hivep3,7,-7,0,2.669903,0,0
HJURP,Hjurp,-18,-9,-27,1.203883,0,0
HJV,Hjv,-2,-2,-4,0,0,0
HK1,Hk1,6,-6,0,10.07767,0,0
HK2,Hk2,-2,-3,-5,5.84466,0,0
HK3,Hk3,21,-3,18,0,0,0
HKDC1,Hkdc1,0,8,8,8.23301,0,0
HLCS,Hlcs,3,1,4,10.805825,0,0
HLF,Hlf,1,2,3,3.679612,0,0
HLTF,Hltf,-3,-6,-9,10.747573,0,0
HLX,Hlx,8,-2,6,1.68932,0,0
HMBOX1,Hmbox1,8,-4,4,0,0,0
HMBS,Hmbs,8,-4,4,38.213592,0,0
HMCES,Hmces,9,-6,3,7.087379,0,0
HMCN1,Hmcn1,6,0,6,0,0,0
HMCN2,Hmcn2,2,-4,-2,1.407767,0,0
HMG20A,Hmg20a,0,-4,-4,2.368932,0,0
HMG20B,Hmg20b,4,-2,2,59.834951,0,0
HMGA1,Hmga1,8,-1,7,2.669903,0,0
HMGA2,Hmga2,1,-7,-6,15.699029,0,0
HMGB1,Hmgb1,6,-6,0,808.38835,308.458333,933
HMGB2,Hmgb2,4,-2,2,1.776699,0,0
HMGB3,Hmgb3,5,-4,1,1.038835,0,0
HMGB4,Hmgb4,-1,-3,-4,0,0,0
HMGCL,Hmgcl,2,-1,1,9.533981,0,0
HMGCLL1,Hmgcll1,-5,-6,-11,0,0,0
HMGCR,Hmgcr,4,-5,-1,25.38835,0,0
HMGCS1,Hmgcs1,6,-5,1,5.106796,0,0
HMGCS2,Hmgcs2,-2,15,13,0,0,0
HMGN1,Hmgn1,9,1,10,7.495146,0,0
HMGN2,Hmgn2,6,-8,-2,48.436893,0,0
HMGN3,Hmgn3,9,-9,0,4.582524,0,0
HMGN5,Hmgn5,5,-3,2,0,0,0
HMGXB3,Hmgxb3,-2,-4,-6,21.446602,0,0
HMGXB4,Hmgxb4,-14,-5,-19,0,0,0
HMMR,Hmmr,5,-6,-1,3.776699,0,0
HMOX1,Hmox1,30,14,44,41.271845,0,0
HMOX2,Hmox2,3,-5,-2,4.038835,0,0
HMX1,Hmx1,1,-3,-2,0,0,0
HMX2,Hmx2,-2,-3,-5,0,0,0
HMX3,Hmx3,0,3,3,0,0,0
HNF1A,Hnf1a,3,-1,2,0,0,0
HNF1B,Hnf1b,-1,-6,-7,2.592233,0,0
HNF4A,Hnf4a,-9,4,-5,0,0,0
HNF4G,Hnf4g,-2,3,1,8.640777,0,0
HNMT,Hnmt,12,2,14,31.223301,0,0
HNRNPA0,Hnrnpa0,6,0,6,0,0,0
HNRNPA1,Hnrnpa1,10,-6,4,1.038835,0,0
HNRNPA2B1,Hnrnpa2b1,10,-3,7,244.990291,170.833333,94
HNRNPA3,Hnrnpa3,6,-2,4,4.873786,0,0
HNRNPAB,Hnrnpab,6,2,8,2.349515,0,0
HNRNPC,Hnrnpc,10,-2,8,1.213592,0,0
HNRNPD,Hnrnpd,6,-5,1,10.009709,0,0
HNRNPDL,Hnrnpdl,8,-4,4,4.38835,0,0
HNRNPF,Hnrnpf,8,-1,7,46.475728,0,0
HNRNPH1,Hnrnph1,4,-5,-1,6.378641,0,0
HNRNPH2,Hnrnph2,6,-1,5,1.417476,0,0
HNRNPH3,Hnrnph3,9,-1,8,28.106796,0,0
HNRNPK,Hnrnpk,9,-2,7,10.699029,0,0
HNRNPL,Hnrnpl,9,-3,6,3.728155,0,0
HNRNPLL,Hnrnpll,4,-3,1,9.902913,0,0
HNRNPM,Hnrnpm,11,-3,8,6.92233,0,0
HNRNPR,Hnrnpr,6,-9,-3,11.601942,0,0
HNRNPU,Hnrnpu,7,-1,6,43.805825,0,0
HNRNPUL1,Hnrnpul1,5,0,5,3.466019,0,0
HNRNPUL2,Hnrnpul2,-1,-3,-4,7.262136,0,0
HOATZ,Hoatz,-2,-18,-20,0,0,0
HOGA1,Hoga1,0,1,1,0.980583,0,0
HOMER1,Homer1,3,-2,1,4.330097,0,0
HOMER2,Homer2,4,-1,3,1.757282,0,0
HOMER3,Homer3,8,0,8,3.398058,0,0
HOMEZ,Homez,-8,-18,-26,3.038835,0,0
HOOK1,Hook1,2,1,3,5.601942,0,0
HOOK2,Hook2,-3,-3,-6,5.941748,0,0
HOOK3,Hook3,5,-4,1,1.009709,0,0
HOPX,Hopx,13,1,14,17.932039,0,0
HORMAD1,Hormad1,-5,0,-5,0,0,0
HORMAD2,Hormad2,2,9,11,0,0,0
HOXA1,Hoxa1,8,4,12,4.718447,0,0
HOXA10,Hoxa10,-1,2,1,0,0,0
HOXA11,Hoxa11,-5,-3,-8,0,0,0
HOXA13,Hoxa13,-2,-3,-5,3.553398,0,0
HOXA2,Hoxa2,7,-5,2,3.07767,0,0
HOXA3,Hoxa3,-6,-5,-11,0,0,0
HOXA4,Hoxa4,21,3,24,1.737864,0,0
HOXA5,Hoxa5,8,2,10,0,0,0
HOXA6,Hoxa6,3,-9,-6,0,0,0
HOXA7,Hoxa7,4,-2,2,2.631068,0,0
HOXA9,Hoxa9,-3,-2,-5,2.631068,0,0
HOXB1,Hoxb1,12,0,12,21.213592,0,0
HOXB13,Hoxb13,2,2,4,0,0,0
HOXB2,Hoxb2,-9,5,-4,2.582524,0,0
HOXB3,Hoxb3,-1,-1,-2,0,0,0
HOXB4,Hoxb4,3,9,12,0,0,0
HOXB5,Hoxb5,10,3,13,0,0,0
HOXB6,Hoxb6,5,2,7,2.23301,0,0
HOXB7,Hoxb7,-6,10,4,0,0,0
HOXB8,Hoxb8,0,9,9,0,0,0
HOXB9,Hoxb9,9,6,15,2.135922,0,0
HOXC10,Hoxc10,17,3,20,0,0,0
HOXC11,Hoxc11,6,-2,4,3.563107,0,0
HOXC12,Hoxc12,-2,-1,-3,0,0,0
HOXC13,Hoxc13,13,-1,12,1.029126,0,0
HOXC4,Hoxc4,-14,-1,-15,0,0,0
HOXC5,Hoxc5,-29,-6,-35,0,0,0
HOXC6,Hoxc6,1,6,7,0,0,0
HOXC8,Hoxc8,2,4,6,0,0,0
HOXC9,Hoxc9,21,2,23,0,0,0
HOXD1,Hoxd1,33,7,40,0,0,0
HOXD10,Hoxd10,0,11,11,0,0,0
HOXD11,Hoxd11,2,0,2,2.058252,0,0
HOXD12,Hoxd12,-4,7,3,2.427184,0,0
HOXD13,Hoxd13,5,8,13,2.427184,0,0
HOXD3,Hoxd3,7,-1,6,0,0,0
HOXD4,Hoxd4,1,-1,0,0,0,0
HOXD8,Hoxd8,-1,-2,-3,0.650485,0,0
HOXD9,Hoxd9,-9,5,-4,0,0,0
HP,Hp,27,6,33,0,0,0
HP1BP3,Hp1bp3,7,-3,4,5.029126,0,0
HPCA,Hpca,12,6,18,0,0,0
HPCAL1,Hpcal1,-1,7,6,5.359223,0,0
HPCAL4,Hpcal4,3,-7,-4,0,0,0
HPD,Hpd,7,12,19,15.514563,0,131
HPDL,Hpdl,-7,-12,-19,1.252427,0,0
HPF1,Hpf1,4,-7,-3,6.174757,0,0
HPGD,Hpgd,-1,-3,-4,4.961165,0,0
HPGDS,Hpgds,-1,4,3,0,0,0
HPN,Hpn,1,12,13,0,0,0
HPS1,Hps1,2,-5,-3,1.427184,0,0
HPS3,Hps3,5,-1,4,12.07767,0,0
HPS4,Hps4,5,-1,4,8.271845,0,0
HPS5,Hps5,4,-4,0,6.68932,0,0
HPS6,Hps6,-36,-9,-45,7.485437,0,0
HPSE,Hpse,5,-4,1,1.475728,0,0
HPSE2,Hpse2,2,-4,-2,0,0,0
HPX,Hpx,11,9,20,0,0,0
HR,Hr,2,1,3,0,0,0
HRAS,Hras,2,-3,-1,66.708738,0,0
HRC,Hrc,2,-1,1,18.980583,0,0
HRCT1,Hrct1,-52,-3,-55,0,0,0
HRG,Hrg,10,5,15,0,0,0
HRH1,Hrh1,2,0,2,0,0,0
HRH2,Hrh2,-1,-7,-8,0,0,0
HRH3,Hrh3,-1,-5,-6,0,0,0
HRH4,Hrh4,7,-7,0,0,0,0
HRK,Hrk,6,16,22,0,0,0
HRNR,Hrnr,0,-1,-1,0,0,0
HROB,Hrob,-6,-5,-11,5.61165,0,0
HS1BP3,Hs1bp3,-9,5,-4,14.951456,0,0
HS2ST1,Hs2st1,4,-3,1,0.805825,0,0
HS3ST1,Hs3st1,-9,1,-8,4.339806,0,0
HS3ST2,Hs3st2,4,-4,0,2.184466,0,0
HS3ST3A1,Hs3st3a1,14,2,16,4.242718,0,0
HS3ST3B1,Hs3st3b1,4,1,5,9.553398,0,0
HS3ST4,Hs3st4,0,-6,-6,0,0,0
HS3ST5,Hs3st5,-7,-2,-9,0,0,0
HS3ST6,Hs3st6,2,0,2,0,0,0
HS6ST1,Hs6st1,2,8,10,1.446602,0,0
HS6ST2,Hs6st2,3,-2,1,0,0,0
HS6ST3,Hs6st3,3,-3,0,0,0,0
HSBP1,Hsbp1,11,-5,6,62.466019,11.25,0
HSBP1L1,Hsbp1l1,9,-11,-2,109.776699,21.25,0
HSCB,Hscb,-1,-13,-14,2.864078,0,0
HSD11B1,Hsd11b1,5,5,10,0,0,0
HSD11B2,Hsd11b2,2,12,14,8.07767,0,106
HSD17B1,Hsd17b1,19,16,35,2.446602,0,0
HSD17B10,Hsd17b10,4,-4,0,1.262136,0,0
HSD17B11,Hsd17b11,8,-2,6,0,0,0
HSD17B12,Hsd17b12,7,0,7,2.650485,0,0
HSD17B13,Hsd17b13,4,0,4,0,0,0
HSD17B14,Hsd17b14,10,-2,8,0,0,0
HSD17B2,Hsd17b2,2,4,6,0,0,0
HSD17B3,Hsd17b3,28,2,30,0,0,0
HSD17B4,Hsd17b4,7,-3,4,2.126214,0,0
HSD17B6,Hsd17b6,15,12,27,0,0,0
HSD17B7,Hsd17b7,13,-3,10,102.145631,9.708333,0
HSD3B1,Hsd3b1,10,3,13,0,0,0
HSD3B2,Hsd3b2,8,-11,-3,0,0,0
HSD3B7,Hsd3b7,9,-3,6,0,0,0
HSDL1,Hsdl1,1,-8,-7,106.883495,0,0
HSDL2,Hsdl2,5,-6,-1,8.708738,0,0
HSF1,Hsf1,10,-6,4,46.864078,31.666667,0
HSF2,Hsf2,-11,-5,-16,3.563107,0,0
HSF2BP,Hsf2bp,-6,-2,-8,9.592233,0,0
HSF4,Hsf4,7,1,8,2.854369,0,0
HSF5,Hsf5,1,-5,-4,0,0,0
HSFY2,Hsfy2,-3,-6,-9,0,0,0
HSH2D,Hsh2d,3,2,5,1.349515,0,0
HSP90AA1,Hsp90aa1,68,37,105,849.126214,805.083333,1319
HSP90AB1,Hsp90ab1,20,5,25,599.165049,297.25,630
HSP90B1,Hsp90b1,13,-1,12,22.349515,0,0
HSPA12A,Hspa12a,-8,-6,-14,5.747573,0,0
HSPA12B,Hspa12b,-12,4,-8,0,0,0
HSPA13,Hspa13,4,-6,-2,0,0,0
HSPA14,Hspa14,2,-10,-8,0,0,0
HSPA1A,Hspa1a,239,137,376,246.796117,86.5,272
HSPA1B,Hspa1b,231,149,380,378.029126,118.791667,759
HSPA1L,Hspa1l,150,32,182,246.796117,86.5,272
HSPA2,Hspa2,10,-11,-1,4.019417,0,0
HSPA4,Hspa4,26,-3,23,248.485437,77.25,131
HSPA4L,Hspa4l,96,13,109,187.349515,66.666667,0
HSPA5,Hspa5,33,2,35,2.07767,0,0
HSPA8,Hspa8,47,11,58,524.475728,409.041667,367
HSPA9,Hspa9,7,-1,6,151.941748,64.875,0
HSPB1,Hspb1,112,111,223,328.699029,153.125,0
HSPB2,Hspb2,73,3,76,34.262136,0,0
HSPB3,Hspb3,2,-4,-2,0,0,0
HSPB6,Hspb6,21,-2,19,19.504854,0,0
HSPB7,Hspb7,-3,-12,-15,0,0,0
HSPB8,Hspb8,100,36,136,39.679612,0,0
HSPB9,Hspb9,76,-8,68,143.533981,23.833333,241
HSPBAP1,Hspbap1,6,-4,2,19.145631,0,0
HSPBP1,Hspbp1,6,0,6,9.23301,0,0
HSPD1,Hspd1,55,12,67,1151.04854,774.958333,1246
HSPE1,Hspe1,39,22,61,1151.04854,774.958333,1246
HSPG2,Hspg2,11,-1,10,4.504854,0,0
HSPH1,Hsph1,167,64,231,685.116505,220.25,520
HTATIP2,Htatip2,3,4,7,9.427184,0,0
HTATSF1,Htatsf1,7,2,9,25.873786,0,0
HTR1A,Htr1a,0,0,0,0,0,0
HTR1B,Htr1b,2,-1,1,0,0,0
HTR1D,Htr1d,5,5,10,1.359223,0,0
HTR1F,Htr1f,-1,-5,-6,0,0,0
HTR2A,Htr2a,1,-5,-4,0,0,0
HTR2B,Htr2b,14,0,14,0,0,0
HTR2C,Htr2c,-4,-3,-7,0,0,0
HTR3A,Htr3a,0,3,3,0,0,0
HTR3B,Htr3b,3,2,5,0,0,0
HTR4,Htr4,-1,1,0,0,0,0
HTR5A,Htr5a,1,0,1,3.92233,0,0
HTR6,Htr6,7,1,8,0,0,0
HTR7,Htr7,4,-3,1,2.932039,0,0
HTRA1,Htra1,7,2,9,3.84466,0,0
HTRA2,Htra2,7,-2,5,10.728155,0,0
HTRA3,Htra3,2,6,8,0,0,0
HTRA4,Htra4,0,5,5,0,0,0
HTT,Htt,10,-2,8,2.048544,0,0
HUNK,Hunk,23,-3,20,18.165049,0,0
HUS1,Hus1,3,-3,0,22.038835,0,0
HUS1B,Hus1b,11,-2,9,0,0,0
HUWE1,Huwe1,11,-1,10,2.970874,0,0
HVCN1,Hvcn1,21,-7,14,0,0,0
HYAL1,Hyal1,7,0,7,1.349515,0,0
HYAL2,Hyal2,-22,-10,-32,2.572816,0,0
HYAL3,Hyal3,-6,0,-6,1.349515,0,0
HYAL4,Hyal4,10,-6,4,0,0,0
HYDIN,Hydin,-3,-3,-6,8.330097,0,0
HYI,Hyi,-1,3,2,1.912621,0,0
HYKK,Hykk,2,-6,-4,0,0,0
HYLS1,Hyls1,-22,-8,-30,13.019417,0,0
HYOU1,Hyou1,6,0,6,7.417476,0,0
HYPK,Hypk,27,1,28,190.446602,45.666667,0
IAH1,Iah1,6,-3,3,3.019417,0,0
IAPP,Iapp,10,-5,5,0,0,0
IARS2,Iars2,3,1,4,10.398058,0,0
IBA57,Iba57,2,-4,-2,19.048544,0,0
IBSP,Ibsp,-2,0,-2,0,0,0
IBTK,Ibtk,4,-2,2,1.242718,0,0
ICA1,Ica1,5,-3,2,0.854369,0,0
ICA1L,Ica1l,8,-1,7,34.456311,0,0
ICAM1,Icam1,-3,9,6,2.31068,0,0
ICAM2,Icam2,24,6,30,2.446602,0,0
ICAM4,Icam4,27,-11,16,0,0,0
ICAM5,Icam5,3,-4,-1,0,0,0
ICE1,Ice1,6,-6,0,9.786408,0,0
ICE2,Ice2,4,-2,2,25.048544,0,0
ICMT,Icmt,0,-2,-2,23.660194,0,0
ICOS,Icos,-11,-9,-20,0,0,0
ID1,Id1,13,14,27,25.854369,0,0
ID2,Id2,41,-1,40,66.864078,0,0
ID3,Id3,10,4,14,35.485437,0,0
ID4,Id4,6,0,6,0,0,0
IDE,Ide,2,-6,-4,4.737864,0,0
IDH1,Idh1,9,-10,-1,1.271845,0,0
IDH2,Idh2,4,-6,-2,4.320388,0,0
IDH3A,Idh3a,7,-8,-1,9.048544,0,0
IDH3B,Idh3b,7,-6,1,3.097087,0,0
IDH3G,Idh3g,9,-5,4,2.174757,0,0
IDI1,Idi1,0,-9,-9,2.854369,0,0
IDI2,Idi2,11,12,23,0,0,0
IDNK,Idnk,6,3,9,22.242718,0,0
IDO1,Ido1,3,2,5,0,0,0
IDO2,Ido2,-2,1,-1,0,0,0
IDS,Ids,6,1,7,2.087379,0,0
IDUA,Idua,8,1,9,5.058252,0,0
IER2,Ier2,17,10,27,2.466019,0,0
IER3,Ier3,-20,2,-18,12.640777,0,0
IER3IP1,Ier3ip1,6,-9,-3,0.796117,0,0
IER5,Ier5,140,2,142,68.825243,0,0
IER5L,Ier5l,19,7,26,51.776699,14,0
IFFO1,Iffo1,25,-8,17,0,0,0
IFFO2,Iffo2,7,-3,4,2.058252,0,0
IFI27,Ifi27,37,-2,35,0,0,0
IFI30,Ifi30,2,-6,-4,1.485437,0,0
IFI35,Ifi35,71,3,74,0,0,0
IFI44,Ifi44,-9,1,-8,0,0,0
IFI44L,Ifi44l,-8,-4,-12,1.699029,0,0
IFIH1,Ifih1,-1,0,-1,1.466019,0,0
IFIT1,Ifit1,0,6,6,0,0,0
IFIT2,Ifit2,-2,-5,-7,0,0,0
IFIT3,Ifit3,-31,-5,-36,0,0,0
IFITM1,Ifitm1,11,-1,10,5.126214,0,0
IFITM10,Ifitm10,6,20,26,0,0,0
IFITM2,Ifitm2,9,2,11,3,0,0
IFITM3,Ifitm3,9,1,10,4.728155,0,0
IFITM5,Ifitm5,10,22,32,2.058252,0,0
IFNA1,Ifna1,2,2,4,0,0,0
IFNA13,Ifna13,0,0,0,0,0,0
IFNA14,Ifna14,-1,2,1,0,0,0
IFNA16,Ifna16,1,0,1,0,0,0
IFNA2,Ifna2,-1,2,1,0,0,0
IFNA4,Ifna4,-1,3,2,0,0,0
IFNA5,Ifna5,32,3,35,0,0,0
IFNA6,Ifna6,5,4,9,0,0,0
IFNA7,Ifna7,-1,1,0,0,0,0
IFNAR1,Ifnar1,4,-7,-3,0.786408,0,0
IFNAR2,Ifnar2,0,-1,-1,1.368932,0,0
IFNB1,Ifnb1,4,2,6,0,0,0
IFNE,Ifne,6,4,10,0,0,0
IFNG,Ifng,4,2,6,0,0,0
IFNGR1,Ifngr1,5,-4,1,4.68932,0,0
IFNGR2,Ifngr2,-2,1,-1,42.31068,0,0
IFNK,Ifnk,-2,0,-2,0,0,0
IFNL2,Ifnl2,3,-3,0,0,0,0
IFNL3,Ifnl3,-6,3,-3,0,0,0
IFNLR1,Ifnlr1,-2,0,-2,2.786408,0,0
IFRD1,Ifrd1,10,8,18,11.087379,0,0
IFRD2,Ifrd2,-2,-6,-8,9.126214,0,0
IFT122,Ift122,-3,-4,-7,24.68932,0,0
IFT140,Ift140,4,-9,-5,50.223301,0,0
IFT172,Ift172,5,-7,-2,26.262136,0,0
IFT20,Ift20,8,-7,1,10.92233,0,0
IFT22,Ift22,4,-9,-5,26.339806,0,0
IFT27,Ift27,-1,-4,-5,0,0,0
IFT43,Ift43,5,-6,-1,4.262136,0,0
IFT46,Ift46,2,-5,-3,0,0,0
IFT52,Ift52,4,-6,-2,14.864078,0,0
IFT57,Ift57,10,-1,9,56.796117,0,0
IFT74,Ift74,1,-8,-7,3.932039,0,0
IFT80,Ift80,7,-6,1,2.203883,0,0
IFT81,Ift81,-2,-5,-7,47.126214,0,0
IFT88,Ift88,0,-3,-3,4.058252,0,0
IFTAP,Iftap,12,-8,4,0,0,0
IGBP1,Igbp1,7,3,10,3.038835,0,0
IGDCC3,Igdcc3,9,-1,8,0,0,0
IGDCC4,Igdcc4,10,-1,9,7.679612,0,0
IGF1,Igf1,-1,5,4,0,0,0
IGF1R,Igf1r,12,2,14,1.815534,0,0
IGF2,Igf2,14,-1,13,0,0,0
IGF2BP1,Igf2bp1,6,-3,3,0,0,0
IGF2BP2,Igf2bp2,11,0,11,4.368932,0,0
IGF2BP3,Igf2bp3,-1,-6,-7,7.92233,0,0
IGF2R,Igf2r,11,2,13,16.747573,0,0
IGFALS,Igfals,1,-1,0,23.436893,0,0
IGFBP1,Igfbp1,0,1,1,0.660194,0,0
IGFBP2,Igfbp2,5,8,13,0,0,0
IGFBP3,Igfbp3,2,16,18,0,0,0
IGFBP4,Igfbp4,7,1,8,2.067961,0,0
IGFBP5,Igfbp5,3,-1,2,0,0,0
IGFBP6,Igfbp6,8,-3,5,4.349515,0,0
IGFBP7,Igfbp7,3,13,16,1.223301,0,0
IGFBPL1,Igfbpl1,4,-2,2,0,0,0
IGFL3,Igfl3,-3,-1,-4,0,0,0
IGFLR1,Igflr1,7,12,19,0,0,0
IGFN1,Igfn1,-5,-2,-7,0,0,0
IGHD,Ighd,0,5,5,0,0,0
IGHD1-1,Ighd1-1,0,0,0,0,0,0
IGHE,Ighe,10,8,18,0,0,0
IGHG1,Ighg1,18,6,24,0,0,0
IGHG3,Ighg3,25,2,27,0,0,0
IGHJ1,Ighj1,0,-3,-3,0,0,0
IGHJ2,Ighj2,0,0,0,0,0,0
IGHJ3,Ighj3,0,-1,-1,0,0,0
IGHJ4,Ighj4,0,0,0,0,0,0
IGHM,Ighm,0,3,3,0,0,0
IGHMBP2,Ighmbp2,10,-6,4,27.106796,0,0
IGHV1-18,Ighv1-18,5,6,11,0,0,0
IGHV1-24,Ighv1-24,4,0,4,0,0,0
IGHV1-58,Ighv1-58,2,-2,0,0,0,0
IGHV1-69,Ighv1-69,2,-12,-10,0,0,0
IGHV2-5,Ighv2-5,-4,2,-2,0,0,0
IGIP,Igip,7,-14,-7,0,0,0
IGKC,Igkc,-9,5,-4,0,0,0
IGKJ1,Igkj1,1,1,2,0,0,0
IGKJ2,Igkj2,0,-2,-2,0,0,0
IGKJ3,Igkj3,0,-2,-2,0,0,0
IGKJ4,Igkj4,-1,-2,-3,0,0,0
IGKJ5,Igkj5,-2,-4,-6,0,0,0
IGKV3-7,Igkv3-7,-4,0,-4,0,0,0
IGLC1,Iglc1,23,3,26,0,0,0
IGLC2,Iglc2,3,-16,-13,0,0,0
IGLC3,Iglc3,-2,-4,-6,0,0,0
IGLJ1,Iglj1,0,1,1,0,0,0
IGLJ2,Iglj2,-3,0,-3,0,0,0
IGLJ3,Iglj3,-2,0,-2,0,0,0
IGLJ4,Iglj4,0,0,0,0,0,0
IGLL1,Igll1,1,1,2,1.349515,0,0
IGLON5,Iglon5,2,-3,-1,0,0,0
IGSF1,Igsf1,0,4,4,0,0,0
IGSF10,Igsf10,-12,-17,-29,6.631068,0,0
IGSF11,Igsf11,12,2,14,51.15534,0,0
IGSF21,Igsf21,2,-2,0,0,0,0
IGSF23,Igsf23,-7,4,-3,0,0,0
IGSF3,Igsf3,2,1,3,0,0,0
IGSF5,Igsf5,1,0,1,0,0,0
IGSF6,Igsf6,5,-5,0,0,0,0
IGSF8,Igsf8,3,-3,0,2.029126,0,0
IGSF9,Igsf9,0,-11,-11,73.116505,0,0
IGSF9B,Igsf9b,9,-6,3,0,0,0
IHH,Ihh,28,6,34,0,0,0
IHO1,Iho1,-2,4,2,2.543689,0,0
IK,Ik,5,-3,2,3.650485,0,0
IKBIP,Ikbip,-4,3,-1,4.553398,0,0
IKBKB,Ikbkb,5,-5,0,0.708738,0,0
IKBKE,Ikbke,-8,-4,-12,0,0,0
IKBKG,Ikbkg,4,-2,2,6.349515,0,0
IKZF1,Ikzf1,4,-3,1,0,0,0
IKZF2,Ikzf2,6,2,8,6.320388,0,0
IKZF3,Ikzf3,3,3,6,0,0,0
IKZF4,Ikzf4,7,1,8,2.708738,0,0
IKZF5,Ikzf5,4,-7,-3,1.912621,0,0
IL10,Il10,4,17,21,1.15534,0,0
IL10RA,Il10ra,3,-1,2,0,0,0
IL10RB,Il10rb,1,2,3,0.76699,0,0
IL11,Il11,8,5,13,0,0,0
IL12A,Il12a,1,-1,0,5.864078,0,0
IL12B,Il12b,9,3,12,0,0,0
IL12RB1,Il12rb1,7,-3,4,2.330097,0,0
IL12RB2,Il12rb2,5,-5,0,1.796117,0,0
IL13,Il13,21,4,25,0,0,0
IL13RA1,Il13ra1,-1,4,3,3.291262,0,0
IL13RA2,Il13ra2,-1,7,6,0,0,0
IL15,Il15,4,-4,0,1.495146,0,0
IL15RA,Il15ra,-9,-4,-13,1.980583,0,0
IL16,Il16,4,-3,1,3.970874,0,0
IL17A,Il17a,2,-1,1,0,0,0
IL17B,Il17b,8,0,8,0,0,0
IL17C,Il17c,9,3,12,0.864078,0,0
IL17D,Il17d,6,-4,2,1.271845,0,0
IL17F,Il17f,34,-9,25,0,0,0
IL17RA,Il17ra,4,3,7,3.106796,0,0
IL17RB,Il17rb,5,2,7,22.640777,0,0
IL17RC,Il17rc,7,3,10,4.990291,0,0
IL17RD,Il17rd,4,-1,3,3.203883,0,0
IL17RE,Il17re,6,1,7,0,0,0
IL18,Il18,11,-18,-7,0,0,0
IL18BP,Il18bp,2,-1,1,1.213592,0,0
IL18R1,Il18r1,0,-2,-2,3.951456,0,0
IL18RAP,Il18rap,3,-2,1,0,0,0
IL19,Il19,4,-6,-2,1.15534,0,0
IL1A,Il1a,-2,8,6,0,0,0
IL1B,Il1b,-28,-3,-31,0,0,0
IL1F10,Il1f10,-1,-7,-8,0,0,0
IL1R1,Il1r1,-3,-1,-4,1.038835,0,0
IL1R2,Il1r2,16,22,38,0,0,0
IL1RAP,Il1rap,4,-2,2,12.106796,0,0
IL1RAPL1,Il1rapl1,-1,1,0,0,0,0
IL1RAPL2,Il1rapl2,-2,1,-1,0,0,0
IL1RL1,Il1rl1,14,-1,13,3.145631,0,0
IL1RL2,Il1rl2,6,7,13,0,0,0
IL1RN,Il1rn,-2,7,5,0,0,0
IL2,Il2,3,4,7,0,0,0
IL20,Il20,18,0,18,0,0,0
IL20RA,Il20ra,-1,-11,-12,7.728155,0,0
IL20RB,Il20rb,11,-2,9,0,0,0
IL21,Il21,-1,-1,-2,0,0,0
IL21R,Il21r,2,-3,-1,0,0,0
IL22,Il22,10,-1,9,0,0,0
IL22RA1,Il22ra1,-10,8,-2,0,0,0
IL22RA2,Il22ra2,0,6,6,0,0,0
IL23A,Il23a,1,5,6,6.23301,0,0
IL23R,Il23r,2,-3,-1,0,0,0
IL24,Il24,16,0,16,0,0,0
IL25,Il25,3,-9,-6,0,0,0
IL27,Il27,8,8,16,1.417476,0,0
IL27RA,Il27ra,-5,5,0,2.019417,0,0
IL2RA,Il2ra,5,-1,4,0,0,0
IL2RB,Il2rb,7,2,9,15.524272,0,0
IL2RG,Il2rg,-15,4,-11,0,0,0
IL3,Il3,1,7,8,0,0,0
IL31,Il31,62,7,69,0,0,0
IL31RA,Il31ra,2,-1,1,0,0,0
IL33,Il33,-1,10,9,0,0,0
IL34,Il34,2,-6,-4,34.194175,10.916667,0
IL3RA,Il3ra,7,-1,6,0,0,0
IL4,Il4,20,3,23,23.475728,0,0
IL4I1,Il4i1,9,-30,-21,33.815534,0,0
IL5,Il5,31,-1,30,0,0,0
IL5RA,Il5ra,21,-11,10,0,0,0
IL6,Il6,9,9,18,0.76699,0,0
IL6ST,Il6st,7,-4,3,2.805825,0,0
IL7,Il7,-2,-2,-4,5.951456,0,0
IL7R,Il7r,9,7,16,18.660194,0,0
IL9,Il9,1,-6,-5,0,0,0
IL9R,Il9r,6,-1,5,0,0,0
ILDR1,Ildr1,0,7,7,0,0,0
ILDR2,Ildr2,4,8,12,0,0,0
ILF2,Ilf2,9,-4,5,30.504854,0,0
ILF3,Ilf3,7,-4,3,34.145631,0,0
ILK,Ilk,4,0,4,19.601942,0,0
ILKAP,Ilkap,6,-2,4,3.650485,0,0
ILRUN,Ilrun,10,-4,6,0,0,0
ILVBL,Ilvbl,1,-10,-9,9.61165,0,0
IMMP1L,Immp1l,12,-6,6,0,0,0
IMMP2L,Immp2l,-9,-16,-25,10.194175,0,0
IMMT,Immt,4,-4,0,6.223301,0,0
IMP3,Imp3,-18,-1,-19,3.699029,0,0
IMP4,Imp4,7,-3,4,4.796117,0,0
IMPA1,Impa1,-1,-4,-5,10.15534,0,0
IMPA2,Impa2,8,-8,0,6.679612,0,0
IMPACT,Impact,-4,5,1,9.669903,0,0
IMPDH1,Impdh1,6,-5,1,1.349515,0,0
IMPDH2,Impdh2,6,-4,2,7.330097,0,0
IMPG1,Impg1,5,-3,2,0,0,0
IMPG2,Impg2,2,-2,0,0,0,0
INA,Ina,15,-1,14,0,0,0
INAFM1,Inafm1,6,-6,0,1.223301,0,0
INAFM2,Inafm2,-10,-1,-11,8.932039,0,0
INAVA,Inava,3,-2,1,12.805825,0,0
INCA1,Inca1,5,-5,0,63.893204,18.333333,0
INCENP,Incenp,-6,-7,-13,0.902913,0,0
INF2,Inf2,-1,1,0,4.339806,0,0
ING1,Ing1,5,-3,2,37.61165,0,0
ING2,Ing2,2,-5,-3,39.145631,0,0
ING3,Ing3,4,0,4,5.339806,0,0
ING4,Ing4,13,-1,12,2.572816,0,0
ING5,Ing5,2,-7,-5,45.873786,0,0
INHA,Inha,3,-8,-5,0,0,0
INHBA,Inhba,7,-1,6,47.970874,0,0
INHBB,Inhbb,7,8,15,0,0,0
INHBC,Inhbc,1,-1,0,12.601942,0,0
INHBE,Inhbe,4,-3,1,0,0,0
INIP,Inip,26,-1,25,2.349515,0,0
INKA1,Inka1,-23,-11,-34,1.058252,0,0
INKA2,Inka2,-4,-8,-12,5.786408,0,0
INMT,Inmt,-1,6,5,0,0,0
INO80,Ino80,-3,-5,-8,9.165049,0,0
INO80B,Ino80b,-4,-4,-8,4.718447,0,0
INO80C,Ino80c,8,-8,0,8.621359,0,0
INO80D,Ino80d,8,-3,5,4.563107,0,0
INO80E,Ino80e,5,-2,3,0,0,0
INPP1,Inpp1,-3,-9,-12,2.776699,0,0
INPP4A,Inpp4a,8,1,9,2.543689,0,0
INPP4B,Inpp4b,6,-1,5,3.07767,0,0
INPP5A,Inpp5a,2,-2,0,7.582524,0,0
INPP5B,Inpp5b,4,3,7,0,0,0
INPP5D,Inpp5d,-3,-2,-5,0,0,0
INPP5E,Inpp5e,8,-4,4,5.291262,0,0
INPP5F,Inpp5f,5,2,7,5.38835,0,0
INPP5J,Inpp5j,18,-4,14,0,0,0
INPP5K,Inpp5k,17,-1,16,1.932039,0,0
INPPL1,Inppl1,5,-3,2,2.660194,0,0
INSC,Insc,1,3,4,0,0,0
INSIG1,Insig1,5,-1,4,20.019417,0,0
INSIG2,Insig2,-2,-7,-9,2.378641,0,0
INSL3,Insl3,16,-1,15,0,0,0
INSL5,Insl5,17,-1,16,0,0,0
INSL6,Insl6,6,-5,1,0,0,0
INSM1,Insm1,4,2,6,0,0,0
INSM2,Insm2,6,-1,5,1.679612,0,0
INSR,Insr,11,4,15,11.961165,0,0
INSRR,Insrr,0,0,0,0,0,0
INSYN1,Insyn1,5,-2,3,0,0,0
INSYN2A,Insyn2a,-1,-1,-2,0,0,0
INSYN2B,Insyn2b,-17,-2,-19,0,0,0
INTS1,Ints1,9,-3,6,18.990291,0,0
INTS10,Ints10,6,-12,-6,6.135922,0,0
INTS11,Ints11,8,-3,5,1.135922,0,0
INTS12,Ints12,4,-2,2,13.980583,0,0
INTS13,Ints13,4,-4,0,6.330097,0,0
INTS14,Ints14,3,-4,-1,18.631068,0,0
INTS2,Ints2,6,-6,0,35.067961,0,0
INTS3,Ints3,9,0,9,2.475728,0,0
INTS4,Ints4,2,-6,-4,13.864078,0,0
INTS5,Ints5,6,-4,2,11.15534,0,0
INTS6,Ints6,5,0,5,0.92233,0,0
INTS6L,Ints6l,0,-5,-5,0.970874,0,0
INTS7,Ints7,5,-4,1,7.747573,0,0
INTS8,Ints8,8,-5,3,43.349515,6.458333,0
INTS9,Ints9,3,0,3,0,0,0
INTU,Intu,10,-1,9,10.029126,0,0
INVS,Invs,4,-2,2,8.504854,0,0
IP6K1,Ip6k1,11,-4,7,9.359223,0,0
IP6K2,Ip6k2,4,0,4,8.252427,0,0
IP6K3,Ip6k3,0,3,3,0,0,0
IPCEF1,Ipcef1,2,3,5,0,0,0
IPMK,Ipmk,6,-4,2,2.883495,0,0
IPO11,Ipo11,7,-4,3,3.932039,0,0
IPO13,Ipo13,9,-1,8,15.92233,0,0
IPO4,Ipo4,3,1,4,51.106796,0,170
IPO5,Ipo5,6,-2,4,0,0,0
IPO7,Ipo7,6,-4,2,6.398058,0,0
IPO8,Ipo8,6,-10,-4,8.592233,0,0
IPO9,Ipo9,6,-1,5,2.126214,0,0
IPP,Ipp,4,-8,-4,36.708738,0,0
IPPK,Ippk,1,-3,-2,11.621359,0,0
IQANK1,Iqank1,2,-10,-8,6.951456,0,0
IQCA1L,Iqca1l,38,14,52,0,0,0
IQCB1,Iqcb1,2,0,2,5.368932,0,0
IQCC,Iqcc,6,-3,3,65.466019,0,0
IQCD,Iqcd,2,-8,-6,3.631068,0,0
IQCE,Iqce,11,-17,-6,44.893204,0,0
IQCF1,Iqcf1,34,21,55,0,0,0
IQCF5,Iqcf5,15,5,20,8.223301,0,0
IQCF6,Iqcf6,2,1,3,0,0,0
IQCG,Iqcg,11,-7,4,28.048544,0,0
IQCH,Iqch,-6,-4,-10,59.184466,0,0
IQCJ,Iqcj,-1,-1,-2,0,0,0
IQCK,Iqck,2,3,5,15.582524,0,0
IQCM,Iqcm,0,1,1,0,0,0
IQCN,Iqcn,9,15,24,9.543689,0,0
IQGAP1,Iqgap1,7,0,7,2.873786,0,0
IQGAP2,Iqgap2,7,1,8,4.466019,0,0
IQGAP3,Iqgap3,3,-20,-17,3.932039,0,0
IQSEC1,Iqsec1,-2,0,-2,15.087379,0,0
IQSEC2,Iqsec2,-1,1,0,1.912621,0,0
IQSEC3,Iqsec3,-5,1,-4,17.902913,0,0
IQUB,Iqub,22,-8,14,0,0,0
IRAG1,Irag1,-7,0,-7,0,0,0
IRAK1,Irak1,5,0,5,1.048544,0,0
IRAK1BP1,Irak1bp1,7,-5,2,3.796117,0,0
IRAK2,Irak2,2,2,4,55.038835,0,0
IRAK3,Irak3,-4,-5,-9,0,0,0
IRAK4,Irak4,0,-4,-4,7.330097,0,0
IREB2,Ireb2,-13,-11,-24,16.213592,0,0
IRF1,Irf1,7,0,7,1.320388,0,0
IRF2,Irf2,4,-3,1,6.961165,0,0
IRF2BP1,Irf2bp1,-5,-1,-6,0,0,0
IRF2BP2,Irf2bp2,9,5,14,1.145631,0,0
IRF2BPL,Irf2bpl,7,5,12,11.941748,0,0
IRF3,Irf3,7,-2,5,19.485437,0,0
IRF4,Irf4,3,4,7,2.262136,0,0
IRF5,Irf5,14,5,19,0,0,0
IRF6,Irf6,0,-2,-2,0,0,0
IRF7,Irf7,5,1,6,0,0,0
IRF8,Irf8,33,5,38,0,0,0
IRF9,Irf9,-2,2,0,1.543689,0,0
IRGQ,Irgq,2,0,2,5.436893,0,0
IRS1,Irs1,4,2,6,1.485437,0,0
IRS2,Irs2,12,7,19,0,0,0
IRS4,Irs4,3,-4,-1,0,0,0
IRX1,Irx1,-1,3,2,1.281553,0,0
IRX2,Irx2,0,1,1,11.92233,0,0
IRX3,Irx3,-3,2,-1,9.223301,0,0
IRX4,Irx4,-3,1,-2,0,0,0
IRX5,Irx5,6,-11,-5,1.84466,0,0
IRX6,Irx6,1,-2,-1,0,0,0
ISCA1,Isca1,2,-2,0,9.718447,0,0
ISCA2,Isca2,-3,-6,-9,8.291262,0,0
ISCU,Iscu,10,0,10,6.883495,0,0
ISG15,Isg15,7,6,13,7.07767,0,0
ISG20,Isg20,4,2,6,8.572816,0,0
ISG20L2,Isg20l2,3,-4,-1,10.252427,0,0
ISL1,Isl1,34,-1,33,0.932039,0,0
ISL2,Isl2,3,-6,-3,0,0,0
ISLR,Islr,-2,2,0,0,0,0
ISLR2,Islr2,6,12,18,1.106796,0,0
ISM1,Ism1,-3,3,0,0,0,0
ISM2,Ism2,14,19,33,0,0,0
ISOC1,Isoc1,5,-2,3,8.359223,0,0
IST1,Ist1,15,-5,10,19.058252,0,0
ISX,Isx,-2,1,-1,19.601942,0,0
ISY1,Isy1,3,-2,1,36.76699,0,0
ISYNA1,Isyna1,7,3,10,0,0,0
ITCH,Itch,4,-5,-1,2.446602,0,0
ITFG1,Itfg1,4,-1,3,9.970874,0,0
ITFG2,Itfg2,6,0,6,13.019417,0,0
ITGA1,Itga1,3,0,3,0,0,0
ITGA10,Itga10,7,-3,4,3.854369,0,0
ITGA11,Itga11,-3,-5,-8,0,0,0
ITGA2,Itga2,4,-4,0,0,0,0
ITGA2B,Itga2b,12,-1,11,5.660194,0,0
ITGA3,Itga3,3,0,3,3.533981,0,0
ITGA4,Itga4,-1,-4,-5,2.621359,0,0
ITGA5,Itga5,0,1,1,3.029126,0,0
ITGA6,Itga6,5,3,8,7.970874,0,0
ITGA7,Itga7,12,1,13,9.553398,0,0
ITGA8,Itga8,2,0,2,0,0,0
ITGA9,Itga9,-1,-5,-6,0,0,0
ITGAD,Itgad,2,3,5,0,0,0
ITGAE,Itgae,3,-13,-10,1.805825,0,0
ITGAL,Itgal,3,3,6,0,0,0
ITGAM,Itgam,6,3,9,0,0,0
ITGAV,Itgav,7,3,10,5.223301,0,0
ITGAX,Itgax,5,2,7,0,0,0
ITGB1,Itgb1,5,0,5,7.427184,0,0
ITGB1BP1,Itgb1bp1,5,0,5,26.087379,0,0
ITGB1BP2,Itgb1bp2,8,-11,-3,0,0,0
ITGB2,Itgb2,8,7,15,1.23301,0,0
ITGB3,Itgb3,-1,1,0,3.961165,0,0
ITGB3BP,Itgb3bp,2,-7,-5,91.563107,0,0
ITGB4,Itgb4,5,-7,-2,4.466019,0,0
ITGB5,Itgb5,7,1,8,21.563107,0,0
ITGB6,Itgb6,3,0,3,0,0,0
ITGB7,Itgb7,17,-4,13,0,0,0
ITGB8,Itgb8,8,11,19,1.582524,0,0
ITGBL1,Itgbl1,1,1,2,1.184466,0,0
ITIH1,Itih1,24,2,26,0,0,0
ITIH2,Itih2,5,-8,-3,0,0,0
ITIH3,Itih3,18,6,24,0,0,0
ITIH4,Itih4,-12,4,-8,0,0,0
ITIH5,Itih5,3,0,3,0,0,0
ITK,Itk,31,2,33,0,0,0
ITLN1,Itln1,0,-6,-6,0,0,0
ITM2A,Itm2a,-2,3,1,0,0,0
ITM2B,Itm2b,11,2,13,2.223301,0,0
ITM2C,Itm2c,4,4,8,5.456311,0,0
ITPA,Itpa,2,-8,-6,0,0,0
ITPK1,Itpk1,5,8,13,16.61165,0,0
ITPKA,Itpka,-3,-1,-4,2.174757,0,0
ITPKB,Itpkb,4,2,6,2.339806,0,0
ITPKC,Itpkc,6,-4,2,3.582524,0,0
ITPR1,Itpr1,-3,-4,-7,5.563107,0,0
ITPR2,Itpr2,6,-5,1,7.495146,0,0
ITPR3,Itpr3,4,-4,0,4.427184,0,0
ITPRID1,Itprid1,0,2,2,0,0,0
ITPRID2,Itprid2,7,2,9,4.893204,0,0
ITPRIP,Itprip,0,-6,-6,2.563107,0,0
ITPRIPL1,Itpripl1,4,-9,-5,0.825243,0,0
ITPRIPL2,Itpripl2,2,-1,1,3.262136,0,0
ITSN1,Itsn1,5,-4,1,35.893204,0,0
ITSN2,Itsn2,2,-5,-3,14.951456,0,0
IVD,Ivd,0,-1,-1,0.873786,0,0
IVL,Ivl,-2,2,0,0,0,0
IVNS1ABP,Ivns1abp,14,5,19,7.708738,0,0
IWS1,Iws1,-3,0,-3,2.582524,0,0
IYD,Iyd,8,1,9,0,0,0
IZUMO1,Izumo1,17,-7,10,0,0,0
IZUMO1R,Izumo1r,14,6,20,0,0,0
IZUMO2,Izumo2,4,-8,-4,0,0,0
IZUMO3,Izumo3,4,-4,0,0,0,0
IZUMO4,Izumo4,-2,-7,-9,14.106796,0,0
JADE1,Jade1,9,2,11,32.087379,5.291667,0
JADE2,Jade2,3,-4,-1,24.31068,0,0
JADE3,Jade3,2,-7,-5,2.135922,0,0
JAG1,Jag1,8,2,10,0.932039,0,0
JAG2,Jag2,2,1,3,0,0,0
JAGN1,Jagn1,-3,-4,-7,5.640777,0,0
JAK1,Jak1,10,5,15,10.281553,0,0
JAK2,Jak2,7,3,10,6.970874,0,0
JAK3,Jak3,8,-2,6,67.76699,0,0
JAKMIP1,Jakmip1,1,4,5,1.961165,0,0
JAKMIP2,Jakmip2,2,-6,-4,0,0,0
JAKMIP3,Jakmip3,-2,0,-2,0.834951,0,0
JAM2,Jam2,3,-1,2,2.349515,0,0
JAM3,Jam3,15,-4,11,13.252427,0,0
JAML,Jaml,11,0,11,1.436893,0,0
JARID2,Jarid2,5,-4,1,3.504854,0,0
JAZF1,Jazf1,0,-8,-8,5.456311,0,0
JCAD,Jcad,2,-2,0,0,0,0
JCHAIN,Jchain,2,9,11,0,0,0
JDP2,Jdp2,5,9,14,0,0,0
JHY,Jhy,4,-4,0,3.883495,0,0
JKAMP,Jkamp,4,-4,0,73.368932,0,0
JMJD1C,Jmjd1c,5,-5,0,30.592233,8.333333,0
JMJD4,Jmjd4,-15,-2,-17,42.271845,0,0
JMJD6,Jmjd6,67,1,68,211.106796,110.333333,0
JMJD7,Jmjd7,1,-4,-3,2.601942,0,0
JMJD8,Jmjd8,0,0,0,63.407767,0,0
JMY,Jmy,7,4,11,0.640777,0,0
JOSD1,Josd1,9,-1,8,44.106796,6.791667,0
JOSD2,Josd2,8,-3,5,14.621359,0,0
JPH1,Jph1,0,1,1,5.359223,0,0
JPH2,Jph2,-1,-3,-4,0,0,0
JPH3,Jph3,4,-7,-3,0,0,0
JPH4,Jph4,13,-5,8,0,0,0
JPT1,Jpt1,4,-5,-1,8.38835,0,0
JPT2,Jpt2,4,-1,3,2.339806,0,0
JRK,Jrk,-4,-14,-18,25.339806,0,0
JRKL,Jrkl,4,-5,-1,6.097087,0,0
JSRP1,Jsrp1,40,2,42,11.262136,0,0
JTB,Jtb,4,-4,0,6.572816,0,0
JUN,Jun,63,28,91,112.368932,12.125,0
JUNB,Junb,19,17,36,53.592233,0,0
JUND,Jund,12,4,16,130.912621,0,0
JUP,Jup,3,-1,2,0.68932,0,0
KALRN,Kalrn,3,0,3,0,0,0
KANK1,Kank1,-14,-4,-18,11.902913,0,0
KANK2,Kank2,6,1,7,11.864078,0,0
KANK3,Kank3,4,-5,-1,0.970874,0,0
KANK4,Kank4,-1,-1,-2,0,0,0
KANSL1,Kansl1,11,0,11,11.543689,0,0
KANSL1L,Kansl1l,20,-6,14,145.543689,45.375,0
KANSL2,Kansl2,5,-3,2,6.61165,0,0
KANSL3,Kansl3,9,-8,1,45.601942,0,0
KANTR,Kantr,1,1,2,0,0,0
KASH5,Kash5,1,2,3,0,0,0
KAT14,Kat14,0,-5,-5,15.126214,0,0
KAT2A,Kat2a,9,-5,4,143.533981,23.833333,241
KAT2B,Kat2b,4,-2,2,8.747573,0,0
KAT5,Kat5,5,-1,4,4.271845,0,0
KAT6A,Kat6a,2,-4,-2,24.84466,0,0
KAT6B,Kat6b,9,-7,2,29.407767,0,0
KAT7,Kat7,1,-4,-3,6.15534,0,0
KAT8,Kat8,5,-6,-1,4.213592,0,0
KATNA1,Katna1,8,-3,5,8.126214,0,0
KATNAL1,Katnal1,2,-6,-4,19.07767,0,0
KATNAL2,Katnal2,3,-7,-4,25.951456,0,0
KATNB1,Katnb1,-2,-7,-9,0.961165,0,0
KATNBL1,Katnbl1,0,-2,-2,11.446602,0,0
KATNIP,Katnip,8,-10,-2,53.92233,0,0
KAZALD1,Kazald1,-1,0,-1,83.097087,0,0
KAZN,Kazn,7,6,13,0,0,0
KBTBD11,Kbtbd11,2,4,6,2.553398,0,0
KBTBD12,Kbtbd12,-1,-3,-4,0,0,0
KBTBD13,Kbtbd13,7,-2,5,0,0,0
KBTBD2,Kbtbd2,11,-2,9,5.524272,0,0
KBTBD3,Kbtbd3,-15,-5,-20,3.61165,0,0
KBTBD4,Kbtbd4,9,-5,4,75.203883,0,0
KBTBD6,Kbtbd6,5,-4,1,9.737864,0,0
KBTBD7,Kbtbd7,7,-7,0,9.135922,0,0
KBTBD8,Kbtbd8,11,-1,10,0,0,0
KCMF1,Kcmf1,7,-3,4,2.029126,0,0
KCNA1,Kcna1,1,-1,0,0,0,0
KCNA10,Kcna10,1,-1,0,0,0,0
KCNA2,Kcna2,0,0,0,0,0,0
KCNA3,Kcna3,4,3,7,0,0,0
KCNA4,Kcna4,0,0,0,0,0,0
KCNA5,Kcna5,-3,3,0,0,0,0
KCNA6,Kcna6,0,7,7,0,0,0
KCNA7,Kcna7,6,-2,4,0,0,0
KCNAB1,Kcnab1,-1,-4,-5,6.029126,0,0
KCNAB2,Kcnab2,-7,-11,-18,13.427184,0,0
KCNAB3,Kcnab3,1,-6,-5,0,0,0
KCNB1,Kcnb1,-1,0,-1,1.213592,0,0
KCNB2,Kcnb2,2,-6,-4,0,0,0
KCNC1,Kcnc1,5,-10,-5,0.961165,0,0
KCNC2,Kcnc2,1,-8,-7,0,0,0
KCNC3,Kcnc3,1,3,4,4.223301,0,0
KCNC4,Kcnc4,8,1,9,0,0,0
KCND1,Kcnd1,5,-4,1,0,0,0
KCND2,Kcnd2,-1,-3,-4,0,0,0
KCND3,Kcnd3,9,2,11,0,0,0
KCNE1,Kcne1,-2,8,6,0,0,0
KCNE2,Kcne2,6,-6,0,0,0,0
KCNE3,Kcne3,0,-16,-16,0,0,0
KCNE4,Kcne4,2,-1,1,13.038835,0,0
KCNF1,Kcnf1,-2,-7,-9,0,0,0
KCNG1,Kcng1,10,-11,-1,10.786408,0,0
KCNG2,Kcng2,5,5,10,0,0,0
KCNG3,Kcng3,1,4,5,6.23301,0,0
KCNG4,Kcng4,1,2,3,0,0,0
KCNH1,Kcnh1,2,-1,1,5.514563,0,0
KCNH2,Kcnh2,1,3,4,4.92233,0,0
KCNH3,Kcnh3,28,-4,24,13.902913,0,0
KCNH4,Kcnh4,1,2,3,0,0,0
KCNH5,Kcnh5,9,1,10,0,0,0
KCNH6,Kcnh6,4,0,4,0,0,0
KCNH7,Kcnh7,2,-5,-3,0,0,0
KCNH8,Kcnh8,0,-4,-4,2.378641,0,0
KCNIP1,Kcnip1,-2,1,-1,1.320388,0,0
KCNIP2,Kcnip2,-2,6,4,1.932039,0,0
KCNIP3,Kcnip3,-1,-3,-4,0.786408,0,0
KCNIP4,Kcnip4,2,-15,-13,0,0,0
KCNJ1,Kcnj1,1,-3,-2,0,0,0
KCNJ10,Kcnj10,11,-1,10,0,0,0
KCNJ11,Kcnj11,-2,-2,-4,1.291262,0,0
KCNJ12,Kcnj12,6,0,6,0.990291,0,0
KCNJ13,Kcnj13,4,-13,-9,0,0,0
KCNJ14,Kcnj14,10,18,28,0,0,0
KCNJ15,Kcnj15,-1,-4,-5,0,0,0
KCNJ16,Kcnj16,-3,-1,-4,0,0,0
KCNJ2,Kcnj2,33,-8,25,7.475728,0,0
KCNJ3,Kcnj3,3,-5,-2,0,0,0
KCNJ4,Kcnj4,4,-5,-1,4.339806,0,0
KCNJ5,Kcnj5,1,-2,-1,0,0,0
KCNJ6,Kcnj6,1,-7,-6,0,0,0
KCNJ8,Kcnj8,2,3,5,0.825243,0,0
KCNJ9,Kcnj9,-4,-16,-20,0,0,0
KCNK1,Kcnk1,-1,7,6,2.291262,0,0
KCNK10,Kcnk10,3,-5,-2,1.174757,0,0
KCNK12,Kcnk12,1,-7,-6,2.019417,0,0
KCNK13,Kcnk13,3,-2,1,1.718447,0,0
KCNK15,Kcnk15,-1,7,6,0.951456,0,0
KCNK16,Kcnk16,-3,3,0,0,0,0
KCNK18,Kcnk18,0,0,0,0,0,0
KCNK2,Kcnk2,-3,-3,-6,0,0,0
KCNK3,Kcnk3,4,0,4,1.349515,0,0
KCNK4,Kcnk4,23,35,58,6.679612,0,0
KCNK5,Kcnk5,5,3,8,0,0,0
KCNK6,Kcnk6,4,-2,2,1.15534,0,0
KCNK7,Kcnk7,32,-6,26,0,0,0
KCNK9,Kcnk9,-2,1,-1,5.029126,0,0
KCNMA1,Kcnma1,8,0,8,10.495146,0,0
KCNMB1,Kcnmb1,0,1,1,2.456311,0,0
KCNMB2,Kcnmb2,5,4,9,0,0,0
KCNMB3,Kcnmb3,-1,-2,-3,4.436893,0,0
KCNMB4,Kcnmb4,10,-1,9,0,0,0
KCNN1,Kcnn1,13,-8,5,114.514563,0,0
KCNN2,Kcnn2,46,-3,43,0,0,0
KCNN3,Kcnn3,9,1,10,4.07767,0,0
KCNN4,Kcnn4,-2,0,-2,19.184466,0,0
KCNQ1,Kcnq1,2,6,8,14.592233,0,0
KCNQ2,Kcnq2,42,-1,41,19.135922,0,0
KCNQ3,Kcnq3,-2,-9,-11,0,0,0
KCNQ4,Kcnq4,-1,-1,-2,0,0,0
KCNQ5,Kcnq5,-23,0,-23,0.84466,0,0
KCNRG,Kcnrg,4,0,4,0,0,0
KCNS1,Kcns1,7,-1,6,1.543689,0,0
KCNS2,Kcns2,0,-1,-1,0,0,0
KCNS3,Kcns3,-4,-1,-5,0,0,0
KCNT1,Kcnt1,1,4,5,0,0,0
KCNT2,Kcnt2,4,-3,1,0,0,0
KCNU1,Kcnu1,-2,-7,-9,0,0,0
KCNV1,Kcnv1,0,-3,-3,0,0,0
KCNV2,Kcnv2,6,-1,5,0,0,0
KCP,Kcp,3,1,4,0,0,0
KCTD1,Kctd1,7,-5,2,9.427184,0,0
KCTD10,Kctd10,7,-1,6,0,0,0
KCTD11,Kctd11,42,-2,40,142.961165,0,0
KCTD12,Kctd12,10,6,16,0,0,0
KCTD13,Kctd13,10,-6,4,4.184466,0,0
KCTD14,Kctd14,55,-9,46,3.61165,0,0
KCTD15,Kctd15,8,-3,5,1.747573,0,0
KCTD16,Kctd16,-2,-7,-9,0.990291,0,0
KCTD17,Kctd17,5,-6,-1,5.679612,0,0
KCTD18,Kctd18,2,9,11,16.38835,0,0
KCTD19,Kctd19,8,6,14,0,0,0
KCTD2,Kctd2,9,-5,4,8.786408,0,0
KCTD20,Kctd20,2,-6,-4,10.553398,0,0
KCTD21,Kctd21,2,-4,-2,30.281553,0,0
KCTD3,Kctd3,5,0,5,9.980583,0,0
KCTD4,Kctd4,7,-4,3,0,0,0
KCTD5,Kctd5,4,-3,1,15.194175,0,0
KCTD6,Kctd6,5,-1,4,9.660194,0,0
KCTD7,Kctd7,10,-10,0,6.271845,0,0
KCTD8,Kctd8,1,2,3,5.514563,0,0
KCTD9,Kctd9,-3,-8,-11,2.601942,0,0
KDELR1,Kdelr1,7,-2,5,0,0,0
KDELR2,Kdelr2,3,-2,1,6.873786,0,0
KDELR3,Kdelr3,-5,-3,-8,0.893204,0,0
KDF1,Kdf1,4,4,8,1.349515,0,0
KDM1A,Kdm1a,9,-1,8,26.640777,0,0
KDM1B,Kdm1b,7,-9,-2,4.165049,0,0
KDM2A,Kdm2a,20,3,23,47.533981,0,0
KDM2B,Kdm2b,4,-6,-2,1.980583,0,0
KDM3A,Kdm3a,9,-4,5,7.796117,0,0
KDM3B,Kdm3b,9,-3,6,11.553398,0,0
KDM4A,Kdm4a,8,-2,6,1.660194,0,0
KDM4B,Kdm4b,4,1,5,6.757282,0,0
KDM4C,Kdm4c,5,1,6,37.485437,0,0
KDM4D,Kdm4d,-15,-12,-27,3.31068,0,0
KDM5A,Kdm5a,20,-3,17,43.194175,0,0
KDM5B,Kdm5b,7,-1,6,3.398058,0,0
KDM5C,Kdm5c,7,3,10,2.009709,0,0
KDM5D,Kdm5d,2,2,4,0,0,0
KDM6A,Kdm6a,3,1,4,1.07767,0,0
KDM6B,Kdm6b,10,2,12,27.990291,0,0
KDM7A,Kdm7a,12,-1,11,3.524272,0,0
KDM8,Kdm8,-4,-3,-7,7.524272,0,0
KDR,Kdr,0,2,2,0,0,0
KDSR,Kdsr,4,4,8,13.582524,0,0
KEAP1,Keap1,1,-5,-4,14.475728,0,0
KEL,Kel,-1,-1,-2,0,0,0
KERA,Kera,1,2,3,0,0,0
KHDC4,Khdc4,20,-1,19,3.427184,0,0
KHDRBS1,Khdrbs1,8,-2,6,29.126214,0,0
KHDRBS2,Khdrbs2,0,2,2,0,0,0
KHDRBS3,Khdrbs3,5,-3,2,3.883495,0,0
KHK,Khk,7,-7,0,8.15534,0,0
KHNYN,Khnyn,2,-2,0,11.553398,0,0
KHSRP,Khsrp,8,-2,6,4.31068,0,0
KIDINS220,Kidins220,11,-6,5,4.805825,0,0
KIF11,Kif11,-7,-7,-14,1.970874,0,0
KIF12,Kif12,10,3,13,1.009709,0,0
KIF13A,Kif13a,5,-3,2,3.135922,0,0
KIF13B,Kif13b,1,-2,-1,2.07767,0,0
KIF14,Kif14,4,-14,-10,41.174757,0,0
KIF15,Kif15,-1,-13,-14,12.291262,0,0
KIF16B,Kif16b,2,-6,-4,8.349515,0,0
KIF17,Kif17,2,2,4,0,0,0
KIF18A,Kif18a,3,-9,-6,44.980583,0,0
KIF18B,Kif18b,-4,-15,-19,2.601942,0,0
KIF1A,Kif1a,15,3,18,0,0,0
KIF1B,Kif1b,8,-2,6,7.058252,0,0
KIF1C,Kif1c,6,-5,1,63.893204,18.333333,0
KIF20A,Kif20a,-14,-12,-26,4.883495,0,0
KIF20B,Kif20b,-12,-12,-24,0,0,0
KIF21A,Kif21a,10,4,14,67.271845,5.916667,0
KIF21B,Kif21b,8,-2,6,0,0,0
KIF22,Kif22,-3,-10,-13,9.592233,0,0
KIF23,Kif23,-3,-7,-10,29.563107,0,0
KIF24,Kif24,-5,-6,-11,30.320388,0,0
KIF26A,Kif26a,4,-1,3,1.097087,0,0
KIF26B,Kif26b,4,-3,1,0,0,0
KIF27,Kif27,19,2,21,38.213592,0,0
KIF2A,Kif2a,7,-5,2,32.019417,0,0
KIF2B,Kif2b,0,-4,-4,0,0,0
KIF2C,Kif2c,-11,-10,-21,4.38835,0,0
KIF3A,Kif3a,3,-2,1,15.572816,0,0
KIF3B,Kif3b,3,-1,2,13.485437,0,0
KIF3C,Kif3c,8,-4,4,0,0,0
KIF5A,Kif5a,28,1,29,1.058252,0,0
KIF5B,Kif5b,8,1,9,0,0,0
KIF5C,Kif5c,9,-2,7,1.990291,0,0
KIF6,Kif6,3,-11,-8,0,0,0
KIF7,Kif7,12,-8,4,1.320388,0,0
KIF9,Kif9,8,-4,4,110.68932,7.833333,141
KIFAP3,Kifap3,8,-3,5,2.699029,0,0
KIFBP,Kifbp,2,-6,-4,9.660194,0,0
KIFC1,Kifc1,-5,-7,-12,2.941748,0,0
KIFC2,Kifc2,7,-2,5,2.242718,0,0
KIFC3,Kifc3,8,2,10,44.38835,0,0
KIN,Kin,3,-6,-3,2.805825,0,0
KIR3DL1,Kir3dl1,1,1,2,1.84466,0,0
KIR3DL2,Kir3dl2,0,-4,-4,0,0,0
KIRREL2,Kirrel2,9,1,10,0,0,0
KIRREL3,Kirrel3,2,-3,-1,0,0,0
KISS1,Kiss1,13,-5,8,0,0,0
KISS1R,Kiss1r,5,0,5,35.592233,0,0
KIT,Kit,2,0,2,0,0,0
KIZ,Kiz,2,-10,-8,1.543689,0,0
KL,Kl,-2,-8,-10,16.126214,0,0
KLB,Klb,-1,-5,-6,13.504854,0,0
KLC1,Klc1,6,-3,3,7.854369,0,0
KLC2,Klc2,7,-10,-3,3.281553,0,0
KLC3,Klc3,2,-6,-4,0,0,0
KLC4,Klc4,14,2,16,0,0,0
KLF1,Klf1,8,-4,4,2.038835,0,0
KLF10,Klf10,8,1,9,18.495146,0,0
KLF11,Klf11,1,0,1,6.029126,0,0
KLF12,Klf12,5,-6,-1,0,0,0
KLF13,Klf13,4,5,9,0.902913,0,0
KLF14,Klf14,-2,-1,-3,0,0,0
KLF15,Klf15,-2,3,1,0,0,0
KLF16,Klf16,2,-3,-1,1.805825,0,0
KLF17,Klf17,2,-4,-2,0,0,0
KLF2,Klf2,20,-11,9,27.92233,0,0
KLF3,Klf3,5,0,5,2.504854,0,0
KLF4,Klf4,19,-2,17,43.592233,0,0
KLF5,Klf5,3,-8,-5,4.087379,0,0
KLF6,Klf6,7,14,21,2.796117,0,0
KLF7,Klf7,5,0,5,5.728155,0,0
KLF8,Klf8,-2,-12,-14,0,0,0
KLF9,Klf9,7,0,7,2.07767,0,0
KLHDC1,Klhdc1,-3,-8,-11,6.757282,0,0
KLHDC10,Klhdc10,6,-3,3,13.262136,0,0
KLHDC2,Klhdc2,7,0,7,15.951456,0,0
KLHDC3,Klhdc3,9,-3,6,1.485437,0,0
KLHDC4,Klhdc4,7,-1,6,2.815534,0,0
KLHDC7A,Klhdc7a,-18,-7,-25,0,0,0
KLHDC7B,Klhdc7b,1,11,12,0,0,0
KLHDC8A,Klhdc8a,2,-3,-1,0,0,0
KLHDC8B,Klhdc8b,6,-4,2,3.621359,0,0
KLHDC9,Klhdc9,-1,-12,-13,0,0,0
KLHL1,Klhl1,0,0,0,0,0,0
KLHL10,Klhl10,-2,-5,-7,1.174757,0,0
KLHL11,Klhl11,3,-3,0,2.398058,0,0
KLHL12,Klhl12,12,-3,9,39.126214,0,0
KLHL13,Klhl13,-7,2,-5,1.213592,0,0
KLHL14,Klhl14,3,2,5,0,0,0
KLHL15,Klhl15,7,-2,5,4.980583,0,0
KLHL18,Klhl18,9,-12,-3,110.68932,7.833333,141
KLHL2,Klhl2,7,0,7,2.961165,0,0
KLHL20,Klhl20,2,-13,-11,13.572816,0,0
KLHL21,Klhl21,8,-1,7,4.582524,0,0
KLHL22,Klhl22,5,-3,2,0,0,0
KLHL23,Klhl23,1,-1,0,1.485437,0,0
KLHL24,Klhl24,7,-3,4,2.038835,0,0
KLHL25,Klhl25,74,-10,64,106.495146,0,0
KLHL26,Klhl26,18,1,19,4.184466,0,0
KLHL28,Klhl28,7,1,8,4.194175,0,0
KLHL29,Klhl29,-11,-3,-14,0,0,0
KLHL3,Klhl3,6,-3,3,0,0,0
KLHL30,Klhl30,2,-1,1,0,0,0
KLHL31,Klhl31,-3,2,-1,0,0,0
KLHL32,Klhl32,11,-9,2,9.728155,0,0
KLHL33,Klhl33,9,1,10,0,0,0
KLHL34,Klhl34,2,-3,-1,0,0,0
KLHL35,Klhl35,1,-5,-4,3.941748,0,0
KLHL36,Klhl36,5,1,6,5.466019,0,0
KLHL38,Klhl38,-3,0,-3,2.398058,0,0
KLHL4,Klhl4,-1,0,-1,0,0,0
KLHL40,Klhl40,7,12,19,0,0,0
KLHL41,Klhl41,0,1,1,0,0,0
KLHL42,Klhl42,5,-2,3,8.553398,0,0
KLHL5,Klhl5,3,-1,2,4.786408,0,0
KLHL6,Klhl6,1,-2,-1,5.31068,0,0
KLHL7,Klhl7,4,0,4,10.456311,0,0
KLHL8,Klhl8,3,-2,1,6.543689,0,0
KLHL9,Klhl9,1,-6,-5,9.699029,0,0
KLK1,Klk1,1,-1,0,0,0,0
KLK10,Klk10,-4,-9,-13,0,0,0
KLK11,Klk11,-1,3,2,0,0,0
KLK12,Klk12,3,1,4,0,0,0
KLK13,Klk13,15,-4,11,19.029126,0,0
KLK14,Klk14,19,-3,16,0,0,0
KLK15,Klk15,4,-4,0,0,0,0
KLK4,Klk4,5,-5,0,0,0,0
KLK5,Klk5,20,0,20,3.650485,0,0
KLK6,Klk6,24,1,25,28.097087,0,0
KLK7,Klk7,0,1,1,0,0,0
KLK8,Klk8,5,-1,4,0,0,0
KLK9,Klk9,10,-2,8,0,0,0
KLKB1,Klkb1,21,-4,17,0,0,0
KLRB1,Klrb1,-3,-5,-8,0,0,0
KLRC1,Klrc1,11,-1,10,0,0,0
KLRC2,Klrc2,10,-2,8,0,0,0
KLRC3,Klrc3,-8,-3,-11,0,0,0
KLRD1,Klrd1,7,11,18,0,0,0
KLRG1,Klrg1,17,3,20,88.436893,19.541667,0
KLRG2,Klrg2,4,3,7,0,0,0
KLRK1,Klrk1,6,-4,2,0,0,0
KMO,Kmo,5,-3,2,0,0,0
KMT2A,Kmt2a,7,-1,6,55.223301,0,0
KMT2B,Kmt2b,6,-5,1,4.592233,0,0
KMT2C,Kmt2c,10,-2,8,21.757282,0,0
KMT2D,Kmt2d,8,-7,1,23.378641,0,0
KMT2E,Kmt2e,11,2,13,36.728155,0,0
KMT5A,Kmt5a,4,0,4,1.067961,0,0
KMT5B,Kmt5b,3,0,3,13.029126,0,0
KMT5C,Kmt5c,1,-13,-12,28.31068,0,0
KNCN,Kncn,4,8,12,3.067961,0,0
KNDC1,Kndc1,2,0,2,0,0,0
KNG1,Kng1,6,1,7,0,0,0
KNL1,Knl1,3,-3,0,34.349515,0,0
KNOP1,Knop1,3,-6,-3,15.582524,0,0
KNSTRN,Knstrn,-6,-7,-13,3.466019,0,0
KNTC1,Kntc1,0,-7,-7,153.524272,4.625,0
KPNA1,Kpna1,10,-7,3,0,0,0
KPNA2,Kpna2,-1,-17,-18,2.932039,0,0
KPNA3,Kpna3,6,-2,4,2.291262,0,0
KPNA4,Kpna4,8,-4,4,4.533981,0,0
KPNA6,Kpna6,4,-3,1,0,0,0
KPNA7,Kpna7,3,-6,-3,0,0,0
KPNB1,Kpnb1,8,-8,0,22.029126,0,0
KPRP,Kprp,-2,1,-1,0,0,0
KPTN,Kptn,3,0,3,1.825243,0,0
KRAS,Kras,3,-8,-5,19,0,0
KRBA1,Krba1,4,-4,0,4.834951,0,0
KRCC1,Krcc1,5,1,6,5.864078,0,0
KREMEN1,Kremen1,4,0,4,0,0,0
KREMEN2,Kremen2,10,-5,5,21.553398,0,0
KRI1,Kri1,2,-7,-5,9.883495,0,0
KRIT1,Krit1,1,-6,-5,7.067961,0,0
KRR1,Krr1,1,-3,-2,3.61165,0,0
KRT1,Krt1,1,8,9,0,0,0
KRT10,Krt10,1,2,3,3.718447,0,0
KRT12,Krt12,14,0,14,0,0,0
KRT13,Krt13,16,-3,13,0,0,0
KRT14,Krt14,2,4,6,0,0,0
KRT15,Krt15,-1,1,0,0,0,0
KRT16,Krt16,12,1,13,0,0,0
KRT17,Krt17,5,4,9,0,0,0
KRT18,Krt18,6,8,14,36.883495,0,0
KRT19,Krt19,-4,10,6,2,0,0
KRT2,Krt2,-3,0,-3,0,0,0
KRT20,Krt20,3,13,16,2.475728,0,0
KRT222,Krt222,11,-4,7,0,0,0
KRT23,Krt23,-5,-3,-8,0,0,0
KRT24,Krt24,0,3,3,0,0,0
KRT25,Krt25,1,1,2,0,0,0
KRT26,Krt26,5,4,9,0,0,0
KRT27,Krt27,5,0,5,0,0,0
KRT28,Krt28,13,0,13,0,0,0
KRT31,Krt31,-1,2,1,0,0,0
KRT32,Krt32,0,0,0,0,0,0
KRT33A,Krt33a,9,4,13,6.796117,0,0
KRT33B,Krt33b,1,0,1,0,0,0
KRT34,Krt34,0,1,1,6.359223,0,0
KRT35,Krt35,-2,0,-2,0,0,0
KRT36,Krt36,-1,-3,-4,6.407767,11.25,0
KRT39,Krt39,2,0,2,0,0,0
KRT4,Krt4,2,-3,-1,0,0,0
KRT40,Krt40,2,1,3,0,0,0
KRT5,Krt5,4,9,13,5.572816,0,0
KRT6A,Krt6a,7,19,26,1.553398,0,0
KRT6B,Krt6b,0,2,2,0,0,0
KRT7,Krt7,1,3,4,5.31068,0,0
KRT71,Krt71,-1,-4,-5,0,0,0
KRT72,Krt72,2,0,2,0,0,0
KRT73,Krt73,1,-7,-6,0,0,0
KRT75,Krt75,3,0,3,1.446602,0,0
KRT76,Krt76,-1,-4,-5,0,0,0
KRT77,Krt77,-1,-4,-5,0,0,0
KRT78,Krt78,11,0,11,3.76699,0,0
KRT79,Krt79,-1,0,-1,0,0,0
KRT8,Krt8,2,-2,0,29.572816,0,0
KRT80,Krt80,1,2,3,3.543689,0,0
KRT81,Krt81,-6,2,-4,0,0,0
KRT82,Krt82,-1,0,-1,0,0,0
KRT83,Krt83,5,6,11,4.097087,0,0
KRT84,Krt84,-1,3,2,0,0,0
KRT86,Krt86,10,3,13,1.495146,0,0
KRT9,Krt9,0,0,0,0,0,0
KRTAP1-3,Krtap1-3,0,1,1,0,0,0
KRTAP1-4,Krtap1-4,-1,8,7,0,0,0
KRTAP1-5,Krtap1-5,-10,20,10,0,0,0
KRTAP10-10,Krtap10-10,0,3,3,0,0,0
KRTAP10-4,Krtap10-4,-3,-4,-7,5.456311,0,0
KRTAP11-1,Krtap11-1,3,0,3,0,0,0
KRTAP12-1,Krtap12-1,-3,-1,-4,0,0,0
KRTAP13-1,Krtap13-1,0,0,0,0,0,0
KRTAP16-1,Krtap16-1,1,-1,0,0,0,0
KRTAP17-1,Krtap17-1,-1,-11,-12,0,0,0
KRTAP19-1,Krtap19-1,3,0,3,0,0,0
KRTAP19-2,Krtap19-2,-2,0,-2,0,0,0
KRTAP19-3,Krtap19-3,-3,1,-2,0,0,0
KRTAP19-4,Krtap19-4,0,0,0,0,0,0
KRTAP19-5,Krtap19-5,20,0,20,0,0,0
KRTAP2-4,Krtap2-4,1,1,2,0.951456,0,0
KRTAP20-2,Krtap20-2,0,-2,-2,0,0,0
KRTAP21-1,Krtap21-1,1,-1,0,0,0,0
KRTAP22-2,Krtap22-2,-3,-6,-9,0,0,0
KRTAP24-1,Krtap24-1,0,-1,-1,0,0,0
KRTAP26-1,Krtap26-1,0,0,0,0,0,0
KRTAP27-1,Krtap27-1,0,-2,-2,0,0,0
KRTAP29-1,Krtap29-1,0,-2,-2,0,0,0
KRTAP3-1,Krtap3-1,-1,-2,-3,0,0,0
KRTAP3-2,Krtap3-2,2,14,16,0,0,0
KRTAP3-3,Krtap3-3,4,3,7,0,0,0
KRTAP4-1,Krtap4-1,-2,-2,-4,0,0,0
KRTAP4-16,Krtap4-16,3,21,24,0,0,0
KRTAP4-2,Krtap4-2,-1,3,2,0,0,0
KRTAP4-6,Krtap4-6,3,2,5,0,0,0
KRTAP4-7,Krtap4-7,-2,0,-2,0,0,0
KRTAP4-8,Krtap4-8,2,-2,0,0,0,0
KRTAP4-9,Krtap4-9,-7,1,-6,0,0,0
KRTAP5-1,Krtap5-1,15,6,21,0,0,0
KRTAP5-2,Krtap5-2,8,1,9,0,0,0
KRTAP5-3,Krtap5-3,2,3,5,0,0,0
KRTAP5-4,Krtap5-4,0,3,3,3.757282,0,0
KRTAP5-5,Krtap5-5,0,2,2,0,0,0
KRTAP6-1,Krtap6-1,6,-1,5,0,0,0
KRTAP6-2,Krtap6-2,-3,1,-2,0,0,0
KRTAP6-3,Krtap6-3,-1,-7,-8,0,0,0
KRTAP7-1,Krtap7-1,0,-1,-1,0,0,0
KRTAP8-1,Krtap8-1,-1,1,0,0,0,0
KRTAP9-1,Krtap9-1,1,0,1,0,0,0
KRTAP9-3,Krtap9-3,0,-3,-3,0,0,0
KRTCAP2,Krtcap2,5,1,6,4.533981,0,0
KRTCAP3,Krtcap3,15,-8,7,0,0,0
KRTDAP,Krtdap,22,4,26,0,0,0
KSR1,Ksr1,26,2,28,3.650485,0,0
KSR2,Ksr2,-5,-4,-9,11.116505,0,0
KTI12,Kti12,-5,-2,-7,4.475728,0,0
KTN1,Ktn1,6,-7,-1,12.07767,0,0
KXD1,Kxd1,-1,-6,-7,9.961165,0,0
KY,Ky,1,0,1,0,0,0
KYAT1,Kyat1,13,2,15,13.15534,0,0
KYAT3,Kyat3,-4,-4,-8,8.601942,2.541667,0
KYNU,Kynu,0,-5,-5,0,0,0
L1CAM,L1cam,5,-5,0,2.417476,0,0
L1TD1,L1td1,-1,5,4,0,0,0
L2HGDH,L2hgdh,3,-9,-6,6.883495,0,0
L3HYPDH,L3hypdh,-4,0,-4,73.368932,0,0
L3MBTL1,L3mbtl1,2,3,5,1.135922,0,0
L3MBTL2,L3mbtl2,5,-2,3,9.271845,0,0
L3MBTL3,L3mbtl3,28,4,32,18.592233,0,0
L3MBTL4,L3mbtl4,2,0,2,1.466019,0,0
LACC1,Lacc1,-1,-3,-4,1.84466,0,0
LACTB,Lactb,4,-3,1,6.126214,0,0
LACTB2,Lactb2,2,-3,-1,14.864078,0,0
LACTBL1,Lactbl1,9,-5,4,3.097087,0,0
LAD1,Lad1,7,9,16,1.300971,0,0
LAG3,Lag3,67,4,71,0,0,0
LAGE3,Lage3,12,-6,6,4.330097,0,0
LAIR1,Lair1,1,-9,-8,0,0,0
LALBA,Lalba,9,1,10,0,0,0
LAMA1,Lama1,9,5,14,0,0,0
LAMA2,Lama2,-2,2,0,0,0,0
LAMA3,Lama3,0,8,8,4.456311,0,0
LAMA4,Lama4,8,-1,7,0,0,0
LAMA5,Lama5,18,1,19,5.038835,0,0
LAMB1,Lamb1,7,0,7,1.621359,0,0
LAMB2,Lamb2,7,-4,3,1.262136,0,0
LAMB3,Lamb3,1,-4,-3,0.912621,0,0
LAMC1,Lamc1,4,3,7,0.932039,0,0
LAMC2,Lamc2,2,4,6,5.941748,0,0
LAMC3,Lamc3,6,5,11,4.087379,0,0
LAMP1,Lamp1,6,0,6,15.76699,0,0
LAMP2,Lamp2,4,1,5,0,0,0
LAMP3,Lamp3,6,-2,4,1.339806,0,0
LAMP5,Lamp5,6,-8,-2,0,0,0
LAMTOR1,Lamtor1,6,-4,2,7.815534,0,0
LAMTOR2,Lamtor2,10,-8,2,8.533981,0,0
LAMTOR3,Lamtor3,11,-1,10,7.330097,0,0
LAMTOR4,Lamtor4,13,-2,11,2.660194,0,0
LAMTOR5,Lamtor5,4,-2,2,18.708738,0,104
LANCL1,Lancl1,0,-5,-5,2.067961,0,0
LANCL2,Lancl2,2,-7,-5,11.184466,0,0
LANCL3,Lancl3,0,6,6,0,0,0
LAP3,Lap3,7,-6,1,15.514563,0,0
LAPTM4A,Laptm4a,7,2,9,1.281553,0,0
LAPTM4B,Laptm4b,9,7,16,5.660194,0,0
LAPTM5,Laptm5,-1,11,10,0,0,0
LARGE1,Large1,8,-4,4,6.291262,0,0
LARGE2,Large2,-2,-2,-4,11.436893,0,0
LARP1,Larp1,8,-3,5,8.398058,0,0
LARP1B,Larp1b,2,-3,-1,2.61165,0,0
LARP4,Larp4,11,-5,6,18.427184,0,0
LARP4B,Larp4b,5,0,5,1.174757,0,0
LARP6,Larp6,-3,-4,-7,2.776699,0,0
LARP7,Larp7,9,-9,0,0,0,0
LARS2,Lars2,3,3,6,14.359223,0,0
LAS1L,Las1l,3,-4,-1,0,0,0
LASP1,Lasp1,7,-1,6,15.640777,0,0
LAT,Lat,7,-8,-1,1.825243,0,0
LAT2,Lat2,4,8,12,2.223301,0,0
LATS1,Lats1,6,-7,-1,7.048544,0,0
LATS2,Lats2,1,2,3,0,0,0
LAX1,Lax1,0,1,1,0,0,0
LAYN,Layn,2,5,7,0,0,0
LBH,Lbh,30,3,33,0,0,0
LBHD1,Lbhd1,3,-4,-1,8.466019,0,0
LBHD2,Lbhd2,8,-6,2,0,0,0
LBP,Lbp,3,7,10,0,0,0
LBR,Lbr,2,-3,-1,3.252427,0,0
LBX1,Lbx1,2,0,2,0,0,0
LBX2,Lbx2,-9,22,13,16.194175,0,0
LCA5,Lca5,4,-8,-4,4.067961,0,0
LCA5L,Lca5l,-4,-13,-17,36.84466,0,0
LCAT,Lcat,15,-7,8,0,0,0
LCE1B,Lce1b,0,-2,-2,0,0,0
LCE1C,Lce1c,-2,0,-2,0,0,0
LCE1D,Lce1d,3,-5,-2,0,0,0
LCE1E,Lce1e,0,3,3,0,0,0
LCE1F,Lce1f,3,8,11,0,0,0
LCE3A,Lce3a,-1,-1,-2,0,0,0
LCE3B,Lce3b,-1,0,-1,0,0,0
LCE3C,Lce3c,2,-8,-6,0,0,0
LCE3D,Lce3d,0,-2,-2,0,0,0
LCE3E,Lce3e,4,-1,3,0,0,0
LCE6A,Lce6a,2,-8,-6,0,0,0
LCK,Lck,28,-7,21,3.776699,0,0
LCLAT1,Lclat1,8,-2,6,8.786408,0,0
LCMT1,Lcmt1,0,-6,-6,2.116505,0,0
LCMT2,Lcmt2,-17,-5,-22,10.92233,0,0
LCN10,Lcn10,98,0,98,0.621359,0,0
LCN12,Lcn12,37,-6,31,2.932039,0,0
LCN2,Lcn2,-4,17,13,0,0,0
LCN6,Lcn6,5,-1,4,5.106796,0,0
LCN8,Lcn8,-2,1,-1,0,0,0
LCN9,Lcn9,0,2,2,0,0,0
LCOR,Lcor,6,-3,3,3.436893,0,0
LCORL,Lcorl,3,-2,1,12.84466,0,0
LCP1,Lcp1,1,-4,-3,27.475728,0,0
LCP2,Lcp2,1,2,3,0,0,0
LCT,Lct,43,2,45,0,0,0
LCTL,Lctl,4,-1,3,0,0,0
LDAH,Ldah,7,-3,4,1.592233,0,0
LDB1,Ldb1,8,-8,0,0,0,0
LDB2,Ldb2,3,1,4,0,0,0
LDB3,Ldb3,5,-5,0,0,0,0
LDHA,Ldha,5,-6,-1,5.126214,0,0
LDHAL6B,Ldhal6b,10,-17,-7,0,0,0
LDHB,Ldhb,8,0,8,43.980583,0,0
LDHC,Ldhc,20,-1,19,0,0,0
LDHD,Ldhd,-1,0,-1,0,0,0
LDLR,Ldlr,7,-8,-1,21.291262,0,0
LDLRAD1,Ldlrad1,6,-2,4,0,0,0
LDLRAD2,Ldlrad2,-5,-11,-16,0,0,0
LDLRAD3,Ldlrad3,10,-7,3,3.475728,0,0
LDLRAD4,Ldlrad4,8,-1,7,2.291262,0,0
LDLRAP1,Ldlrap1,-2,0,-2,2.825243,0,0
LDOC1,Ldoc1,5,-2,3,2.223301,0,0
LEAP2,Leap2,49,1,50,0,0,0
LECT2,Lect2,0,-4,-4,0,0,0
LEF1,Lef1,2,-1,1,1.718447,0,0
LEFTY1,Lefty1,15,-12,3,0,0,0
LEFTY2,Lefty2,17,-8,9,0,0,0
LEKR1,Lekr1,3,-11,-8,15.184466,0,0
LELP1,Lelp1,1,-1,0,0,0,0
LEMD1,Lemd1,9,1,10,0,0,0
LEMD2,Lemd2,6,-2,4,9.466019,0,0
LEMD3,Lemd3,0,0,0,9.126214,0,0
LENEP,Lenep,65,1,66,111.834951,0,0
LENG1,Leng1,3,-1,2,28.718447,0,0
LENG8,Leng8,7,-7,0,8.504854,0,0
LENG9,Leng9,-22,-4,-26,5.504854,0,0
LEO1,Leo1,-14,-6,-20,8.631068,0,0
LEP,Lep,2,-7,-5,0,0,0
LEPR,Lepr,0,10,10,4.621359,0,0
LEPROT,Leprot,2,-5,-3,4.621359,0,0
LEPROTL1,Leprotl1,4,-6,-2,2.718447,0,0
LETM1,Letm1,8,-3,5,25.601942,0,0
LETM2,Letm2,9,0,9,2.485437,0,0
LETMD1,Letmd1,7,-6,1,0,0,0
LEXM,Lexm,0,-14,-14,0,0,0
LFNG,Lfng,-25,-14,-39,26.378641,0,0
LGALS1,Lgals1,15,-8,7,20.466019,0,0
LGALS12,Lgals12,-2,-1,-3,0,0,0
LGALS2,Lgals2,-3,-9,-12,2.601942,0,0
LGALS3,Lgals3,7,3,10,4.466019,0,0
LGALS3BP,Lgals3bp,6,-10,-4,0,0,0
LGALS4,Lgals4,70,-1,69,0,0,0
LGALS7,Lgals7,29,18,47,36.631068,0,0
LGALS8,Lgals8,-1,-10,-11,0,0,0
LGALS9,Lgals9,8,1,9,0,0,0
LGALSL,Lgalsl,4,-1,3,5.38835,0,0
LGI1,Lgi1,7,-3,4,0,0,0
LGI2,Lgi2,-2,4,2,0,0,0
LGI3,Lgi3,6,6,12,0,0,0
LGI4,Lgi4,-2,-2,-4,0,0,0
LGMN,Lgmn,14,5,19,17.23301,0,0
LGR4,Lgr4,9,0,9,3.038835,0,0
LGR5,Lgr5,1,-2,-1,1.834951,0,0
LGR6,Lgr6,1,-3,-2,5.592233,0,0
LGSN,Lgsn,4,5,9,0,0,0
LHB,Lhb,9,-7,2,3.106796,0,0
LHCGR,Lhcgr,1,-1,0,0,0,0
LHFPL1,Lhfpl1,-2,-1,-3,0,0,0
LHFPL2,Lhfpl2,-1,6,5,6.592233,0,0
LHFPL3,Lhfpl3,4,-9,-5,0,0,0
LHFPL4,Lhfpl4,3,5,8,0,0,0
LHFPL5,Lhfpl5,2,-3,-1,1.553398,0,0
LHPP,Lhpp,0,-6,-6,3.38835,0,0
LHX1,Lhx1,5,-2,3,0,0,0
LHX2,Lhx2,8,-3,5,0,0,0
LHX3,Lhx3,0,2,2,0,0,0
LHX4,Lhx4,22,-2,20,15.242718,0,0
LHX5,Lhx5,5,-5,0,0,0,0
LHX6,Lhx6,7,-3,4,0,0,0
LHX8,Lhx8,-2,0,-2,1.407767,0,0
LHX9,Lhx9,2,4,6,4.883495,0,0
LIAS,Lias,1,-1,0,0,0,0
LIF,Lif,-24,-2,-26,12.097087,0,0
LIFR,Lifr,11,1,12,6.708738,0,0
LIG1,Lig1,-3,-3,-6,6.242718,0,0
LIG3,Lig3,-11,-5,-16,2.320388,0,0
LIG4,Lig4,7,-9,-2,4.330097,0,0
LILRA5,Lilra5,0,-2,-2,5.708738,0,0
LILRA6,Lilra6,7,-3,4,0,0,0
LIM2,Lim2,0,3,3,3.07767,0,0
LIMA1,Lima1,5,4,9,8.572816,0,0
LIMCH1,Limch1,8,-7,1,4.349515,0,0
LIMD1,Limd1,4,-4,0,5.68932,0,0
LIMD2,Limd2,-9,-6,-15,0,0,0
LIME1,Lime1,7,-4,3,2.786408,0,0
LIMK1,Limk1,1,2,3,0.786408,0,0
LIMK2,Limk2,4,-3,1,5.097087,0,0
LIMS1,Lims1,6,-5,1,37.815534,0,0
LIMS2,Lims2,4,6,10,0,0,0
LIN28A,Lin28a,2,-8,-6,0,0,0
LIN28B,Lin28b,7,-2,5,0,0,0
LIN37,Lin37,-5,-1,-6,0,0,0
LIN52,Lin52,6,3,9,0.68932,0,0
LIN7A,Lin7a,3,0,3,2,0,0
LIN7B,Lin7b,-7,7,0,1.320388,0,0
LIN7C,Lin7c,2,-6,-4,7.339806,0,0
LIN9,Lin9,3,-7,-4,11.514563,0,0
LINGO1,Lingo1,5,0,5,3.864078,0,0
LINGO2,Lingo2,-4,-4,-8,0,0,0
LINGO3,Lingo3,1,4,5,12.31068,0,0
LINGO4,Lingo4,3,4,7,0,0,0
LINS1,Lins1,1,-10,-9,21.708738,0,0
LIPA,Lipa,6,3,9,2.320388,0,0
LIPC,Lipc,0,1,1,0,0,0
LIPE,Lipe,-13,2,-11,0,0,0
LIPF,Lipf,0,-2,-2,0,0,0
LIPG,Lipg,8,7,15,0,0,0
LIPH,Liph,-1,-1,-2,3.009709,0,0
LIPI,Lipi,1,-6,-5,0,0,0
LIPK,Lipk,2,-1,1,33.048544,0,0
LIPM,Lipm,0,-1,-1,0,0,0
LIPN,Lipn,0,-1,-1,0,0,0
LIPT1,Lipt1,-6,-4,-10,0,0,0
LIPT2,Lipt2,-29,-17,-46,11.932039,0,0
LITAF,Litaf,10,8,18,0,0,0
LIX1,Lix1,17,-1,16,0,0,0
LIX1L,Lix1l,5,0,5,6.417476,0,0
LKAAEAR1,Lkaaear1,1,-25,-24,6.349515,16.958333,0
LLCFC1,Llcfc1,2,1,3,0,0,0
LLGL1,Llgl1,7,-5,2,0,0,0
LLGL2,Llgl2,18,0,18,10.31068,0,0
LLPH,Llph,5,1,6,1.135922,0,0
LMAN1,Lman1,4,-1,3,20.786408,0,0
LMAN1L,Lman1l,36,21,57,31.029126,0,0
LMAN2,Lman2,8,-3,5,6.058252,0,0
LMAN2L,Lman2l,15,-3,12,51.786408,0,0
LMBR1,Lmbr1,3,-3,0,8.203883,0,0
LMBR1L,Lmbr1l,5,-7,-2,0,0,0
LMBRD1,Lmbrd1,6,-2,4,35.029126,0,0
LMBRD2,Lmbrd2,5,-4,1,10.68932,0,0
LMCD1,Lmcd1,3,3,6,4.728155,0,0
LMF1,Lmf1,7,-10,-3,48.203883,0,0
LMF2,Lmf2,7,-2,5,15.087379,0,0
LMLN,Lmln,9,-3,6,27.048544,0,0
LMNA,Lmna,5,-1,4,52.203883,0,0
LMNB1,Lmnb1,-1,-3,-4,6.873786,0,0
LMNB2,Lmnb2,9,-10,-1,3.349515,0,0
LMNTD1,Lmntd1,5,-4,1,0,0,0
LMNTD2,Lmntd2,13,-5,8,1.184466,0,0
LMO1,Lmo1,3,1,4,0,0,0
LMO2,Lmo2,1,3,4,0.970874,0,0
LMO3,Lmo3,5,-8,-3,0,0,0
LMO4,Lmo4,11,3,14,4.485437,0,0
LMO7,Lmo7,7,0,7,0,0,0
LMOD1,Lmod1,2,1,3,0,0,0
LMOD2,Lmod2,10,-7,3,0,0,0
LMOD3,Lmod3,6,-8,-2,0,0,0
LMTK2,Lmtk2,9,-1,8,4.242718,0,0
LMTK3,Lmtk3,17,-6,11,8.533981,0,0
LMX1A,Lmx1a,0,-1,-1,0,0,0
LMX1B,Lmx1b,-2,-4,-6,8.524272,0,0
LNP1,Lnp1,-1,-1,-2,3.786408,0,0
LNPEP,Lnpep,4,0,4,19.135922,0,0
LNPK,Lnpk,5,-1,4,2.640777,0,0
LNX1,Lnx1,2,2,4,7.106796,0,0
LNX2,Lnx2,1,-4,-3,0.970874,0,0
LONP1,Lonp1,6,2,8,16.038835,0,0
LONP2,Lonp2,4,-4,0,11.398058,0,0
LONRF1,Lonrf1,0,0,0,3.796117,0,0
LONRF2,Lonrf2,5,3,8,2.291262,0,0
LONRF3,Lonrf3,4,7,11,4.281553,0,0
LOX,Lox,-2,-6,-8,0.970874,0,0
LOXHD1,Loxhd1,4,-6,-2,9.543689,0,0
LOXL1,Loxl1,0,0,0,10.475728,0,0
LOXL2,Loxl2,4,5,9,0,0,0
LOXL3,Loxl3,-2,-9,-11,6.601942,0,0
LOXL4,Loxl4,0,-6,-6,0,0,0
LPAR1,Lpar1,7,-2,5,2.07767,0,0
LPAR2,Lpar2,-2,-1,-3,2.07767,0,0
LPAR3,Lpar3,0,3,3,4.805825,0,0
LPAR4,Lpar4,3,1,4,0,0,0
LPAR5,Lpar5,18,-7,11,0,0,0
LPAR6,Lpar6,14,3,17,0,0,0
LPCAT1,Lpcat1,7,-1,6,2.126214,0,0
LPCAT2,Lpcat2,-3,-9,-12,0,0,0
LPCAT3,Lpcat3,-5,-4,-9,10.466019,0,0
LPCAT4,Lpcat4,5,-9,-4,17.504854,0,0
LPGAT1,Lpgat1,3,-3,0,7.543689,0,0
LPIN1,Lpin1,6,-9,-3,11.61165,0,0
LPIN2,Lpin2,-1,-1,-2,19.436893,0,0
LPIN3,Lpin3,-8,-3,-11,0,0,0
LPL,Lpl,-4,5,1,0,0,0
LPO,Lpo,4,1,5,0,0,0
LPP,Lpp,7,-1,6,7.980583,0,0
LPXN,Lpxn,-2,-14,-16,3.514563,0,0
LRAT,Lrat,0,-3,-3,1.601942,0,0
LRATD1,Lratd1,1,3,4,0,0,0
LRATD2,Lratd2,3,0,3,68.76699,42.916667,0
LRBA,Lrba,3,-2,1,6.708738,0,0
LRCH1,Lrch1,0,1,1,0.834951,0,0
LRCH2,Lrch2,3,-4,-1,0,0,0
LRCH3,Lrch3,3,-2,1,7.932039,3.458333,0
LRCH4,Lrch4,10,-10,0,7.631068,0,0
LRCOL1,Lrcol1,7,9,16,0,0,0
LRFN1,Lrfn1,-4,2,-2,3.087379,0,0
LRFN2,Lrfn2,-2,0,-2,0,0,0
LRFN3,Lrfn3,-2,-2,-4,4.61165,0,0
LRFN4,Lrfn4,7,-7,0,6.174757,0,0
LRFN5,Lrfn5,-1,1,0,0,0,0
LRG1,Lrg1,3,23,26,2.883495,0,0
LRGUK,Lrguk,3,-9,-6,33.165049,0,0
LRIF1,Lrif1,27,-7,20,212.359223,84.916667,230
LRIG1,Lrig1,5,-2,3,4.669903,0,0
LRIG2,Lrig2,4,-1,3,0.990291,0,0
LRIG3,Lrig3,3,3,6,5.466019,0,0
LRIT1,Lrit1,-3,-3,-6,5.194175,0,0
LRIT2,Lrit2,3,0,3,0,0,0
LRIT3,Lrit3,63,11,74,0,0,0
LRMDA,Lrmda,3,-10,-7,1.990291,0,0
LRP1,Lrp1,7,0,7,1.07767,0,0
LRP10,Lrp10,7,-2,5,4.436893,0,0
LRP11,Lrp11,6,-2,4,13.893204,0,0
LRP12,Lrp12,4,-6,-2,14.669903,0,0
LRP1B,Lrp1b,5,-8,-3,0,0,0
LRP2,Lrp2,2,1,3,1.834951,0,0
LRP2BP,Lrp2bp,11,-5,6,57.31068,0,0
LRP3,Lrp3,25,2,27,0,0,0
LRP4,Lrp4,13,4,17,2.019417,0,0
LRP5,Lrp5,12,0,12,36.436893,0,0
LRP6,Lrp6,3,-1,2,13.854369,0,0
LRP8,Lrp8,0,-5,-5,3.271845,0,0
LRPAP1,Lrpap1,5,-9,-4,43.873786,0,0
LRPPRC,Lrpprc,5,0,5,12.067961,0,0
LRR1,Lrr1,1,-13,-12,4.854369,0,0
LRRC1,Lrrc1,4,1,5,9.757282,0,0
LRRC10,Lrrc10,7,5,12,1.446602,0,0
LRRC10B,Lrrc10b,3,-4,-1,1.145631,0,0
LRRC14,Lrrc14,10,-6,4,6.660194,0,0
LRRC14B,Lrrc14b,5,-5,0,17.31068,0,0
LRRC15,Lrrc15,11,2,13,12.980583,0,0
LRRC17,Lrrc17,-4,2,-2,2.067961,0,0
LRRC18,Lrrc18,-6,-4,-10,0,0,0
LRRC19,Lrrc19,0,-9,-9,0,0,0
LRRC2,Lrrc2,2,9,11,0,0,0
LRRC20,Lrrc20,8,-12,-4,10.359223,0,0
LRRC23,Lrrc23,7,0,7,38.106796,0,0
LRRC24,Lrrc24,-7,-3,-10,4.708738,0,0
LRRC25,Lrrc25,3,-8,-5,0,0,0
LRRC26,Lrrc26,4,24,28,0,0,0
LRRC27,Lrrc27,4,-9,-5,44.572816,0,0
LRRC28,Lrrc28,2,-1,1,7.223301,0,0
LRRC3,Lrrc3,-3,-1,-4,0,0,0
LRRC30,Lrrc30,1,0,1,0,0,0
LRRC31,Lrrc31,3,4,7,0,0,0
LRRC32,Lrrc32,-2,2,0,0,0,0
LRRC34,Lrrc34,-2,-5,-7,4.650485,0,0
LRRC36,Lrrc36,11,-4,7,0,0,0
LRRC37A,Lrrc37a,3,-8,-5,1.533981,0,0
LRRC38,Lrrc38,1,1,2,0.854369,0,0
LRRC39,Lrrc39,5,-7,-2,0,0,0
LRRC3B,Lrrc3b,5,-3,2,0,0,0
LRRC3C,Lrrc3c,0,0,0,0,0,0
LRRC4,Lrrc4,30,-8,22,1,0,0
LRRC40,Lrrc40,2,1,3,13.058252,0,0
LRRC41,Lrrc41,5,-4,1,2.737864,0,0
LRRC42,Lrrc42,-1,-5,-6,3.495146,0,0
LRRC43,Lrrc43,9,5,14,0,0,0
LRRC45,Lrrc45,5,4,9,2.582524,0,0
LRRC46,Lrrc46,5,-10,-5,41.970874,0,0
LRRC47,Lrrc47,5,-1,4,10.009709,0,0
LRRC49,Lrrc49,3,-4,-1,9.61165,0,0
LRRC4B,Lrrc4b,5,-9,-4,1.436893,0,0
LRRC4C,Lrrc4c,8,-17,-9,0,0,0
LRRC52,Lrrc52,0,-5,-5,0,0,0
LRRC55,Lrrc55,0,-2,-2,0,0,0
LRRC56,Lrrc56,8,-3,5,66.708738,0,0
LRRC57,Lrrc57,-2,4,2,9.407767,0,0
LRRC58,Lrrc58,3,-3,0,23.194175,4.125,0
LRRC59,Lrrc59,4,-2,2,29.097087,0,0
LRRC61,Lrrc61,-2,-9,-11,54.524272,0,0
LRRC63,Lrrc63,0,0,0,1.339806,0,0
LRRC66,Lrrc66,19,-4,15,0,0,0
LRRC69,Lrrc69,10,-3,7,0,0,0
LRRC7,Lrrc7,-1,0,-1,1.427184,0,0
LRRC71,Lrrc71,-3,-7,-10,0,0,0
LRRC72,Lrrc72,7,2,9,0,0,0
LRRC73,Lrrc73,17,-2,15,59.815534,0,0
LRRC74A,Lrrc74a,2,1,3,0,0,0
LRRC74B,Lrrc74b,-3,-2,-5,0,0,0
LRRC75A,Lrrc75a,-2,-12,-14,0,0,0
LRRC75B,Lrrc75b,-6,-11,-17,0,0,0
LRRC8A,Lrrc8a,7,-8,-1,13.15534,0,0
LRRC8B,Lrrc8b,2,-3,-1,4.902913,0,0
LRRC8C,Lrrc8c,8,-1,7,5.504854,0,0
LRRC8D,Lrrc8d,2,2,4,4.776699,0,0
LRRC8E,Lrrc8e,4,-11,-7,7.563107,0,0
LRRC9,Lrrc9,-2,-4,-6,0,0,0
LRRCC1,Lrrcc1,1,-12,-11,13.116505,0,0
LRRD1,Lrrd1,10,2,12,1.339806,0,0
LRRFIP1,Lrrfip1,3,5,8,10.631068,0,0
LRRFIP2,Lrrfip2,10,-4,6,7.514563,0,0
LRRIQ1,Lrriq1,2,-6,-4,0.776699,0,0
LRRIQ3,Lrriq3,1,-7,-6,2.582524,0,0
LRRIQ4,Lrriq4,17,-6,11,0,0,0
LRRK1,Lrrk1,2,2,4,1.135922,0,0
LRRK2,Lrrk2,-1,-4,-5,0.970874,0,0
LRRN1,Lrrn1,7,4,11,1.990291,0,0
LRRN2,Lrrn2,5,-2,3,13.504854,0,0
LRRN3,Lrrn3,2,-3,-1,0,0,0
LRRN4,Lrrn4,-3,-8,-11,0,0,0
LRRN4CL,Lrrn4cl,20,1,21,0,0,0
LRRTM1,Lrrtm1,3,-3,0,0,0,0
LRRTM2,Lrrtm2,2,2,4,0,0,0
LRRTM3,Lrrtm3,2,2,4,1.330097,0,0
LRRTM4,Lrrtm4,10,3,13,0,0,0
LRSAM1,Lrsam1,7,-6,1,19.640777,0,0
LRTM1,Lrtm1,4,-4,0,0,0,0
LRTM2,Lrtm2,2,-6,-4,0,0,0
LRWD1,Lrwd1,13,-19,-6,19.058252,0,0
LSAMP,Lsamp,11,0,11,0,0,0
LSG1,Lsg1,4,-1,3,19.990291,0,0
LSM1,Lsm1,4,-1,3,2.029126,0,0
LSM10,Lsm10,3,-13,-10,4.76699,0,0
LSM11,Lsm11,5,-7,-2,17.087379,0,0
LSM12,Lsm12,1,0,1,12.893204,0,0
LSM14A,Lsm14a,3,0,3,4.533981,0,0
LSM14B,Lsm14b,8,-4,4,8.495146,0,0
LSM2,Lsm2,6,-1,5,8.262136,0,0
LSM3,Lsm3,6,-3,3,6.019417,0,0
LSM4,Lsm4,9,-6,3,12.436893,0,0
LSM5,Lsm5,3,-12,-9,11.728155,0,0
LSM6,Lsm6,8,-8,0,8.407767,0,0
LSM7,Lsm7,7,-4,3,3.427184,0,0
LSM8,Lsm8,6,-7,-1,12.699029,0,0
LSMEM1,Lsmem1,113,-9,104,0,0,0
LSMEM2,Lsmem2,43,2,45,0,0,0
LSP1,Lsp1,6,-5,1,0.815534,0,0
LSR,Lsr,-3,1,-2,0,0,0
LSS,Lss,5,-2,3,1.932039,0,0
LST1,Lst1,19,-5,14,1.194175,0,0
LTA,Lta,154,-6,148,0,0,0
LTA4H,Lta4h,7,-4,3,27.456311,0,0
LTB,Ltb,16,1,17,4.038835,0,0
LTB4R2,Ltb4r2,-1,7,6,0,0,0
LTBP1,Ltbp1,8,4,12,18.834951,0,0
LTBP2,Ltbp2,-8,-2,-10,3.84466,0,0
LTBP3,Ltbp3,7,3,10,3.271845,0,0
LTBP4,Ltbp4,5,2,7,46.067961,0,0
LTBR,Ltbr,-9,-1,-10,8.601942,0,0
LTC4S,Ltc4s,6,11,17,6.84466,0,0
LTF,Ltf,-4,2,-2,4.330097,0,0
LTK,Ltk,11,6,17,0,0,0
LTN1,Ltn1,6,-3,3,1.203883,0,0
LTO1,LTO1,3,-1,2,5.757282,0,0
LTV1,Ltv1,-13,-4,-17,6.980583,0,0
LUC7L,Luc7l,0,-2,-2,11.980583,0,0
LUC7L2,Luc7l2,5,-5,0,40.165049,0,0
LUC7L3,Luc7l3,5,1,6,7.912621,0,0
LUM,Lum,-1,-2,-3,2.980583,0,0
LURAP1,Lurap1,4,-8,-4,3.92233,0,0
LURAP1L,Lurap1l,12,0,12,0,0,0
LUZP1,Luzp1,9,-7,2,1.504854,0,0
LUZP2,Luzp2,4,-4,0,4.07767,0,0
LUZP4,Luzp4,0,-7,-7,0,0,0
LVRN,Lvrn,15,0,15,0,0,0
LXN,Lxn,3,-3,0,0,0,0
LY6D,Ly6d,-4,4,0,0,0,0
LY6E,Ly6e,8,1,9,0,0,0
LY6G5B,Ly6g5b,-5,1,-4,2.660194,0,0
LY6G5C,Ly6g5c,5,9,14,0,0,0
LY6G6C,Ly6g6c,89,26,115,1.834951,0,0
LY6G6D,Ly6g6d,12,16,28,1.834951,0,0
LY6G6E,Ly6g6e,42,-1,41,0,0,0
LY6G6F,Ly6g6f,5,-5,0,4.961165,0,0
LY6H,Ly6h,2,0,2,0,0,0
LY6K,Ly6k,2,22,24,70.359223,0,0
LY6L,Ly6l,-2,1,-1,0,0,0
LY75,Ly75,-1,0,-1,0,0,0
LY86,Ly86,1,5,6,0,0,0
LY9,Ly9,-5,-1,-6,1.223301,0,0
LY96,Ly96,18,2,20,8.135922,0,0
LYAR,Lyar,3,-17,-14,4.533981,0,0
LYG1,Lyg1,40,3,43,0,0,0
LYG2,Lyg2,50,4,54,0,0,0
LYL1,Lyl1,13,10,23,2.359223,0,0
LYN,Lyn,4,1,5,0,0,0
LYNX1,Lynx1,7,-8,-1,0.621359,0,0
LYPD1,Lypd1,14,12,26,0,0,0
LYPD2,Lypd2,6,5,11,0,0,0
LYPD3,Lypd3,1,4,5,0,0,0
LYPD4,Lypd4,44,-2,42,0,0,0
LYPD5,Lypd5,35,-8,27,1.058252,0,0
LYPD6,Lypd6,5,-6,-1,1.019417,0,0
LYPD6B,Lypd6b,6,-2,4,2.495146,0,0
LYPD8,Lypd8,2,-3,-1,0,0,0
LYPLA1,Lypla1,6,-2,4,12.631068,0,0
LYPLA2,Lypla2,10,-4,6,3.728155,0,0
LYPLAL1,Lyplal1,5,-7,-2,7.893204,0,0
LYRM1,Lyrm1,7,-7,0,11.776699,0,0
LYRM2,Lyrm2,1,-9,-8,7.757282,0,0
LYRM4,Lyrm4,6,-6,0,46.23301,0,0
LYRM7,Lyrm7,4,-6,-2,0,0,0
LYRM9,Lyrm9,1,3,4,0.92233,0,0
LYSMD1,Lysmd1,1,-1,0,11.553398,0,0
LYSMD2,Lysmd2,-9,-7,-16,5.883495,0,0
LYSMD3,Lysmd3,7,-3,4,46.339806,0,0
LYSMD4,Lysmd4,-1,-1,-2,0,0,0
LYST,Lyst,2,12,14,2.504854,0,0
LYVE1,Lyve1,19,7,26,1.504854,0,0
LYZL1,Lyzl1,3,-6,-3,0,0,0
LYZL4,Lyzl4,5,-2,3,0,0,0
LYZL6,Lyzl6,9,-5,4,5.854369,0,0
LZIC,Lzic,5,-2,3,29.582524,0,0
LZTFL1,Lztfl1,10,-6,4,24.106796,0,0
LZTR1,Lztr1,13,-7,6,4.524272,0,0
LZTS1,Lzts1,-9,-7,-16,0,0,0
LZTS2,Lzts2,3,2,5,1.262136,0,0
LZTS3,Lzts3,3,-5,-2,2.543689,0,0
M1AP,M1ap,3,-11,-8,0,0,0
M6PR,M6pr,7,-2,5,88.436893,19.541667,0
MAB21L1,Mab21l1,-4,6,2,0,0,0
MAB21L2,Mab21l2,-3,-4,-7,0,0,0
MAB21L3,Mab21l3,4,-5,-1,0,0,0
MAB21L4,Mab21l4,0,0,0,0,0,0
MACC1,Macc1,1,-9,-8,14.145631,0,0
MACF1,Macf1,10,1,11,0,0,0
MACIR,Macir,-6,-3,-9,7.067961,3.833333,0
MACO1,Maco1,3,-3,0,3.92233,0,0
MACROD1,Macrod1,8,-2,6,16.601942,0,0
MACROD2,Macrod2,4,-12,-8,2.893204,0,0
MACROH2A1,Macroh2a1,7,-6,1,5.883495,0,0
MACROH2A2,Macroh2a2,20,-7,13,0.932039,0,0
MAD1L1,Mad1l1,3,-1,2,5.834951,0,0
MAD2L1,Mad2l1,4,-3,1,0.951456,0,0
MAD2L1BP,Mad2l1bp,-2,-5,-7,6.281553,0,0
MAD2L2,Mad2l2,8,-9,-1,7.76699,0,0
MADCAM1,Madcam1,18,-1,17,4.252427,0,0
MADD,Madd,7,-2,5,8.116505,0,0
MAEA,Maea,6,-1,5,3,0,0
MAEL,Mael,-7,-1,-8,3.524272,0,0
MAF,Maf,23,4,27,0,0,0
MAF1,Maf1,11,-1,10,23.504854,0,0
MAFA,Mafa,69,-3,66,59.417476,0,0
MAFB,Mafb,86,-3,83,0,0,0
MAFF,Maff,25,19,44,1.126214,0,0
MAFG,Mafg,8,1,9,19.951456,0,0
MAFK,Mafk,11,0,11,3.815534,0,0
MAG,Mag,-2,-9,-11,0,0,0
MAGEA1,Magea1,-2,1,-1,0,0,0
MAGEA10,Magea10,1,5,6,0,0,0
MAGEA2,Magea2,-11,8,-3,0,0,0
MAGEA3,Magea3,-5,6,1,3.951456,0,0
MAGEA4,Magea4,7,3,10,0,0,0
MAGEA6,Magea6,1,10,11,2.495146,0,0
MAGEA8,Magea8,3,4,7,0,0,0
MAGEA9,Magea9,2,-8,-6,0,0,0
MAGEB1,Mageb1,0,-7,-7,0,0,0
MAGEB16,Mageb16,-1,2,1,0,0,0
MAGEB18,Mageb18,2,2,4,0,0,0
MAGEB2,Mageb2,2,2,4,3.378641,0,0
MAGEB3,Mageb3,28,-1,27,0,0,0
MAGEB4,Mageb4,1,1,2,0,0,0
MAGEB5,Mageb5,0,-5,-5,0,0,0
MAGEC2,Magec2,-3,1,-2,0,0,0
MAGED1,Maged1,7,1,8,0,0,0
MAGED2,Maged2,7,-1,6,0,0,0
MAGEE1,Magee1,-10,1,-9,0,0,0
MAGEE2,Magee2,1,-5,-4,0,0,0
MAGEH1,Mageh1,9,-2,7,3.07767,0,0
MAGEL2,Magel2,-2,1,-1,0,0,0
MAGI1,Magi1,8,-2,6,0,0,0
MAGI2,Magi2,6,-11,-5,2.067961,0,0
MAGI3,Magi3,9,-4,5,6.300971,0,0
MAGIX,Magix,11,0,11,15.174757,0,0
MAGOH,Magoh,5,-4,1,6.116505,0,0
MAGOHB,Magohb,-2,-10,-12,5.708738,0,0
MAGT1,Magt1,4,0,4,0,0,0
MAIP1,Maip1,10,-5,5,0,0,0
MAJIN,Majin,1,8,9,0,0,0
MAK,Mak,5,-5,0,1.660194,0,0
MAK16,Mak16,-5,-8,-13,3.796117,0,0
MAL,Mal,8,7,15,0,0,0
MAL2,Mal2,1,1,2,3.223301,0,0
MALL,Mall,-4,-1,-5,0.76699,0,0
MALRD1,Malrd1,1,1,2,0,0,0
MALSU1,Malsu1,5,1,6,10.320388,0,0
MALT1,Malt1,5,-2,3,13.864078,0,0
MAMDC2,Mamdc2,6,-4,2,155.029126,56.333333,0
MAMDC4,Mamdc4,2,0,2,0,0,0
MAML1,Maml1,9,-2,7,2.087379,0,0
MAML2,Maml2,3,-3,0,4.728155,0,0
MAML3,Maml3,-3,-1,-4,9.359223,0,0
MAMLD1,Mamld1,1,-1,0,3.145631,0,0
MAMSTR,Mamstr,-16,-14,-30,0,0,0
MAN1A2,Man1a2,3,-4,-1,9.76699,0,0
MAN1B1,Man1b1,8,-1,7,58.058252,0,0
MAN1C1,Man1c1,-1,3,2,0,0,0
MAN2A1,Man2a1,2,0,2,1.728155,0,0
MAN2A2,Man2a2,12,1,13,1.601942,0,0
MAN2B1,Man2b1,6,2,8,2.475728,0,0
MAN2B2,Man2b2,2,-6,-4,3.019417,0,0
MAN2C1,Man2c1,4,-8,-4,18.349515,0,0
MANBA,Manba,14,0,14,7.15534,0,0
MANBAL,Manbal,3,-2,1,9.349515,0,0
MANEA,Manea,1,-8,-7,4.524272,0,0
MANEAL,Maneal,5,-4,1,4.427184,0,0
MANF,Manf,4,-6,-2,2.718447,0,0
MANSC1,Mansc1,-2,18,16,0,0,0
MANSC4,Mansc4,-5,1,-4,8.553398,0,0
MAOA,Maoa,2,-8,-6,0,0,0
MAOB,Maob,-2,12,10,1.504854,0,0
MAP10,Map10,-20,1,-19,0,0,0
MAP1A,Map1a,27,-5,22,0,0,0
MAP1B,Map1b,11,1,12,0.951456,0,0
MAP1LC3A,Map1lc3a,10,3,13,5.485437,0,0
MAP1LC3B,Map1lc3b,6,2,8,6.087379,0,0
MAP1S,Map1s,0,0,0,3.31068,0,0
MAP2,Map2,9,2,11,12.854369,0,0
MAP2K1,Map2k1,4,-1,3,4.864078,0,0
MAP2K2,Map2k2,10,-4,6,4.786408,0,0
MAP2K3,Map2k3,13,-3,10,1.223301,0,0
MAP2K4,Map2k4,4,2,6,1.203883,0,0
MAP2K5,Map2k5,13,-7,6,6.097087,0,0
MAP2K6,Map2k6,4,0,4,0,0,0
MAP2K7,Map2k7,4,-4,0,4.854369,0,0
MAP3K1,Map3k1,4,0,4,3.31068,0,0
MAP3K10,Map3k10,6,-2,4,1.699029,0,0
MAP3K11,Map3k11,13,-5,8,4.07767,0,0
MAP3K12,Map3k12,13,-3,10,8.504854,0,0
MAP3K13,Map3k13,3,-5,-2,4.281553,0,0
MAP3K14,Map3k14,0,-1,-1,42.757282,0,0
MAP3K15,Map3k15,4,1,5,1.76699,0,0
MAP3K19,Map3k19,-1,-2,-3,0,0,0
MAP3K2,Map3k2,11,2,13,5.23301,0,0
MAP3K20,Map3k20,4,-2,2,3.815534,0,0
MAP3K21,Map3k21,-1,1,0,4.543689,0,0
MAP3K3,Map3k3,3,-2,1,4.669903,0,0
MAP3K4,Map3k4,2,-6,-4,9.378641,0,0
MAP3K5,Map3k5,8,-5,3,10.300971,0,0
MAP3K6,Map3k6,0,4,4,12.242718,0,0
MAP3K7,Map3k7,5,-5,0,6.757282,0,0
MAP3K7CL,Map3k7cl,6,6,12,95.825243,8.666667,0
MAP3K8,Map3k8,20,-1,19,4.990291,0,0
MAP3K9,Map3k9,4,-2,2,24.68932,0,0
MAP4,Map4,8,-4,4,13.61165,0,0
MAP4K1,Map4k1,5,-13,-8,0.708738,0,0
MAP4K2,Map4k2,5,-4,1,0,0,0
MAP4K3,Map4k3,-5,-4,-9,10.300971,0,0
MAP4K4,Map4k4,12,2,14,3.165049,0,0
MAP4K5,Map4k5,7,0,7,16.864078,3.958333,0
MAP6,Map6,18,-4,14,11.990291,0,0
MAP6D1,Map6d1,-7,-4,-11,0,0,0
MAP7,Map7,3,4,7,6.407767,0,0
MAP7D1,Map7d1,5,-1,4,1.029126,0,0
MAP7D2,Map7d2,62,2,64,0,0,0
MAP7D3,Map7d3,-1,-4,-5,0,0,0
MAP9,Map9,1,-8,-7,26.203883,0,0
MAPK1,Mapk1,10,1,11,5.68932,0,0
MAPK10,Mapk10,46,-5,41,1.242718,0,0
MAPK11,Mapk11,10,-10,0,0,0,0
MAPK12,Mapk12,5,-7,-2,2.495146,0,0
MAPK13,Mapk13,2,8,10,0,0,0
MAPK14,Mapk14,6,-3,3,19.650485,0,0
MAPK15,Mapk15,3,-11,-8,17.029126,0,0
MAPK3,Mapk3,4,-6,-2,2.048544,0,0
MAPK4,Mapk4,-1,6,5,0,0,0
MAPK6,Mapk6,0,-2,-2,4.495146,0,0
MAPK7,Mapk7,-5,-8,-13,0,0,0
MAPK8,Mapk8,5,-4,1,1.378641,0,0
MAPK8IP1,Mapk8ip1,11,2,13,2.23301,0,0
MAPK8IP2,Mapk8ip2,7,-5,2,0,0,0
MAPK8IP3,Mapk8ip3,6,-1,5,13.92233,0,0
MAPK9,Mapk9,4,-5,-1,1.271845,0,0
MAPKAP1,Mapkap1,9,-2,7,7.825243,0,0
MAPKAPK2,Mapkapk2,11,2,13,6.174757,0,0
MAPKAPK3,Mapkapk3,-1,4,3,6.932039,0,0
MAPKAPK5,Mapkapk5,5,-1,4,9.067961,0,0
MAPKBP1,Mapkbp1,1,1,2,0,0,0
MAPRE1,Mapre1,8,-2,6,12.495146,0,0
MAPRE2,Mapre2,10,-1,9,0,0,0
MAPRE3,Mapre3,7,-11,-4,59.475728,0,0
MAPT,Mapt,8,1,9,10.067961,0,0
MARCHF1,Marchf1,-5,-1,-6,0.757282,0,0
MARCHF10,Marchf10,-6,-2,-8,0,0,0
MARCHF11,Marchf11,-10,-9,-19,0,0,0
MARCHF2,Marchf2,9,-5,4,5.854369,0,0
MARCHF3,Marchf3,4,-3,1,5.097087,0,0
MARCHF4,Marchf4,3,-4,-1,0,0,0
MARCHF5,Marchf5,16,-1,15,23.601942,0,0
MARCHF6,Marchf6,10,-4,6,29,0,0
MARCHF7,Marchf7,-10,-5,-15,16.912621,0,0
MARCHF8,Marchf8,3,3,6,33.456311,0,0
MARCHF9,Marchf9,-1,1,0,32.92233,0,0
MARCKS,Marcks,8,-1,7,2.61165,0,0
MARCKSL1,Marcksl1,10,-1,9,0,0,0
MARCO,Marco,-2,1,-1,0,0,0
MARF1,Marf1,4,-4,0,6.92233,0,0
MARK1,Mark1,3,-2,1,6.097087,0,0
MARK2,Mark2,9,-3,6,6.776699,0,0
MARK3,Mark3,10,-2,8,70.601942,0,0
MARK4,Mark4,8,0,8,0,0,0
MARS1,Mars1,9,5,14,2.009709,0,0
MARS2,Mars2,-6,-9,-15,3.621359,0,0
MARVELD1,Marveld1,1,-6,-5,15.378641,0,0
MARVELD2,Marveld2,5,10,15,6.320388,0,0
MARVELD3,Marveld3,4,-10,-6,0,0,0
MAS1,Mas1,3,-5,-2,0,0,0
MASP1,Masp1,2,4,6,0,0,0
MASP2,Masp2,43,-6,37,0,0,0
MAST1,Mast1,11,-4,7,6.84466,0,0
MAST2,Mast2,8,-2,6,7.23301,0,0
MAST3,Mast3,12,-1,11,2.330097,0,0
MAST4,Mast4,-4,0,-4,7.485437,0,0
MASTL,Mastl,-1,-8,-9,0,0,0
MAT1A,Mat1a,-8,-2,-10,0,0,0
MAT2A,Mat2a,6,-9,-3,129.572816,21.125,0
MAT2B,Mat2b,2,-2,0,5.553398,0,0
MATK,Matk,4,-8,-4,5.203883,0,0
MATN1,Matn1,-3,-2,-5,2.796117,0,0
MATN2,Matn2,0,1,1,3.737864,0,0
MATN3,Matn3,4,4,8,0.864078,0,0
MATN4,Matn4,-1,3,2,1.378641,0,0
MATR3,Matr3,9,1,10,38.417476,0,0
MAU2,Mau2,5,-8,-3,12.291262,0,0
MAVS,Mavs,1,1,2,2.699029,0,0
MAX,Max,7,1,8,6.203883,0,0
MAZ,Maz,5,-6,-1,6.116505,0,0
MB,Mb,7,1,8,0,0,0
MB21D2,Mb21d2,1,-1,0,10.912621,0,0
MBD1,Mbd1,3,-4,-1,3.31068,0,0
MBD2,Mbd2,1,-4,-3,17.009709,0,0
MBD3,Mbd3,10,-6,4,5.339806,0,0
MBD3L1,Mbd3l1,-2,-2,-4,0,0,0
MBD3L2,Mbd3l2,10,-1,9,0,0,0
MBD4,Mbd4,-15,3,-12,24.68932,0,0
MBD5,Mbd5,9,1,10,4.912621,0,0
MBD6,Mbd6,5,-3,2,2.213592,0,0
MBIP,Mbip,-1,-7,-8,2.174757,0,0
MBL2,Mbl2,0,0,0,0,0,0
MBLAC1,Mblac1,6,-5,1,2.271845,0,0
MBLAC2,Mblac2,-7,-2,-9,15.38835,0,0
MBNL1,Mbnl1,4,-5,-1,14.029126,0,0
MBNL2,Mbnl2,36,5,41,11.029126,0,0
MBNL3,Mbnl3,-2,-3,-5,2.796117,0,0
MBOAT1,Mboat1,-2,-2,-4,0,0,0
MBOAT2,Mboat2,7,1,8,185.485437,32.125,0
MBOAT4,Mboat4,6,-4,2,0,0,0
MBOAT7,Mboat7,27,8,35,188.417476,29.75,0
MBP,Mbp,13,4,17,5.883495,0,0
MBTD1,Mbtd1,7,-2,5,9.786408,0,0
MBTPS1,Mbtps1,4,-9,-5,6.592233,0,0
MBTPS2,Mbtps2,3,-7,-4,7.427184,0,0
MC1R,Mc1r,12,6,18,26.699029,0,0
MC2R,Mc2r,5,2,7,0,0,0
MC3R,Mc3r,-2,1,-1,0,0,0
MC4R,Mc4r,-7,27,20,0,0,0
MC5R,Mc5r,16,0,16,1.038835,0,0
MCAM,Mcam,3,0,3,0,0,0
MCAT,Mcat,-1,-10,-11,39.553398,0,0
MCC,Mcc,4,-5,-1,6.864078,0,0
MCCC1,Mccc1,-3,-3,-6,2.281553,0,0
MCCC2,Mccc2,1,-7,-6,2.456311,0,0
MCEE,Mcee,5,-4,1,21.145631,0,0
MCEMP1,Mcemp1,-1,-1,-2,13.757282,0,0
MCF2,Mcf2,28,3,31,0,0,0
MCF2L,Mcf2l,9,-4,5,14.572816,0,0
MCFD2,Mcfd2,4,0,4,13.23301,0,0
MCHR1,Mchr1,6,-1,5,3.058252,0,0
MCIDAS,Mcidas,14,0,14,3.582524,0,0
MCL1,Mcl1,18,-1,17,16.407767,0,0
MCM10,Mcm10,1,-1,0,0,0,0
MCM2,Mcm2,4,-3,1,2.07767,0,0
MCM3,Mcm3,-1,-3,-4,5.446602,0,0
MCM3AP,Mcm3ap,8,-1,7,12.485437,0,0
MCM4,Mcm4,8,1,9,2.76699,0,0
MCM5,Mcm5,3,-2,1,1.15534,0,0
MCM6,Mcm6,2,0,2,13.902913,0,0
MCM7,Mcm7,8,0,8,21.796117,0,0
MCM8,Mcm8,2,-2,0,13.262136,0,0
MCM9,Mcm9,0,-2,-2,4.378641,0,0
MCMBP,Mcmbp,4,1,5,8.466019,0,0
MCMDC2,Mcmdc2,3,-5,-2,0,0,0
MCOLN1,Mcoln1,10,-3,7,26.029126,0,0
MCOLN2,Mcoln2,9,4,13,4.291262,0,0
MCOLN3,Mcoln3,0,3,3,4.291262,0,0
MCPH1,Mcph1,0,-3,-3,2.262136,0,0
MCRIP1,Mcrip1,7,0,7,20.631068,0,0
MCRIP2,Mcrip2,-4,-3,-7,0,0,0
MCRS1,Mcrs1,7,-2,5,1.126214,0,0
MCTP1,Mctp1,1,-4,-3,1.359223,0,0
MCTP2,Mctp2,-3,2,-1,0,0,0
MCTS1,Mcts1,3,-3,0,0,0,0
MCU,Mcu,28,-4,24,93.533981,0,0
MCUB,Mcub,2,-8,-6,3.067961,0,0
MCUR1,Mcur1,5,-2,3,5.747573,0,0
MDC1,Mdc1,9,5,14,5.184466,0,0
MDFI,Mdfi,9,9,18,0.902913,0,0
MDFIC,Mdfic,4,0,4,3.097087,0,0
MDFIC2,Mdfic2,0,-5,-5,0,0,0
MDGA1,Mdga1,25,4,29,0,0,0
MDGA2,Mdga2,3,-5,-2,0,0,0
MDH1,Mdh1,4,1,5,5.747573,0,0
MDH1B,Mdh1b,3,1,4,0,0,0
MDH2,Mdh2,8,-3,5,0,0,0
MDK,Mdk,7,-5,2,0,0,0
MDM1,Mdm1,-3,-6,-9,8.23301,0,0
MDM2,Mdm2,8,0,8,5.466019,0,0
MDM4,Mdm4,7,-3,4,18.495146,0,0
MDN1,Mdn1,7,-1,6,4.194175,0,0
MDP1,Mdp1,12,2,14,6.514563,0,0
ME1,Me1,1,-2,-1,135.708738,29.875,0
ME2,Me2,6,-7,-1,9.912621,0,0
ME3,Me3,5,-3,2,0,0,0
MEA1,Mea1,7,-3,4,4.291262,0,0
MEAF6,Meaf6,7,-6,1,21.106796,0,0
MEAK7,Meak7,3,-7,-4,16.009709,0,0
MECOM,Mecom,-8,-7,-15,6.116505,0,0
MECP2,Mecp2,4,-2,2,7.737864,0,0
MECR,Mecr,1,-5,-4,7.378641,0,0
MED1,Med1,5,-5,0,8.446602,0,0
MED10,Med10,8,-5,3,7.495146,0,0
MED11,Med11,6,-5,1,2.815534,0,0
MED12,Med12,13,-3,10,0,0,0
MED12L,Med12l,7,-3,4,9.873786,0,0
MED13,Med13,9,-2,7,4.106796,0,0
MED13L,Med13l,9,1,10,12.368932,0,0
MED14,Med14,6,-2,4,3.786408,0,0
MED15,Med15,8,-2,6,3.38835,0,0
MED16,Med16,6,-14,-8,7.796117,0,0
MED17,Med17,6,1,7,1.796117,0,0
MED18,Med18,-1,-4,-5,2.932039,0,0
MED19,Med19,-1,-2,-3,3.815534,0,0
MED20,Med20,12,-9,3,4.737864,0,0
MED21,Med21,1,-10,-9,5.417476,0,0
MED22,Med22,0,-6,-6,2,0,0
MED23,Med23,-1,-6,-7,54.631068,0,0
MED24,Med24,9,-7,2,0,0,0
MED25,Med25,8,-1,7,3.330097,0,0
MED26,Med26,12,-2,10,10.135922,0,0
MED27,Med27,3,-3,0,0,0,0
MED28,Med28,5,0,5,0,0,0
MED29,Med29,5,-1,4,0,0,0
MED30,Med30,14,-4,10,3.631068,0,0
MED31,Med31,7,4,11,2.84466,0,0
MED4,Med4,-2,-6,-8,4.291262,0,0
MED6,Med6,1,-9,-8,0.76699,0,0
MED7,Med7,-4,1,-3,2.563107,0,0
MED8,Med8,1,-9,-8,3.106796,0,0
MED9,Med9,1,-3,-2,12.825243,0,0
MEDAG,Medag,-5,1,-4,0,0,0
MEF2A,Mef2a,6,-10,-4,7.116505,0,0
MEF2B,Mef2b,18,1,19,0,0,0
MEF2C,Mef2c,0,-3,-3,2.621359,0,0
MEF2D,Mef2d,3,-2,1,6.398058,0,0
MEFV,Mefv,8,-2,6,0,0,0
MEGF10,Megf10,26,2,28,0,0,0
MEGF11,Megf11,7,2,9,0,0,0
MEGF6,Megf6,-3,-3,-6,12.650485,0,0
MEGF8,Megf8,-5,-2,-7,4.893204,0,0
MEGF9,Megf9,9,-7,2,2.427184,0,0
MEI1,Mei1,2,0,2,17.718447,0,0
MEI4,Mei4,2,-5,-3,0,0,0
MEIG1,Meig1,23,-7,16,2.349515,0,0
MEIKIN,Meikin,-8,-3,-11,0,0,0
MEIOB,Meiob,1,1,2,0,0,0
MEIOC,Meioc,6,-5,1,0,0,0
MEIOSIN,Meiosin,4,0,4,2.320388,0,0
MEIS1,Meis1,-3,4,1,12.291262,0,0
MEIS2,Meis2,9,3,12,1.135922,0,0
MEIS3,Meis3,10,0,10,0,0,0
MELK,Melk,-2,-12,-14,1.038835,0,0
MELTF,Meltf,5,-1,4,5.932039,0,0
MEMO1,Memo1,9,-3,6,16.038835,0,0
MEN1,Men1,7,-2,5,5.84466,0,0
MEOX1,Meox1,1,-3,-2,0,0,0
MEOX2,Meox2,-3,0,-3,0,0,0
MEP1A,Mep1a,0,9,9,0,0,0
MEP1B,Mep1b,26,-10,16,0,0,0
MEPCE,Mepce,5,-5,0,3.504854,0,0
MEPE,Mepe,-2,3,1,0,0,0
MERTK,Mertk,10,2,12,8.165049,0,0
MESD,Mesd,7,-3,4,3.776699,0,0
MESP1,Mesp1,3,-9,-6,4.728155,0,0
MESP2,Mesp2,3,-2,1,1.456311,0,0
MEST,Mest,6,1,7,1.504854,0,0
MET,Met,1,-1,0,20.893204,0,0
METAP1,Metap1,2,-5,-3,4.378641,0,0
METAP1D,Metap1d,4,-6,-2,0,0,0
METAP2,Metap2,8,-9,-1,0,0,0
METRN,Metrn,11,-4,7,0,0,0
METRNL,Metrnl,7,1,8,1.417476,0,0
METTL1,Mettl1,-23,-11,-34,0.84466,0,0
METTL14,Mettl14,-9,-3,-12,0,0,0
METTL15,Mettl15,7,-2,5,44.980583,0,0
METTL16,Mettl16,0,-5,-5,19.058252,0,104
METTL17,Mettl17,9,-8,1,8.368932,0,0
METTL18,Mettl18,-3,-13,-16,5.728155,0,0
METTL21A,Mettl21a,3,-6,-3,74.330097,4.791667,0
METTL21C,Mettl21c,4,1,5,0,0,0
METTL22,Mettl22,7,-16,-9,0,0,0
METTL23,Mettl23,0,-5,-5,211.106796,110.333333,0
METTL24,Mettl24,3,2,5,0,0,0
METTL25,Mettl25,-2,-4,-6,0,0,0
METTL26,Mettl26,10,-1,9,39.300971,0,0
METTL27,Mettl27,-13,-6,-19,8.475728,0,0
METTL3,Mettl3,10,3,13,3.194175,0,0
METTL4,Mettl4,1,-10,-9,9.902913,0,0
METTL5,Mettl5,9,0,9,7.31068,0,0
METTL6,Mettl6,7,-5,2,2.524272,0,0
METTL7B,Mettl7b,-10,0,-10,0,0,0
METTL8,Mettl8,-2,-11,-13,7.747573,0,0
METTL9,Mettl9,9,-3,6,20.786408,0,0
MEX3A,Mex3a,2,-7,-5,3.543689,0,0
MEX3B,Mex3b,41,-1,40,1.359223,0,0
MEX3C,Mex3c,7,-3,4,0,0,0
MEX3D,Mex3d,8,-6,2,0,0,0
MFAP2,Mfap2,1,-14,-13,0,0,0
MFAP3,Mfap3,12,-3,9,4.436893,0,0
MFAP3L,Mfap3l,3,1,4,15.427184,0,0
MFAP4,Mfap4,-7,-4,-11,0,0,0
MFAP5,Mfap5,8,-11,-3,0,0,0
MFF,Mff,1,2,3,8.815534,0,0
MFGE8,Mfge8,8,2,10,8.038835,0,0
MFHAS1,Mfhas1,5,1,6,0,0,0
MFN1,Mfn1,1,1,2,4.300971,0,0
MFN2,Mfn2,9,-3,6,9,0,0
MFNG,Mfng,15,0,15,0,0,0
MFRP,Mfrp,5,2,7,0,0,0
MFSD1,Mfsd1,9,5,14,3.252427,0,0
MFSD10,Mfsd10,6,8,14,6.61165,0,0
MFSD11,Mfsd11,8,-4,4,17.019417,0,0
MFSD12,Mfsd12,5,-5,0,2.339806,0,0
MFSD13A,Mfsd13a,-1,2,1,4.067961,0,0
MFSD14A,Mfsd14a,3,-5,-2,9.805825,0,0
MFSD14B,Mfsd14b,3,3,6,3.07767,0,0
MFSD2A,Mfsd2a,-13,-14,-27,4.330097,0,0
MFSD2B,Mfsd2b,17,5,22,6.135922,0,0
MFSD3,Mfsd3,0,-5,-5,8.650485,0,0
MFSD4A,Mfsd4a,4,-2,2,0,0,0
MFSD5,Mfsd5,-7,-7,-14,9.058252,0,0
MFSD6,Mfsd6,0,1,1,2.291262,0,0
MFSD6L,Mfsd6l,-7,-22,-29,0,0,0
MFSD8,Mfsd8,1,-6,-5,4.398058,0,0
MFSD9,Mfsd9,4,-7,-3,1.592233,0,0
MGA,Mga,6,1,7,9.621359,0,0
MGAM,Mgam,2,-4,-2,0,0,0
MGARP,Mgarp,61,9,70,0,0,0
MGAT1,Mgat1,10,-7,3,21.970874,0,0
MGAT2,Mgat2,6,-6,0,8.281553,0,0
MGAT3,Mgat3,5,-1,4,4.757282,0,0
MGAT4A,Mgat4a,7,-2,5,0,0,0
MGAT4B,Mgat4b,7,2,9,3.456311,0,0
MGAT4C,Mgat4c,-3,-2,-5,0,0,0
MGAT4D,Mgat4d,-2,-8,-10,0,0,0
MGAT5,Mgat5,9,-3,6,1.165049,0,0
MGAT5B,Mgat5b,6,4,10,3.407767,0,0
MGLL,Mgll,1,0,1,0.92233,0,0
MGME1,Mgme1,4,-10,-6,7.31068,0,0
MGMT,Mgmt,2,4,6,8.970874,0,0
MGP,Mgp,6,6,12,0,0,0
MGRN1,Mgrn1,6,-5,1,4.776699,0,0
MGST1,Mgst1,-8,-1,-9,2.466019,0,0
MGST2,Mgst2,3,-12,-9,16,0,0
MGST3,Mgst3,9,-1,8,4.563107,0,0
MIA,Mia,127,8,135,3.427184,0,0
MIA2,Mia2,7,-2,5,8.524272,0,0
MIA3,Mia3,7,-3,4,42.31068,0,0
MIB1,Mib1,8,-1,7,4.203883,0,0
MIB2,Mib2,12,3,15,55.145631,0,0
MICAL1,Mical1,4,-1,3,3.145631,0,0
MICAL2,Mical2,-8,-4,-12,2.543689,0,0
MICAL3,Mical3,4,-3,1,6.728155,0,0
MICALL1,Micall1,-1,-1,-2,1.970874,0,0
MICALL2,Micall2,-1,-3,-4,36.621359,0,0
MICOS10,Micos10,1,-6,-5,6.864078,0,0
MICOS13,Micos13,13,-7,6,74.582524,0,0
MICU1,Micu1,9,2,11,0,0,0
MICU2,Micu2,1,-15,-14,12.669903,0,0
MICU3,Micu3,-12,-3,-15,4.252427,0,0
MID1,Mid1,5,7,12,17.650485,0,0
MID1IP1,Mid1ip1,4,2,6,9.213592,0,0
MID2,Mid2,-1,4,3,2.68932,0,0
MIDEAS,Mideas,8,4,12,19.485437,0,0
MIDN,Midn,12,-1,11,0,0,0
MIEF1,Mief1,6,0,6,1.553398,0,0
MIEF2,Mief2,-30,-11,-41,1,0,0
MIEN1,Mien1,7,-3,4,6.873786,0,0
MIER1,Mier1,5,-9,-4,43.271845,0,0
MIER2,Mier2,-4,-6,-10,2.514563,0,0
MIER3,Mier3,1,-4,-3,0.84466,0,0
MIF,Mif,4,1,5,9.262136,0,0
MIF4GD,Mif4gd,4,-9,-5,8.533981,0,0
MIGA1,Miga1,6,-1,5,3.320388,0,0
MIGA2,Miga2,8,-1,7,2.174757,0,0
MIIP,Miip,7,-12,-5,0.834951,0,0
MILR1,Milr1,3,5,8,0,0,0
MINAR1,Minar1,2,0,2,0,0,0
MINAR2,Minar2,5,3,8,2.699029,0,0
MINDY1,Mindy1,5,-6,-1,6.61165,0,0
MINDY2,Mindy2,4,0,4,5.009709,0,0
MINDY3,Mindy3,4,-3,1,0,0,0
MINDY4,Mindy4,-3,-11,-14,15.737864,0,0
MINK1,Mink1,10,-5,5,9.805825,0,0
MINPP1,Minpp1,15,2,17,14.145631,0,0
MIOS,Mios,4,-9,-5,7.669903,0,0
MIOX,Miox,6,2,8,0,0,0
MIP,Mip,-6,-7,-13,0,0,0
MIPEP,Mipep,3,-5,-2,25.466019,0,0
MIPOL1,Mipol1,8,-8,0,15.737864,0,0
MIS12,Mis12,3,0,3,3.029126,0,0
MIS18A,Mis18a,2,2,4,2.446602,0,0
MIS18BP1,Mis18bp1,-3,-10,-13,11.815534,0,0
MISP,Misp,3,8,11,0,0,0
MISP3,Misp3,5,2,7,5.165049,0,0
MITD1,Mitd1,6,0,6,13.23301,0,0
MITF,Mitf,26,1,27,1.291262,0,0
MIXL1,Mixl1,11,-1,10,0,0,0
MKI67,Mki67,-1,-9,-10,0,0,0
MKKS,Mkks,5,-11,-6,2.883495,0,0
MKLN1,Mkln1,7,-3,4,7.543689,0,0
MKNK1,Mknk1,3,-2,1,2.815534,0,0
MKNK2,Mknk2,27,2,29,44.252427,0,0
MKRN1,Mkrn1,6,-1,5,7.970874,0,0
MKRN2,Mkrn2,7,-6,1,35.048544,0,0
MKRN2OS,Mkrn2os,16,-1,15,40.427184,0,0
MKRN3,Mkrn3,8,-8,0,6.145631,0,0
MKS1,Mks1,10,-3,7,25.058252,0,0
MKX,Mkx,2,0,2,0,0,0
MLANA,Mlana,2,2,4,0,0,0
MLC1,Mlc1,14,-1,13,0,0,0
MLEC,Mlec,4,0,4,53.223301,0,0
MLF1,Mlf1,6,-12,-6,58.116505,0,0
MLF2,Mlf2,9,-7,2,6.38835,3.583333,0
MLH1,Mlh1,6,-9,-3,72.436893,0,0
MLH3,Mlh3,3,-3,0,5.563107,0,0
MLIP,Mlip,25,1,26,2.747573,0,0
MLKL,Mlkl,28,-6,22,14.728155,0,0
MLLT1,Mllt1,10,-3,7,28.466019,0,0
MLLT10,Mllt10,2,-3,-1,7.660194,0,0
MLLT11,Mllt11,4,-4,0,10.15534,0,0
MLLT3,Mllt3,4,-1,3,0,0,0
MLLT6,Mllt6,8,2,10,6.737864,0,0
MLPH,Mlph,-4,-4,-8,5.38835,0,0
MLST8,Mlst8,5,-4,1,9.184466,0,0
MLX,Mlx,2,0,2,5.68932,0,0
MLXIP,Mlxip,11,-8,3,5.893204,0,0
MLXIPL,Mlxipl,8,5,13,4.737864,0,0
MLYCD,Mlycd,4,-1,3,1.737864,0,0
MMAA,Mmaa,-6,-6,-12,19.330097,0,0
MMAB,Mmab,5,-3,2,0,0,0
MMACHC,Mmachc,4,-7,-3,11.757282,0,0
MMADHC,Mmadhc,6,-6,0,43.242718,0,0
MMD,Mmd,1,0,1,3.475728,0,0
MMD2,Mmd2,29,1,30,0,0,0
MME,Mme,6,3,9,11.097087,0,0
MMEL1,Mmel1,-13,-11,-24,1.281553,0,0
MMGT1,Mmgt1,-3,0,-3,1.368932,0,0
MMP10,Mmp10,34,9,43,0,0,0
MMP11,Mmp11,1,-10,-9,0,0,0
MMP12,Mmp12,2,11,13,0,0,0
MMP13,Mmp13,19,10,29,0,0,0
MMP14,Mmp14,14,2,16,1.019417,0,0
MMP15,Mmp15,15,0,15,5.38835,0,0
MMP16,Mmp16,13,-2,11,47.796117,0,0
MMP17,Mmp17,-5,2,-3,0,0,0
MMP19,Mmp19,-1,-5,-6,0,0,0
MMP2,Mmp2,6,1,7,0,0,0
MMP20,Mmp20,0,0,0,0,0,0
MMP21,Mmp21,8,-1,7,0,0,0
MMP24,Mmp24,1,-7,-6,0,0,0
MMP25,Mmp25,21,8,29,0,0,0
MMP27,Mmp27,0,5,5,0,0,0
MMP28,Mmp28,6,1,7,0,0,0
MMP3,Mmp3,11,10,21,0,0,0
MMP7,Mmp7,-7,3,-4,0,0,0
MMP8,Mmp8,3,4,7,0,0,0
MMP9,Mmp9,0,1,1,0,0,0
MMRN1,Mmrn1,-2,2,0,0,0,0
MMRN2,Mmrn2,9,3,12,2.359223,0,0
MMS19,Mms19,1,-3,-2,1.281553,0,0
MMS22L,Mms22l,9,-11,-2,1.84466,0,0
MMUT,Mmut,4,-6,-2,0,0,0
MN1,Mn1,12,2,14,0,0,0
MNAT1,Mnat1,6,-3,3,10.76699,0,0
MND1,Mnd1,3,-3,0,8.533981,0,0
MNS1,Mns1,-3,-8,-11,8.349515,0,0
MNT,Mnt,-11,-5,-16,3.699029,0,0
MNX1,Mnx1,-1,-2,-3,0,0,0
MOAP1,Moap1,6,-7,-1,7.893204,0,0
MOB1A,Mob1a,6,-1,5,3.834951,0,0
MOB1B,Mob1b,3,-5,-2,9.145631,0,0
MOB2,Mob2,-9,-8,-17,0,0,0
MOB3A,Mob3a,8,-5,3,14.106796,0,0
MOB3B,Mob3b,6,3,9,0.864078,0,0
MOB3C,Mob3c,-3,-4,-7,6.834951,0,0
MOB4,Mob4,40,1,41,19.553398,0,0
MOBP,Mobp,7,6,13,0,0,0
MOCOS,Mocos,2,1,3,1.796117,0,0
MOCS1,Mocs1,0,-3,-3,3.970874,0,0
MOCS2,Mocs2,8,-10,-2,32.242718,0,0
MOCS3,Mocs3,-1,-2,-3,12.893204,0,0
MOG,Mog,2,-10,-8,0,0,0
MOGAT1,Mogat1,1,0,1,0,0,0
MOGAT2,Mogat2,5,3,8,0,0,0
MOGS,Mogs,4,-7,-3,2.097087,0,0
MOK,Mok,10,-8,2,90.805825,0,0
MON1A,Mon1a,11,-6,5,5.281553,0,0
MON1B,Mon1b,10,-4,6,5.92233,0,0
MON2,Mon2,9,-2,7,4.553398,0,0
MORC1,Morc1,-1,0,-1,0,0,0
MORC3,Morc3,4,-4,0,2.980583,0,0
MORC4,Morc4,9,5,14,112.563107,0,0
MORF4L1,Morf4l1,7,-5,2,9.281553,0,0
MORF4L2,Morf4l2,7,2,9,258.07767,56.125,133
MORN1,Morn1,2,3,5,34.76699,0,0
MORN2,Morn2,7,-9,-2,53.262136,0,0
MORN3,Morn3,0,-22,-22,28.407767,0,0
MORN4,Morn4,0,-14,-14,20.029126,0,0
MORN5,Morn5,-2,-2,-4,9.805825,0,0
MOS,Mos,1,-7,-6,0,0,0
MOSMO,Mosmo,10,-9,1,3.067961,0,0
MOSPD1,Mospd1,1,-2,-1,0,0,0
MOSPD2,Mospd2,-4,-2,-6,2.213592,0,0
MOSPD3,Mospd3,3,4,7,1.398058,0,0
MOV10,Mov10,6,0,6,5.485437,0,0
MOV10L1,Mov10l1,-2,0,-2,0,0,0
MOXD1,Moxd1,10,0,10,0,0,0
MPC1,Mpc1,6,-5,1,6.640777,0,0
MPC2,Mpc2,1,-9,-8,53.184466,0,0
MPDU1,Mpdu1,5,-4,1,2.485437,0,0
MPDZ,Mpdz,6,1,7,36.912621,0,0
MPEG1,Mpeg1,0,-3,-3,0,0,0
MPG,Mpg,4,-7,-3,3.660194,0,0
MPHOSPH10,Mphosph10,1,-5,-4,21.145631,0,0
MPHOSPH6,Mphosph6,4,-9,-5,6.747573,0,0
MPHOSPH8,Mphosph8,8,-1,7,0,0,0
MPHOSPH9,Mphosph9,5,-5,0,0,0,0
MPI,Mpi,8,-5,3,2.708738,0,0
MPIG6B,Mpig6b,9,-2,7,1.834951,0,0
MPL,Mpl,4,1,5,0,0,0
MPLKIP,Mplkip,5,-7,-2,14.359223,0,0
MPND,Mpnd,4,-3,1,17.747573,0,0
MPO,Mpo,4,16,20,0,0,0
MPP1,Mpp1,1,2,3,0,0,0
MPP2,Mpp2,-8,-7,-15,0,0,0
MPP3,Mpp3,-3,-2,-5,4.106796,0,0
MPP4,Mpp4,9,-3,6,0,0,0
MPP7,Mpp7,2,-2,0,0,0,0
MPPE1,Mppe1,1,-16,-15,7.757282,0,0
MPPED1,Mpped1,-2,-1,-3,0,0,0
MPPED2,Mpped2,7,5,12,0,0,0
MPRIP,Mprip,9,-2,7,1.058252,0,0
MPST,Mpst,7,-4,3,2.543689,0,0
MPV17,Mpv17,9,1,10,0,0,0
MPV17L,Mpv17l,4,-4,0,0,0,0
MPV17L2,Mpv17l2,6,0,6,42.61165,0,0
MPZ,Mpz,-5,0,-5,1.291262,0,0
MPZL1,Mpzl1,8,-6,2,4.320388,0,0
MPZL2,Mpzl2,-8,16,8,1.951456,0,0
MPZL3,Mpzl3,7,1,8,2.378641,0,0
MR1,Mr1,2,0,2,5.747573,0,0
MRAP,Mrap,-7,5,-2,0,0,0
MRAP2,Mrap2,7,-7,0,0.864078,0,0
MRAS,Mras,6,-5,1,0,3.958333,0
MRC1,Mrc1,40,-2,38,26.543689,0,0
MRC2,Mrc2,-8,-2,-10,1.76699,0,0
MREG,Mreg,1,2,3,6.728155,0,0
MRFAP1,Mrfap1,8,-2,6,22.825243,0,0
MRGBP,Mrgbp,-3,-2,-5,0,0,0
MRGPRD,Mrgprd,1,2,3,0,0,0
MRGPRE,Mrgpre,1,-7,-6,0,0,0
MRGPRF,Mrgprf,-5,-1,-6,0,0,0
MRGPRG,Mrgprg,8,0,8,0,0,0
MRGPRX1,Mrgprx1,-1,0,-1,0,0,0
MRGPRX2,Mrgprx2,0,0,0,0,0,0
MRI1,Mri1,13,-1,12,1.029126,0,0
MRLN,Mrln,33,9,42,0,0,0
MRM1,Mrm1,-11,2,-9,1.776699,0,0
MRM2,Mrm2,6,-4,2,5.669903,0,0
MRM3,Mrm3,0,-6,-6,12.320388,0,0
MRNIP,Mrnip,2,-7,-5,25.737864,0,0
MRO,Mro,-3,0,-3,0,0,0
MROH1,Mroh1,0,1,1,1.194175,0,0
MROH2A,Mroh2a,-1,-10,-11,0,0,0
MROH2B,Mroh2b,0,-1,-1,0,0,0
MROH5,Mroh5,-1,-8,-9,0,0,0
MROH6,Mroh6,4,13,17,0,0,0
MROH7,Mroh7,-2,0,-2,0,0,0
MROH8,Mroh8,7,-8,-1,12.640777,0,0
MROH9,Mroh9,-1,-8,-9,0,0,0
MRPL1,Mrpl1,4,-5,-1,18.776699,0,0
MRPL10,Mrpl10,0,-5,-5,41.970874,0,0
MRPL11,Mrpl11,2,-3,-1,0,0,0
MRPL12,Mrpl12,4,-2,2,8.533981,0,0
MRPL13,Mrpl13,9,-8,1,8.902913,0,0
MRPL14,Mrpl14,6,-11,-5,10.349515,0,0
MRPL15,Mrpl15,-2,-5,-7,1.631068,0,0
MRPL16,Mrpl16,7,-1,6,5.660194,0,0
MRPL17,Mrpl17,3,-5,-2,6.495146,0,0
MRPL18,Mrpl18,63,-1,62,439.330097,78.25,1196
MRPL19,Mrpl19,10,-1,9,2.466019,0,0
MRPL2,Mrpl2,1,-4,-3,0,0,0
MRPL20,Mrpl20,4,-3,1,8.543689,0,0
MRPL21,Mrpl21,4,-5,-1,27.106796,0,0
MRPL22,Mrpl22,0,-6,-6,8.38835,0,0
MRPL23,Mrpl23,12,-8,4,0,0,0
MRPL24,Mrpl24,7,-2,5,7.135922,0,0
MRPL27,Mrpl27,6,4,10,2.572816,0,0
MRPL28,Mrpl28,8,-2,6,0,0,0
MRPL3,Mrpl3,4,-3,1,17.485437,0,0
MRPL30,Mrpl30,3,-3,0,0,0,0
MRPL32,Mrpl32,8,-1,7,2.203883,0,0
MRPL33,Mrpl33,12,-2,10,13.61165,0,0
MRPL34,Mrpl34,5,-3,2,12.932039,0,0
MRPL35,Mrpl35,2,-7,-5,6.223301,0,0
MRPL36,Mrpl36,6,-5,1,8.776699,0,0
MRPL37,Mrpl37,6,-1,5,2.271845,0,0
MRPL38,Mrpl38,3,0,3,19.805825,0,0
MRPL39,Mrpl39,5,-3,2,17.815534,0,0
MRPL4,Mrpl4,5,-7,-2,6.398058,0,0
MRPL40,Mrpl40,0,-3,-3,27.029126,0,0
MRPL41,Mrpl41,5,-1,4,2.786408,0,0
MRPL42,Mrpl42,-1,-4,-5,1.417476,0,0
MRPL43,Mrpl43,7,0,7,0.980583,0,0
MRPL44,Mrpl44,5,-1,4,46.728155,0,0
MRPL45,Mrpl45,4,-4,0,46.553398,0,0
MRPL46,Mrpl46,-5,-6,-11,1.514563,0,0
MRPL47,Mrpl47,8,-7,1,2.883495,0,0
MRPL48,Mrpl48,4,-4,0,41.009709,0,0
MRPL49,Mrpl49,-1,-2,-3,0,0,0
MRPL50,Mrpl50,6,-12,-6,10.145631,0,0
MRPL51,Mrpl51,5,2,7,4.533981,0,0
MRPL52,Mrpl52,10,-11,-1,3.76699,0,0
MRPL53,Mrpl53,12,-10,2,38.320388,0,0
MRPL54,Mrpl54,6,-1,5,9.631068,0,0
MRPL55,Mrpl55,7,-5,2,7.563107,0,0
MRPL57,Mrpl57,2,-6,-4,1.834951,0,0
MRPL58,Mrpl58,6,-5,1,20.737864,0,0
MRPL9,Mrpl9,4,-5,-1,9,0,0
MRPS10,Mrps10,3,-7,-4,1.213592,0,0
MRPS11,Mrps11,9,-3,6,1.514563,0,0
MRPS12,Mrps12,2,1,3,0,0,0
MRPS14,Mrps14,13,-3,10,5.475728,0,0
MRPS15,Mrps15,3,-3,0,14.533981,0,0
MRPS16,Mrps16,6,-8,-2,26.485437,0,0
MRPS17,Mrps17,5,-4,1,1.15534,0,0
MRPS18A,Mrps18a,7,-5,2,0,0,0
MRPS18B,Mrps18b,-3,-3,-6,0,0,0
MRPS18C,Mrps18c,-1,-8,-9,8.699029,0,0
MRPS2,Mrps2,7,-4,3,53.135922,0,0
MRPS21,Mrps21,5,-5,0,0,0,117
MRPS22,Mrps22,2,2,4,0,0,0
MRPS23,Mrps23,4,-2,2,31.708738,0,0
MRPS24,Mrps24,10,-10,0,5.417476,0,0
MRPS25,Mrps25,7,-2,5,0,0,0
MRPS26,Mrps26,0,3,3,7.718447,0,0
MRPS27,Mrps27,0,-7,-7,0,0,0
MRPS28,Mrps28,3,-2,1,5.07767,0,0
MRPS30,Mrps30,6,-5,1,5.320388,0,0
MRPS31,Mrps31,-3,-5,-8,14.300971,0,0
MRPS33,Mrps33,4,-9,-5,13.203883,0,0
MRPS34,Mrps34,11,3,14,6.165049,0,0
MRPS35,Mrps35,5,-5,0,25.07767,0,0
MRPS36,Mrps36,4,-1,3,1.805825,0,0
MRPS5,Mrps5,8,-3,5,9.213592,0,0
MRPS6,Mrps6,16,2,18,355.009709,144.541667,0
MRPS7,Mrps7,2,-3,-1,7.533981,0,0
MRPS9,Mrps9,4,-1,3,0,0,0
MRRF,Mrrf,3,-2,1,10.31068,0,0
MRS2,Mrs2,2,-6,-4,3.951456,0,0
MRTFA,Mrtfa,1,-4,-3,5.786408,0,0
MRTFB,Mrtfb,-9,-1,-10,5.31068,0,0
MRTO4,Mrto4,4,0,4,11.466019,0,0
MS4A1,Ms4a1,0,-1,-1,0,0,0
MS4A10,Ms4a10,5,6,11,0,0,0
MS4A12,Ms4a12,-3,-7,-10,0,0,0
MS4A13,Ms4a13,-2,0,-2,0,0,0
MS4A14,Ms4a14,5,0,5,0,0,0
MS4A15,Ms4a15,0,-6,-6,0,0,0
MS4A18,Ms4a18,-2,1,-1,0,0,0
MS4A2,Ms4a2,3,1,4,0,0,0
MS4A3,Ms4a3,2,-4,-2,0,0,0
MS4A4A,Ms4a4a,12,9,21,0,0,0
MS4A5,Ms4a5,9,2,11,0,0,0
MS4A7,Ms4a7,5,-5,0,0,0,0
MSANTD1,Msantd1,15,13,28,0,0,0
MSANTD2,Msantd2,5,-5,0,6.76699,0,0
MSANTD3,Msantd3,6,-9,-3,2.747573,0,0
MSANTD4,Msantd4,13,0,13,4.165049,0,0
MSANTD5,Msantd5,4,-1,3,0,0,0
MSC,Msc,-5,2,-3,0,0,0
MSGN1,Msgn1,13,11,24,0,0,0
MSH2,Msh2,3,-4,-1,5.621359,0,0
MSH3,Msh3,4,-8,-4,364.68932,117.541667,518
MSH4,Msh4,28,-16,12,0,0,0
MSH5,Msh5,-1,1,0,3.135922,0,0
MSH6,Msh6,-4,-3,-7,7.572816,0,0
MSI1,Msi1,17,-6,11,2.223301,0,0
MSI2,Msi2,9,0,9,51.213592,8.416667,0
MSL1,Msl1,2,-6,-4,1.873786,0,0
MSL2,Msl2,5,0,5,7.961165,0,0
MSL3,Msl3,0,-2,-2,7.961165,0,0
MSLN,Msln,8,0,8,0,0,0
MSLNL,Mslnl,3,2,5,0,0,0
MSMB,Msmb,24,-9,15,0,0,0
MSMO1,Msmo1,2,3,5,60.718447,0,0
MSMP,Msmp,-2,-4,-6,7.543689,0,0
MSN,Msn,9,5,14,5.339806,0,0
MSR1,Msr1,6,-1,5,0,0,0
MSRA,Msra,10,-6,4,1.456311,0,0
MSRB1,Msrb1,2,-4,-2,0,0,0
MSRB2,Msrb2,3,-2,1,6.76699,0,0
MSRB3,Msrb3,2,-3,-1,51.990291,0,0
MSS51,Mss51,0,-10,-10,0,0,0
MST1,Mst1,2,-12,-10,5.679612,0,0
MST1R,Mst1r,21,2,23,26.514563,0,0
MSTN,Mstn,16,-1,15,0,0,0
MSTO1,Msto1,1,-7,-6,5.728155,0,0
MSX1,Msx1,18,1,19,15.834951,0,0
MSX2,Msx2,10,-2,8,3.990291,0,0
MT-ATP6,mt-Atp6,8,-9,-1,0,0,0
MT-ATP8,mt-Atp8,4,-10,-6,0,0,0
MT-CO1,mt-Co1,4,-11,-7,0,0,0
MT-CO2,mt-Co2,8,-10,-2,0,0,0
MT-CO3,mt-Co3,-5,-9,-14,0,0,0
MT-ND1,mt-Nd1,2,-6,-4,0,0,0
MT-ND2,mt-Nd2,5,-3,2,0,0,0
MT-ND3,mt-Nd3,9,-5,4,0,0,0
MT-ND4,mt-Nd4,9,-13,-4,0,0,0
MT-ND4L,mt-Nd4l,9,-17,-8,0,0,0
MT-ND5,mt-Nd5,2,-16,-14,0,0,0
MT-ND6,mt-Nd6,-5,-12,-17,0,0,0
MT3,Mt3,25,5,30,0,0,0
MT4,Mt4,9,13,22,0,0,0
MTA1,Mta1,8,-4,4,3.194175,0,0
MTA2,Mta2,9,1,10,4.436893,0,0
MTA3,Mta3,8,-8,0,11.980583,0,0
MTAP,Mtap,2,-2,0,4.320388,0,0
MTARC1,Mtarc1,13,-1,12,10.165049,0,0
MTARC2,Mtarc2,8,3,11,2.543689,0,0
MTBP,Mtbp,-2,-7,-9,8.902913,0,0
MTCH1,Mtch1,9,-1,8,69.466019,25.375,0
MTCH2,Mtch2,7,-5,2,6.961165,0,0
MTCL1,Mtcl1,8,0,8,0,0,0
MTCP1,Mtcp1,-1,-4,-5,2.514563,0,0
MTDH,Mtdh,2,4,6,48.669903,0,0
MTERF2,Mterf2,6,-13,-7,18.582524,0,0
MTERF3,Mterf3,-14,-8,-22,12.15534,0,0
MTERF4,Mterf4,1,-2,-1,0,0,0
MTF1,Mtf1,13,-1,12,27.126214,0,0
MTF2,Mtf2,-3,-2,-5,41.699029,0,0
MTFMT,Mtfmt,0,1,1,3.15534,0,0
MTFP1,Mtfp1,0,-7,-7,2.262136,0,0
MTFR1,Mtfr1,4,-2,2,15.223301,0,0
MTFR1L,Mtfr1l,6,-3,3,3.902913,0,0
MTFR2,Mtfr2,0,-2,-2,1.786408,0,0
MTG1,Mtg1,3,-17,-14,6,0,0
MTG2,Mtg2,1,-5,-4,0,0,0
MTHFD1,Mthfd1,0,-4,-4,6.864078,0,0
MTHFD1L,Mthfd1l,6,2,8,17.223301,0,0
MTHFD2,Mthfd2,3,7,10,6.223301,0,0
MTHFD2L,Mthfd2l,25,-6,19,39.38835,0,0
MTHFR,Mthfr,7,0,7,35.951456,0,0
MTHFS,Mthfs,1,-6,-5,28.15534,0,0
MTHFSD,Mthfsd,2,-3,-1,7.330097,0,0
MTIF2,Mtif2,7,-4,3,20.533981,0,93
MTIF3,Mtif3,12,-9,3,4.834951,0,0
MTLN,Mtln,-7,-4,-11,2.631068,0,0
MTM1,Mtm1,-9,-3,-12,5.048544,0,0
MTMR1,Mtmr1,5,-1,4,3.135922,0,0
MTMR10,Mtmr10,5,-7,-2,6.009709,0,0
MTMR11,Mtmr11,17,-4,13,9.708738,0,0
MTMR12,Mtmr12,3,-9,-6,8.398058,0,0
MTMR14,Mtmr14,6,-3,3,1.427184,0,0
MTMR2,Mtmr2,5,-6,-1,8.533981,0,0
MTMR3,Mtmr3,5,-3,2,5.262136,0,0
MTMR4,Mtmr4,2,-4,-2,8.427184,0,0
MTMR6,Mtmr6,-11,-8,-19,2.533981,0,0
MTMR7,Mtmr7,3,-2,1,0,0,0
MTMR9,Mtmr9,0,-3,-3,5.320388,0,0
MTNR1A,Mtnr1a,6,8,14,0,0,0
MTNR1B,Mtnr1b,-7,0,-7,0,0,0
MTO1,Mto1,4,-5,-1,1.213592,0,0
MTOR,Mtor,5,-4,1,0,0,0
MTPAP,Mtpap,-2,-2,-4,1.563107,0,0
MTPN,Mtpn,9,2,11,7.262136,0,0
MTR,Mtr,4,-3,1,3.165049,0,0
MTRES1,Mtres1,2,-3,-1,35.456311,0,0
MTREX,Mtrex,4,-4,0,20.737864,0,0
MTRF1,Mtrf1,11,-6,5,74.796117,8.083333,0
MTRF1L,Mtrf1l,6,-3,3,13.456311,0,0
MTRR,Mtrr,1,-5,-4,9.543689,0,0
MTSS1,Mtss1,2,0,2,0,0,0
MTSS2,Mtss2,7,-2,5,1.106796,0,0
MTTP,Mttp,14,-5,9,0,0,0
MTURN,Mturn,9,-2,7,1.864078,0,0
MTUS1,Mtus1,4,3,7,4.747573,0,0
MTUS2,Mtus2,-1,1,0,0,0,0
MTX1,Mtx1,3,1,4,37.883495,0,0
MTX2,Mtx2,6,0,6,8.679612,0,0
MTX3,Mtx3,2,-10,-8,2.941748,0,0
MUC1,Muc1,1,1,2,115.087379,0,0
MUC13,Muc13,7,17,24,0,0,0
MUC15,Muc15,-3,-6,-9,0,0,0
MUC16,Muc16,-1,-1,-2,0,0,0
MUC2,Muc2,15,-1,14,0,0,0
MUC20,Muc20,28,-2,26,0,0,0
MUC21,Muc21,4,0,4,4.475728,0,0
MUC3A,Muc3a,1,1,2,7.941748,0,0
MUC5AC,Muc5ac,14,-4,10,33.563107,0,0
MUC5B,Muc5b,-2,-2,-4,0,0,0
MUCL1,Mucl1,-1,-6,-7,0,0,0
MUCL3,Mucl3,5,0,5,0,0,0
MUL1,Mul1,7,-6,1,23.475728,0,0
MUS81,Mus81,0,-4,-4,11.660194,0,0
MUSK,Musk,9,1,10,0,0,0
MUSTN1,Mustn1,-21,2,-19,0,0,0
MUTYH,Mutyh,7,-15,-8,8.932039,0,0
MVB12A,Mvb12a,3,-8,-5,89.456311,27.125,169
MVB12B,Mvb12b,-6,-7,-13,1.592233,0,0
MVD,Mvd,5,-3,2,12.786408,0,0
MVK,Mvk,-8,-4,-12,42.757282,0,0
MVP,Mvp,9,8,17,1.407767,0,0
MX1,Mx1,-3,-6,-9,0.990291,0,0
MX2,Mx2,-13,-2,-15,1.330097,0,0
MXD1,Mxd1,33,2,35,14.563107,0,0
MXD3,Mxd3,-7,-12,-19,4.601942,0,0
MXD4,Mxd4,8,-7,1,27.970874,0,0
MXI1,Mxi1,4,-1,3,4.864078,0,0
MXRA7,Mxra7,3,0,3,3.640777,0,0
MXRA8,Mxra8,25,-2,23,0,0,0
MYADM,Myadm,1,-8,-7,24.15534,0,0
MYADML2,Myadml2,5,4,9,0,0,0
MYB,Myb,4,-1,3,0,0,0
MYBBP1A,Mybbp1a,1,-1,0,3.504854,0,0
MYBL1,Mybl1,5,-5,0,12.699029,0,0
MYBL2,Mybl2,1,3,4,7.194175,0,0
MYBPC1,Mybpc1,0,6,6,0,0,0
MYBPC2,Mybpc2,4,6,10,0,0,0
MYBPC3,Mybpc3,0,4,4,2.378641,0,0
MYBPH,Mybph,11,-3,8,1.68932,0,0
MYBPHL,Mybphl,5,-1,4,0,0,0
MYC,Myc,12,13,25,67.019417,64.25,0
MYCBP,Mycbp,0,5,5,26.485437,0,0
MYCBP2,Mycbp2,5,0,5,5.980583,0,0
MYCBPAP,Mycbpap,12,-6,6,0,0,0
MYCL,Mycl,33,2,35,0.902913,0,0
MYCN,Mycn,10,-13,-3,0,0,0
MYCT1,Myct1,5,4,9,0,0,0
MYD88,Myd88,-1,1,0,2.417476,0,0
MYDGF,Mydgf,4,-1,3,11.990291,0,0
MYEF2,Myef2,3,-6,-3,0,0,0
MYF5,Myf5,1,1,2,0,0,0
MYF6,Myf6,1,-9,-8,0,0,0
MYG1,Myg1,13,1,14,54.213592,0,0
MYH1,Myh1,-2,-1,-3,0,0,0
MYH10,Myh10,8,-2,6,0,0,0
MYH11,Myh11,-1,-8,-9,0,0,0
MYH13,Myh13,-1,2,1,0,0,0
MYH14,Myh14,8,3,11,19.563107,0,0
MYH15,Myh15,6,-6,0,0,0,0
MYH2,Myh2,-1,0,-1,0,0,0
MYH3,Myh3,0,-1,-1,0,0,0
MYH4,Myh4,-2,-1,-3,0,0,0
MYH6,Myh6,5,1,6,2.718447,0,0
MYH7,Myh7,3,1,4,0,0,0
MYH7B,Myh7b,6,-4,2,7.68932,0,0
MYH8,Myh8,1,-1,0,0,0,0
MYH9,Myh9,6,7,13,31.271845,0,0
MYL1,Myl1,8,2,10,0,0,0
MYL10,Myl10,-4,-19,-23,0,0,0
MYL12A,Myl12a,6,2,8,6.116505,0,0
MYL12B,Myl12b,6,0,6,14.572816,0,0
MYL2,Myl2,-5,5,0,0,0,0
MYL3,Myl3,-5,0,-5,0,0,0
MYL4,Myl4,24,-2,22,2.417476,0,0
MYL6,Myl6,10,1,11,0,0,0
MYL6B,Myl6b,8,-3,5,35.252427,0,0
MYL7,Myl7,15,6,21,0,0,0
MYL9,Myl9,-1,-5,-6,0,0,0
MYLIP,Mylip,11,-1,10,8.495146,0,0
MYLK,Mylk,0,2,2,3.019417,0,0
MYLK2,Mylk2,4,9,13,0,0,0
MYLK3,Mylk3,4,-4,0,24.582524,0,0
MYLK4,Mylk4,-3,-3,-6,25.145631,0,0
MYLPF,Mylpf,10,2,12,3.533981,0,0
MYMK,Mymk,13,0,13,5.873786,0,0
MYMX,Mymx,3,-8,-5,0,0,0
MYNN,Mynn,2,-2,0,47.31068,0,0
MYO10,Myo10,27,-1,26,7.592233,0,0
MYO15B,Myo15b,1,4,5,6.650485,0,0
MYO16,Myo16,-2,-6,-8,0,0,0
MYO18A,Myo18a,10,-3,7,3.07767,0,0
MYO18B,Myo18b,-3,-1,-4,0,0,0
MYO19,Myo19,6,-9,-3,2.631068,0,0
MYO1A,Myo1a,29,-2,27,0,0,0
MYO1B,Myo1b,6,3,9,9.203883,0,0
MYO1C,Myo1c,7,-1,6,3.456311,0,0
MYO1D,Myo1d,-3,7,4,0,0,0
MYO1E,Myo1e,-3,2,-1,0.941748,0,0
MYO1F,Myo1f,4,4,8,1.951456,0,0
MYO1G,Myo1g,10,29,39,3.213592,0,0
MYO1H,Myo1h,-5,-13,-18,0,0,0
MYO3A,Myo3a,1,-3,-2,0,0,0
MYO3B,Myo3b,-2,-2,-4,0,0,0
MYO5A,Myo5a,6,-5,1,5.961165,0,0
MYO5B,Myo5b,12,3,15,0,0,0
MYO5C,Myo5c,0,0,0,3.825243,0,0
MYO6,Myo6,4,-4,0,24.640777,0,0
MYO7A,Myo7a,12,-5,7,3.184466,0,0
MYO7B,Myo7b,5,2,7,0,0,0
MYO9A,Myo9a,5,-8,-3,3.912621,0,0
MYO9B,Myo9b,4,-3,1,13.097087,0,0
MYOC,Myoc,7,6,13,0,0,0
MYOCD,Myocd,6,-2,4,0,0,0
MYOCOS,Myocos,37,16,53,0,0,0
MYOD1,Myod1,6,8,14,0,0,0
MYOF,Myof,2,5,7,0,0,0
MYOG,Myog,1,6,7,0,0,0
MYOM1,Myom1,3,0,3,0,0,0
MYOM2,Myom2,13,2,15,0,0,0
MYOM3,Myom3,4,3,7,0,0,0
MYORG,Myorg,5,-10,-5,2.61165,0,0
MYOT,Myot,6,0,6,0,0,0
MYOZ1,Myoz1,-6,-1,-7,0,0,0
MYOZ2,Myoz2,6,8,14,0,0,0
MYOZ3,Myoz3,7,-5,2,5.067961,0,0
MYPN,Mypn,8,-1,7,0,0,0
MYPOP,Mypop,2,-8,-6,9.048544,0,0
MYRF,Myrf,7,-2,5,17.980583,0,0
MYRFL,Myrfl,41,-1,40,0,0,0
MYRIP,Myrip,0,-7,-7,0,0,0
MYSM1,Mysm1,2,-5,-3,2.407767,0,0
MYT1,Myt1,6,-8,-2,0,0,0
MYT1L,Myt1l,2,0,2,0,0,0
MYZAP,Myzap,-4,3,-1,2.398058,0,0
MZB1,Mzb1,28,17,45,1.786408,0,0
MZF1,Mzf1,4,-5,-1,106.631068,0,0
MZT1,Mzt1,1,-2,-1,3.320388,0,0
N4BP1,N4bp1,-41,-3,-44,18.631068,0,0
N4BP2,N4bp2,5,-4,1,3.912621,0,0
N4BP2L1,N4bp2l1,58,4,62,0,0,0
N4BP2L2,N4bp2l2,8,3,11,72.291262,0,0
N4BP3,N4bp3,2,-2,0,1.990291,0,0
N6AMT1,N6amt1,0,-3,-3,12.349515,0,0
NAA10,Naa10,4,-2,2,3.029126,0,0
NAA11,Naa11,4,0,4,0,0,0
NAA15,Naa15,5,-1,4,1.038835,0,0
NAA16,Naa16,11,1,12,74.796117,8.083333,0
NAA20,Naa20,3,-9,-6,12.165049,0,0
NAA25,Naa25,4,-8,-4,9.601942,0,0
NAA30,Naa30,5,-9,-4,4.699029,0,0
NAA35,Naa35,7,0,7,18.398058,0,0
NAA38,Naa38,5,-4,1,201.592233,0,0
NAA40,Naa40,0,-9,-9,48.15534,0,0
NAA50,Naa50,9,2,11,20.019417,0,0
NAA60,Naa60,6,2,8,8.048544,0,0
NAA80,Naa80,-13,-11,-24,1.349515,0,0
NAAA,Naaa,5,-4,1,1.038835,0,0
NAALAD2,Naalad2,24,6,30,0,0,0
NAALADL1,Naaladl1,17,-11,6,5.067961,0,0
NAALADL2,Naaladl2,-3,-1,-4,1.427184,0,0
NAB1,Nab1,9,5,14,2.84466,0,0
NAB2,Nab2,-4,-2,-6,2.980583,0,0
NABP1,Nabp1,3,-9,-6,3.524272,0,0
NABP2,Nabp2,5,-1,4,5.708738,0,0
NACA,Naca,8,-1,7,3.61165,0,0
NACAD,Nacad,3,0,3,9.76699,0,0
NACC1,Nacc1,9,-2,7,17.427184,0,0
NACC2,Nacc2,9,-1,8,2.174757,0,0
NADK,Nadk,9,-8,1,36.475728,0,0
NADK2,Nadk2,5,-6,-1,14.543689,0,0
NADSYN1,Nadsyn1,8,-1,7,0,0,0
NAE1,Nae1,-1,-8,-9,7.883495,0,0
NAF1,Naf1,4,3,7,2.533981,0,0
NAGA,Naga,1,-6,-5,0,0,0
NAGK,Nagk,6,-9,-3,11.38835,0,0
NAGLU,Naglu,-8,-4,-12,3.699029,0,0
NAGPA,Nagpa,-5,-1,-6,8.23301,0,0
NAGS,Nags,-14,-2,-16,0.650485,0,0
NAIF1,Naif1,7,-5,2,3.31068,0,0
NALCN,Nalcn,8,-1,7,0,0,0
NAMPT,Nampt,-1,1,0,8.466019,0,0
NANOG,Nanog,5,-1,4,0,0,0
NANOS1,Nanos1,3,-4,-1,1.165049,0,0
NANOS2,Nanos2,6,0,6,0,0,0
NANOS3,Nanos3,13,-3,10,7.737864,0,0
NANP,Nanp,-19,-19,-38,10.31068,0,0
NANS,Nans,1,-3,-2,12.320388,0,0
NAP1L1,Nap1l1,6,-6,0,58.699029,0,0
NAP1L2,Nap1l2,1,-5,-4,4.76699,0,0
NAP1L3,Nap1l3,4,1,5,0,0,0
NAP1L4,Nap1l4,10,-9,1,5.786408,0,0
NAP1L5,Nap1l5,-2,-3,-5,0,0,0
NAPA,Napa,7,1,8,3.621359,0,0
NAPB,Napb,0,-5,-5,1.223301,0,0
NAPEPLD,Napepld,1,-9,-8,13.378641,0,0
NAPG,Napg,-2,-2,-4,7.961165,0,0
NAPRT,Naprt,7,1,8,1.718447,0,0
NAPSA,Napsa,15,5,20,0,0,0
NARF,Narf,9,-3,6,8.466019,0,0
NARS2,Nars2,4,-2,2,0,0,0
NASP,Nasp,9,-6,3,2.747573,0,0
NAT1,Nat1,-2,-10,-12,1.951456,0,0
NAT10,Nat10,6,-3,3,8.805825,0,0
NAT14,Nat14,-1,-8,-9,22.019417,0,0
NAT2,Nat2,-18,-11,-29,0,0,0
NAT8,Nat8,17,6,23,0,0,0
NAT8L,Nat8l,6,-2,4,0,0,0
NAT9,Nat9,2,-1,1,21.495146,0,0
NATD1,Natd1,1,0,1,0,0,0
NAV1,Nav1,3,2,5,0,0,0
NAV2,Nav2,3,-2,1,8.194175,0,0
NAV3,Nav3,4,-2,2,0,0,0
NAXD,Naxd,5,-2,3,0,0,0
NAXE,Naxe,5,-6,-1,8.864078,0,0
NBAS,Nbas,6,-2,4,0,0,0
NBDY,Nbdy,6,-2,4,0,0,0
NBEA,Nbea,6,0,6,0.825243,0,0
NBEAL1,Nbeal1,3,-6,-3,1.271845,0,0
NBEAL2,Nbeal2,-4,-9,-13,4.815534,0,0
NBL1,Nbl1,34,8,42,41.941748,0,0
NBN,Nbn,-4,1,-3,26.92233,4.041667,0
NBR1,Nbr1,9,1,10,1.825243,0,0
NCALD,Ncald,20,-2,18,0,0,0
NCAM1,Ncam1,10,-6,4,4.174757,0,0
NCAM2,Ncam2,2,-1,1,5.330097,0,0
NCAN,Ncan,15,1,16,0,0,0
NCAPD2,Ncapd2,7,-5,2,4.533981,0,0
NCAPD3,Ncapd3,4,-6,-2,13.951456,0,0
NCAPG,Ncapg,-2,-12,-14,3.582524,0,0
NCAPG2,Ncapg2,2,-10,-8,0,0,0
NCAPH,Ncaph,-12,-5,-17,9.951456,0,0
NCAPH2,Ncaph2,10,-3,7,15.087379,0,0
NCBP1,Ncbp1,8,-8,0,10.563107,0,0
NCBP2,Ncbp2,8,-7,1,15.116505,0,0
NCBP3,Ncbp3,9,-2,7,32.145631,0,0
NCCRP1,Nccrp1,-1,4,3,0,0,0
NCDN,Ncdn,7,-3,4,2.650485,0,0
NCEH1,Nceh1,4,6,10,5.757282,0,0
NCF1,Ncf1,43,8,51,3.92233,0,0
NCF2,Ncf2,-3,-2,-5,0,0,0
NCF4,Ncf4,5,2,7,43.669903,0,0
NCK1,Nck1,9,-6,3,3.446602,0,0
NCK2,Nck2,8,-3,5,0,0,0
NCKAP1,Nckap1,10,0,10,7.553398,0,0
NCKAP1L,Nckap1l,3,-1,2,0,0,0
NCKAP5,Nckap5,1,-3,-2,0,0,0
NCKAP5L,Nckap5l,8,-7,1,3.029126,0,0
NCKIPSD,Nckipsd,7,5,12,4.776699,0,0
NCL,Ncl,6,-9,-3,1.990291,0,0
NCLN,Ncln,6,-3,3,3.76699,0,0
NCMAP,Ncmap,4,-3,1,1.737864,0,0
NCOA1,Ncoa1,7,0,7,1.407767,0,0
NCOA2,Ncoa2,8,1,9,29.883495,0,0
NCOA3,Ncoa3,6,-2,4,36.116505,0,0
NCOA4,Ncoa4,7,-5,2,44.563107,0,0
NCOA5,Ncoa5,-13,-7,-20,60.368932,0,0
NCOA6,Ncoa6,7,-7,0,8.009709,0,0
NCOA7,Ncoa7,3,-11,-8,37.475728,0,0
NCOR1,Ncor1,5,0,5,7.553398,0,0
NCOR2,Ncor2,12,0,12,6.708738,0,0
NCR1,Ncr1,8,-5,3,0,0,0
NCS1,Ncs1,5,-8,-3,3.815534,0,0
NCSTN,Ncstn,14,-8,6,71.757282,0,0
NDC1,Ndc1,4,-2,2,0,0,0
NDC80,Ndc80,-3,-11,-14,9.902913,0,0
NDE1,Nde1,6,-10,-4,7.92233,0,0
NDEL1,Ndel1,12,-1,11,2.699029,0,0
NDFIP1,Ndfip1,8,-3,5,4.135922,0,0
NDFIP2,Ndfip2,6,-5,1,3.281553,0,0
NDN,Ndn,6,3,9,0,0,0
NDNF,Ndnf,12,-4,8,2.029126,0,0
NDOR1,Ndor1,8,0,8,5.650485,0,97
NDP,Ndp,-7,-6,-13,0,0,0
NDRG1,Ndrg1,25,3,28,17.990291,0,0
NDRG2,Ndrg2,2,-1,1,0,0,0
NDRG3,Ndrg3,2,-1,1,0,0,0
NDRG4,Ndrg4,6,1,7,32.563107,0,0
NDST1,Ndst1,9,1,10,8.834951,0,0
NDST2,Ndst2,-19,-11,-30,41.941748,6.333333,0
NDST3,Ndst3,2,-10,-8,2.582524,0,0
NDST4,Ndst4,9,-4,5,0,0,0
NDUFA1,Ndufa1,7,0,7,8.174757,0,0
NDUFA10,Ndufa10,6,-3,3,20.68932,0,0
NDUFA11,Ndufa11,4,-12,-8,24.23301,0,0
NDUFA12,Ndufa12,9,-2,7,35.058252,0,0
NDUFA13,Ndufa13,7,-2,5,3.902913,0,0
NDUFA2,Ndufa2,8,-8,0,3.650485,0,0
NDUFA3,Ndufa3,9,-2,7,13.38835,0,0
NDUFA4,Ndufa4,7,-6,1,6.475728,0,0
NDUFA4L2,Ndufa4l2,14,-5,9,1.873786,0,0
NDUFA5,Ndufa5,2,-7,-5,1.456311,0,0
NDUFA6,Ndufa6,3,2,5,2.417476,0,0
NDUFA7,Ndufa7,0,1,1,10.941748,0,0
NDUFA8,Ndufa8,5,-5,0,9.805825,0,0
NDUFA9,Ndufa9,1,-11,-10,1.970874,0,0
NDUFAB1,Ndufab1,9,-3,6,23.679612,0,0
NDUFAF1,Ndufaf1,5,-12,-7,8.699029,0,0
NDUFAF2,Ndufaf2,11,1,12,0,0,0
NDUFAF3,Ndufaf3,1,-7,-6,13.796117,0,0
NDUFAF4,Ndufaf4,2,-4,-2,9.728155,0,0
NDUFAF5,Ndufaf5,4,-12,-8,12.126214,0,0
NDUFAF6,Ndufaf6,3,-1,2,17.825243,0,0
NDUFAF7,Ndufaf7,-3,1,-2,0,0,0
NDUFAF8,Ndufaf8,4,-11,-7,0,0,0
NDUFB1,Ndufb1,11,-1,10,2.427184,0,0
NDUFB10,Ndufb10,5,-6,-1,9.495146,0,0
NDUFB11,Ndufb11,2,1,3,0.84466,0,0
NDUFB2,Ndufb2,5,-3,2,5.951456,0,0
NDUFB3,Ndufb3,8,-5,3,1.796117,0,0
NDUFB4,Ndufb4,3,-1,2,25.281553,0,0
NDUFB5,Ndufb5,7,6,13,2.883495,0,0
NDUFB6,Ndufb6,5,-3,2,2.757282,0,0
NDUFB7,Ndufb7,7,-7,0,9,0,0
NDUFB8,Ndufb8,6,-9,-3,5.446602,0,0
NDUFB9,Ndufb9,7,-9,-2,13.776699,0,127
NDUFC1,Ndufc1,-1,1,0,1.038835,0,0
NDUFC2,Ndufc2,7,-7,0,29.786408,0,0
NDUFS1,Ndufs1,5,-5,0,7.631068,0,0
NDUFS2,Ndufs2,6,-4,2,1.621359,0,0
NDUFS3,Ndufs3,5,-2,3,75.203883,0,0
NDUFS4,Ndufs4,9,-8,1,2.174757,0,0
NDUFS5,Ndufs5,9,-6,3,0,0,0
NDUFS6,Ndufs6,6,-4,2,8.776699,0,0
NDUFS7,Ndufs7,9,-5,4,71.07767,0,0
NDUFS8,Ndufs8,8,1,9,3.601942,0,0
NDUFV1,Ndufv1,9,0,9,6.757282,0,0
NDUFV2,Ndufv2,4,-4,0,27.873786,0,0
NDUFV3,Ndufv3,2,-10,-8,2.601942,0,0
NEB,Neb,9,-1,8,0,0,0
NEBL,Nebl,4,0,4,8.320388,0,0
NECAB1,Necab1,-5,-4,-9,0,0,0
NECAB2,Necab2,18,-4,14,1.466019,0,0
NECAB3,Necab3,8,-3,5,6.543689,0,0
NECAP1,Necap1,1,2,3,3.893204,0,0
NECAP2,Necap2,6,-10,-4,145.019417,0,0
NECTIN1,Nectin1,4,-3,1,5.203883,0,0
NECTIN2,Nectin2,6,-2,4,4.019417,0,0
NECTIN3,Nectin3,12,-11,1,9.019417,0,0
NECTIN4,Nectin4,24,-1,23,11.368932,0,0
NEDD1,Nedd1,3,-5,-2,5.728155,0,0
NEDD4,Nedd4,3,-3,0,5.203883,0,0
NEDD4L,Nedd4l,9,0,9,6.650485,5.875,0
NEDD8,Nedd8,8,-5,3,0,0,0
NEDD9,Nedd9,8,2,10,0,0,0
NEFH,Nefh,4,6,10,0,0,0
NEFL,Nefl,1,0,1,0,0,0
NEFM,Nefm,9,-1,8,0,0,0
NEGR1,Negr1,1,2,3,33.660194,0,0
NEIL1,Neil1,13,3,16,1.854369,0,0
NEIL2,Neil2,3,1,4,42.009709,0,0
NEIL3,Neil3,-12,-22,-34,2.262136,0,0
NEK1,Nek1,4,0,4,3.572816,0,0
NEK10,Nek10,15,-13,2,98.271845,0,140
NEK11,Nek11,8,-6,2,26.514563,0,0
NEK2,Nek2,4,-14,-10,7.834951,0,0
NEK3,Nek3,-3,-5,-8,2.951456,0,0
NEK4,Nek4,0,-3,-3,22.368932,0,0
NEK5,Nek5,4,2,6,4.330097,0,0
NEK6,Nek6,6,-3,3,0,0,0
NEK7,Nek7,3,2,5,0.84466,0,0
NEK8,Nek8,5,-9,-4,3.864078,0,0
NEK9,Nek9,9,-2,7,1.834951,0,0
NELFA,Nelfa,9,-2,7,9.941748,0,0
NELFB,Nelfb,6,-6,0,28.873786,0,0
NELFCD,Nelfcd,11,-4,7,9.446602,0,0
NELFE,Nelfe,7,-3,4,16.417476,0,0
NELL1,Nell1,0,-1,-1,0,0,0
NELL2,Nell2,7,0,7,1.145631,0,0
NEMF,Nemf,0,-6,-6,39.932039,8.708333,0
NEMP1,Nemp1,8,-7,1,0,0,0
NEMP2,Nemp2,-7,-7,-14,0,0,0
NENF,Nenf,4,-6,-2,0,0,0
NEO1,Neo1,8,0,8,0,0,0
NEPRO,Nepro,-5,-9,-14,10.31068,4.916667,0
NES,Nes,9,0,9,29.718447,0,0
NET1,Net1,2,-2,0,24.087379,0,0
NETO1,Neto1,2,-1,1,0,0,0
NETO2,Neto2,3,1,4,4.757282,0,0
NEU1,Neu1,6,6,12,2.194175,0,0
NEU2,Neu2,0,9,9,0,0,0
NEU3,Neu3,2,3,5,1.417476,0,0
NEU4,Neu4,32,1,33,0,0,0
NEURL1B,Neurl1b,2,-8,-6,3.067961,0,0
NEURL2,Neurl2,0,8,8,7.757282,0,0
NEURL3,Neurl3,2,3,5,1.679612,0,0
NEURL4,Neurl4,8,-4,4,17.38835,0,0
NEUROD1,Neurod1,5,2,7,0,0,0
NEUROD2,Neurod2,6,-2,4,0,0,0
NEUROD4,Neurod4,1,-5,-4,0,0,0
NEUROD6,Neurod6,-2,-1,-3,0,0,0
NEUROG1,Neurog1,-2,-4,-6,1.990291,0,0
NEUROG2,Neurog2,9,4,13,4.330097,0,0
NEUROG3,Neurog3,0,-3,-3,0,0,0
NEXMIF,Nexmif,1,0,1,0,0,0
NEXN,Nexn,18,0,18,0,0,0
NF1,Nf1,8,-3,5,0.941748,0,0
NF2,Nf2,3,-2,1,0.76699,0,0
NFAM1,Nfam1,5,-4,1,0,0,0
NFASC,Nfasc,10,0,10,1.019417,0,0
NFAT5,Nfat5,6,3,9,35.320388,0,0
NFATC1,Nfatc1,4,0,4,8.320388,0,0
NFATC2,Nfatc2,9,0,9,5.485437,0,0
NFATC2IP,Nfatc2ip,2,-11,-9,1.38835,0,0
NFATC3,Nfatc3,13,1,14,10.466019,0,0
NFATC4,Nfatc4,0,-13,-13,3.262136,0,0
NFE2,Nfe2,-7,-6,-13,8.796117,0,0
NFE2L1,Nfe2l1,9,0,9,16.980583,0,0
NFE2L2,Nfe2l2,11,3,14,10.223301,0,0
NFE2L3,Nfe2l3,-6,1,-5,2.815534,0,0
NFIA,Nfia,7,-1,6,4.15534,0,0
NFIB,Nfib,13,2,15,7.087379,0,0
NFIC,Nfic,7,-2,5,1.291262,0,0
NFIL3,Nfil3,13,21,34,6.708738,0,0
NFIX,Nfix,6,-2,4,2.796117,0,0
NFKB1,Nfkb1,6,-4,2,1.038835,0,0
NFKB2,Nfkb2,4,5,9,2.029126,0,0
NFKBIA,Nfkbia,1,1,2,17.815534,0,0
NFKBIB,Nfkbib,7,2,9,2.776699,0,0
NFKBID,Nfkbid,3,0,3,43.68932,0,0
NFKBIE,Nfkbie,-3,-3,-6,4.747573,0,0
NFKBIL1,Nfkbil1,9,0,9,0,0,126
NFKBIZ,Nfkbiz,14,-1,13,104.126214,5.916667,0
NFRKB,Nfrkb,5,-3,2,5.563107,0,0
NFS1,Nfs1,1,3,4,13.572816,0,0
NFU1,Nfu1,0,-10,-10,10.116505,0,0
NFX1,Nfx1,-2,-5,-7,8.912621,0,0
NFXL1,Nfxl1,-3,-2,-5,3.087379,0,0
NFYA,Nfya,3,-5,-2,3.708738,0,0
NFYB,Nfyb,4,1,5,7.495146,0,0
NFYC,Nfyc,9,-4,5,11.174757,0,0
NGB,Ngb,-2,2,0,116.291262,6.958333,0
NGDN,Ngdn,-4,-7,-11,0,0,0
NGEF,Ngef,4,8,12,13.019417,0,0
NGF,Ngf,-22,3,-19,0,0,0
NGFR,Ngfr,1,-13,-12,2.058252,0,0
NGLY1,Ngly1,4,-7,-3,7.145631,0,0
NGRN,Ngrn,9,0,9,51.728155,0,0
NHEJ1,Nhej1,4,2,6,9.184466,0,0
NHLH1,Nhlh1,111,3,114,0,0,0
NHLH2,Nhlh2,6,1,7,0,0,0
NHLRC1,Nhlrc1,0,0,0,2.019417,0,0
NHLRC2,Nhlrc2,2,2,4,1.165049,0,0
NHLRC3,Nhlrc3,2,-2,0,1.194175,0,0
NHLRC4,Nhlrc4,9,5,14,38.475728,0,0
NHP2,Nhp2,0,-3,-3,2.679612,0,0
NHS,Nhs,-2,4,2,4.029126,0,0
NHSL1,Nhsl1,3,-3,0,0,0,0
NHSL2,Nhsl2,-4,1,-3,0,0,0
NIBAN1,Niban1,-4,5,1,0.757282,0,0
NIBAN2,Niban2,3,3,6,25.271845,0,0
NIBAN3,Niban3,3,-6,-3,0.825243,0,0
NICN1,Nicn1,3,-2,1,2.854369,0,0
NID1,Nid1,12,-4,8,0.776699,0,0
NID2,Nid2,8,-8,0,0,0,0
NIF3L1,Nif3l1,-1,-3,-4,4.495146,0,0
NIFK,Nifk,5,1,6,2.669903,0,0
NIM1K,Nim1k,11,-7,4,0,0,0
NIN,Nin,3,-5,-2,4.194175,0,0
NINJ1,Ninj1,-1,0,-1,12.980583,0,0
NINJ2,Ninj2,-7,-3,-10,4.475728,0,0
NINL,Ninl,3,-5,-2,0,0,0
NIP7,Nip7,0,-1,-1,3.572816,0,0
NIPA1,Nipa1,-1,-7,-8,6.951456,0,0
NIPA2,Nipa2,6,-8,-2,12.68932,0,0
NIPAL1,Nipal1,3,1,4,2.582524,0,0
NIPAL2,Nipal2,3,3,6,0.84466,0,0
NIPAL3,Nipal3,6,-1,5,28.097087,0,0
NIPAL4,Nipal4,-12,-6,-18,0,0,0
NIPBL,Nipbl,7,-5,2,4.504854,0,0
NIPSNAP1,Nipsnap1,7,-5,2,1.15534,0,0
NIPSNAP2,Nipsnap2,-6,-5,-11,8.184466,0,0
NIPSNAP3A,Nipsnap3a,5,-7,-2,3.883495,0,0
NIPSNAP3B,Nipsnap3b,-4,-9,-13,0,0,0
NISCH,Nisch,12,-5,7,3.84466,0,0
NIT1,Nit1,4,-2,2,5.300971,0,0
NIT2,Nit2,3,-2,1,10.679612,0,0
NKAIN1,Nkain1,13,-6,7,0,0,0
NKAIN2,Nkain2,3,0,3,0,0,0
NKAIN3,Nkain3,7,1,8,2.106796,0,0
NKAIN4,Nkain4,8,-5,3,0,0,0
NKAP,Nkap,2,-1,1,13.368932,0,0
NKAPD1,Nkapd1,6,-2,4,6.650485,0,0
NKAPL,Nkapl,22,-15,7,2.747573,0,0
NKD1,Nkd1,2,0,2,1.417476,0,0
NKD2,Nkd2,0,-6,-6,1.349515,0,0
NKG7,Nkg7,-7,-13,-20,3.038835,0,0
NKIRAS1,Nkiras1,8,-2,6,19.815534,0,0
NKIRAS2,Nkiras2,10,-6,4,91.514563,0,0
NKPD1,Nkpd1,-1,0,-1,0,0,0
NKRF,Nkrf,57,-9,48,67.864078,0,0
NKTR,Nktr,1,-7,-6,7.009709,0,0
NKX1-1,Nkx1-1,6,1,7,0,0,0
NKX1-2,Nkx1-2,8,2,10,0,0,0
NKX2-1,Nkx2-1,2,-1,1,0,0,0
NKX2-2,Nkx2-2,3,-1,2,0,0,0
NKX2-3,Nkx2-3,5,-1,4,0,0,0
NKX2-4,Nkx2-4,6,-5,1,0,0,0
NKX2-5,Nkx2-5,2,11,13,0,0,0
NKX2-6,Nkx2-6,-1,-5,-6,0,0,0
NKX3-1,Nkx3-1,11,-8,3,0,0,0
NKX3-2,Nkx3-2,7,2,9,3.941748,0,0
NKX6-1,Nkx6-1,8,-1,7,0.582524,0,0
NKX6-2,Nkx6-2,-5,-21,-26,0,0,0
NKX6-3,Nkx6-3,4,1,5,0,0,0
NLE1,Nle1,-1,-2,-3,15.378641,0,0
NLGN1,Nlgn1,6,-1,5,4.961165,0,0
NLGN2,Nlgn2,4,-5,-1,0,0,0
NLGN3,Nlgn3,21,5,26,0,0,0
NLK,Nlk,9,-2,7,0,0,0
NLN,Nln,1,-6,-5,1.165049,0,0
NLRC3,Nlrc3,0,4,4,0,0,0
NLRC4,Nlrc4,0,-4,-4,0,0,0
NLRC5,Nlrc5,-2,0,-2,0,0,0
NLRP10,Nlrp10,7,-2,5,0,0,0
NLRP12,Nlrp12,-3,3,0,0,0,0
NLRP14,Nlrp14,-2,-7,-9,0,0,0
NLRP2,Nlrp2,-4,-4,-8,0,0,0
NLRP3,Nlrp3,1,8,9,11.825243,0,0
NLRP5,Nlrp5,0,-2,-2,0,0,0
NLRP6,Nlrp6,10,8,18,1.15534,0,0
NLRX1,Nlrx1,-4,-3,-7,4.009709,0,0
NMB,Nmb,14,-4,10,14.320388,0,0
NMBR,Nmbr,-1,-10,-11,23.194175,0,0
NMD3,Nmd3,3,-2,1,7.718447,0,0
NME1,Nme1,7,1,8,35.281553,0,0
NME2,Nme2,10,0,10,31.058252,0,0
NME3,Nme3,-1,-5,-6,6.165049,0,0
NME4,Nme4,7,-13,-6,5.291262,0,0
NME5,Nme5,13,15,28,0,0,0
NME6,Nme6,-1,-9,-10,10.533981,0,0
NME7,Nme7,3,-2,1,14.339806,0,0
NME8,Nme8,2,2,4,1.038835,0,0
NME9,Nme9,-1,-6,-7,38.23301,0,0
NMI,Nmi,-7,-9,-16,9.398058,0,0
NMNAT1,Nmnat1,3,-7,-4,29.582524,0,0
NMNAT2,Nmnat2,4,-1,3,0,0,0
NMNAT3,Nmnat3,9,5,14,0,0,0
NMRAL1,Nmral1,5,-9,-4,4.038835,0,0
NMRK1,Nmrk1,9,3,12,4.621359,0,0
NMRK2,Nmrk2,21,-6,15,2.699029,0,0
NMS,Nms,3,0,3,30.864078,0,0
NMT1,Nmt1,6,-1,5,0,0,0
NMT2,Nmt2,6,-2,4,3.533981,0,0
NMU,Nmu,-2,15,13,3.38835,0,0
NMUR1,Nmur1,-2,2,0,26.087379,0,0
NMUR2,Nmur2,5,0,5,0,0,0
NNAT,Nnat,18,-2,16,0.980583,0,0
NNMT,Nnmt,-5,2,-3,0.76699,0,0
NNT,Nnt,7,-2,5,2.058252,0,0
NOA1,Noa1,-1,-3,-4,0,0,0
NOB1,Nob1,3,-6,-3,12.009709,0,0
NOBOX,Nobox,-1,2,1,0,0,0
NOC2L,Noc2l,11,1,12,1.572816,0,0
NOC3L,Noc3l,1,-4,-3,13.087379,0,0
NOC4L,Noc4l,-4,0,-4,7.543689,0,0
NOCT,Noct,20,-5,15,14.796117,0,0
NOD1,Nod1,-9,-2,-11,7.058252,0,0
NOD2,Nod2,3,-13,-10,1.165049,0,0
NODAL,Nodal,14,-1,13,10.504854,0,0
NOG,Nog,-1,10,9,0.805825,0,0
NOL10,Nol10,5,3,8,7.728155,0,0
NOL11,Nol11,-5,-6,-11,31.398058,0,0
NOL12,Nol12,-5,1,-4,4.524272,0,0
NOL3,Nol3,6,-1,5,3.640777,0,0
NOL4,Nol4,-5,-4,-9,2.592233,0,0
NOL4L,Nol4l,6,-6,0,3.203883,0,0
NOL6,Nol6,3,1,4,2.252427,0,0
NOL7,Nol7,4,-1,3,22.601942,0,0
NOL8,Nol8,4,-2,2,7.796117,0,0
NOL9,Nol9,3,-3,0,11.970874,0,0
NOLC1,Nolc1,5,2,7,3.349515,0,0
NOM1,Nom1,4,-2,2,13.271845,0,0
NOMO1,Nomo1,4,-6,-2,3.019417,0,0
NONO,Nono,7,-3,4,0,0,0
NOP10,Nop10,6,-6,0,6.048544,0,0
NOP14,Nop14,5,-1,4,15.271845,0,0
NOP16,Nop16,-1,-1,-2,2.514563,0,0
NOP2,Nop2,0,-4,-4,4,0,0
NOP53,Nop53,5,-3,2,3.203883,0,0
NOP56,Nop56,3,-5,-2,0,0,0
NOP58,Nop58,5,-2,3,208.048544,16.416667,209
NOP9,Nop9,6,-7,-1,5.951456,0,0
NOS1,Nos1,3,2,5,0,0,0
NOS1AP,Nos1ap,9,0,9,6.029126,0,0
NOS2,Nos2,0,-2,-2,0,0,0
NOS3,Nos3,-2,0,-2,0.699029,0,0
NOSIP,Nosip,4,0,4,11.669903,0,0
NOSTRIN,Nostrin,6,-1,5,0,0,0
NOTCH1,Notch1,12,3,15,10.669903,0,0
NOTCH2,Notch2,12,-2,10,24.15534,0,0
NOTCH3,Notch3,16,10,26,2.174757,0,0
NOTCH4,Notch4,-4,-6,-10,0,0,0
NOTO,Noto,3,3,6,0,0,0
NOTUM,Notum,10,7,17,1.087379,0,0
NOVA1,Nova1,4,3,7,3.951456,0,0
NOVA2,Nova2,4,-8,-4,0,0,0
NOX1,Nox1,1,-1,0,0,0,0
NOX3,Nox3,1,-3,-2,0,0,0
NOX4,Nox4,0,-6,-6,0,0,0
NOXA1,Noxa1,-6,1,-5,34.262136,0,0
NOXO1,Noxo1,3,-11,-8,31.786408,0,0
NOXRED1,Noxred1,58,14,72,0,0,0
NPAS1,Npas1,2,-5,-3,1.368932,0,0
NPAS2,Npas2,9,1,10,0,0,0
NPAS3,Npas3,12,7,19,4.485437,0,0
NPAS4,Npas4,16,-4,12,19.174757,0,0
NPAT,Npat,0,-3,-3,4.300971,0,0
NPB,Npb,9,-23,-14,3.883495,0,0
NPBWR1,Npbwr1,4,0,4,0,0,0
NPC1,Npc1,10,-1,9,7.76699,0,0
NPC1L1,Npc1l1,52,4,56,0,0,0
NPC2,Npc2,9,0,9,8.291262,0,0
NPDC1,Npdc1,11,-5,6,0,0,0
NPEPL1,Npepl1,-1,-7,-8,6.834951,0,0
NPEPPS,Npepps,9,-2,7,8.834951,0,0
NPFF,Npff,0,-4,-4,0,0,0
NPFFR1,Npffr1,3,-1,2,0.932039,0,0
NPFFR2,Npffr2,-1,4,3,0,0,0
NPHP1,Nphp1,0,-10,-10,61.174757,0,0
NPHP3,Nphp3,0,-9,-9,1.330097,0,0
NPHP4,Nphp4,-2,-2,-4,0,0,0
NPHS1,Nphs1,7,4,11,0,0,0
NPHS2,Nphs2,1,3,4,0,0,0
NPL,Npl,5,2,7,24.339806,0,0
NPLOC4,Nploc4,6,-4,2,24.213592,0,0
NPM1,Npm1,5,-9,-4,10.252427,0,0
NPM2,Npm2,0,-2,-2,0,0,0
NPM3,Npm3,4,-5,-1,0,0,0
NPNT,Npnt,13,-1,12,6.796117,0,0
NPPA,Nppa,6,-3,3,0,0,0
NPPB,Nppb,13,3,16,0,0,0
NPPC,Nppc,24,3,27,0,0,0
NPR1,Npr1,-1,-1,-2,0,0,0
NPR2,Npr2,10,2,12,0,0,0
NPR3,Npr3,24,-3,21,21.873786,0,0
NPRL2,Nprl2,6,5,11,2.776699,0,0
NPRL3,Nprl3,11,-5,6,20.815534,0,0
NPS,Nps,-2,-8,-10,0,0,0
NPSR1,Npsr1,-1,-2,-3,0,0,0
NPTN,Nptn,5,-3,2,0,0,0
NPTX1,Nptx1,3,9,12,0,0,0
NPTX2,Nptx2,7,-5,2,0,0,0
NPTXR,Nptxr,5,-7,-2,0,0,0
NPVF,Npvf,0,-4,-4,0,0,0
NPW,Npw,22,3,25,0,0,0
NPY,Npy,6,1,7,0,0,0
NPY1R,Npy1r,8,0,8,0.941748,0,0
NPY2R,Npy2r,-6,1,-5,0,0,0
NPY4R,Npy4r,-9,-2,-11,1.009709,0,0
NPY5R,Npy5r,1,-6,-5,0,0,0
NQO1,Nqo1,9,0,9,59.932039,0,0
NQO2,Nqo2,5,-15,-10,4.466019,0,0
NR0B1,Nr0b1,8,3,11,0,0,0
NR0B2,Nr0b2,16,14,30,0,0,0
NR1D1,Nr1d1,6,0,6,42.84466,0,0
NR1D2,Nr1d2,7,-6,1,9.631068,0,0
NR1H2,Nr1h2,5,-2,3,7.349515,0,0
NR1H3,Nr1h3,10,7,17,15.262136,0,0
NR1H4,Nr1h4,11,7,18,0,0,0
NR1I2,Nr1i2,0,-4,-4,0,0,0
NR1I3,Nr1i3,-2,-3,-5,0,0,0
NR2C1,Nr2c1,4,-7,-3,4.786408,0,0
NR2C2,Nr2c2,8,-5,3,16.61165,0,0
NR2C2AP,Nr2c2ap,0,-1,-1,13.951456,0,0
NR2E1,Nr2e1,25,-1,24,0,0,0
NR2E3,Nr2e3,-1,2,1,3.679612,0,0
NR2F1,Nr2f1,11,3,14,0,0,0
NR2F2,Nr2f2,9,0,9,79.61165,5.75,0
NR2F6,Nr2f6,6,1,7,62.495146,0,0
NR3C1,Nr3c1,10,0,10,2.92233,0,0
NR3C2,Nr3c2,6,-5,1,1.097087,0,0
NR4A1,Nr4a1,44,4,48,81.679612,0,0
NR4A2,Nr4a2,47,1,48,0.786408,0,0
NR4A3,Nr4a3,68,19,87,20.330097,0,0
NR5A1,Nr5a1,7,8,15,0,0,0
NR5A2,Nr5a2,3,-3,0,8.941748,6.041667,0
NR6A1,Nr6a1,3,-6,-3,6.456311,0,0
NRAP,Nrap,5,-4,1,7.553398,0,0
NRARP,Nrarp,33,-2,31,7.145631,0,0
NRAS,Nras,5,-10,-5,5.38835,0,0
NRBF2,Nrbf2,1,-6,-5,16.009709,0,0
NRBP1,Nrbp1,2,-8,-6,4.902913,0,0
NRBP2,Nrbp2,5,-1,4,2.407767,0,0
NRCAM,Nrcam,0,-13,-13,31.427184,0,0
NRDE2,Nrde2,1,-11,-10,5.097087,0,0
NREP,Nrep,2,-3,-1,8.504854,0,0
NRF1,Nrf1,4,-7,-3,15.776699,0,0
NRG1,Nrg1,-4,1,-3,1.417476,0,0
NRG2,Nrg2,2,2,4,2.669903,0,0
NRG3,Nrg3,2,-3,-1,0,0,0
NRG4,Nrg4,0,-12,-12,0,0,0
NRGN,Nrgn,-5,1,-4,1.970874,0,0
NRIP1,Nrip1,4,-4,0,1.417476,0,0
NRIP2,Nrip2,7,-5,2,0,0,0
NRIP3,Nrip3,2,4,6,0,0,0
NRK,Nrk,1,2,3,0,0,0
NRL,Nrl,-4,5,1,8.572816,0,0
NRM,Nrm,5,-10,-5,1.252427,0,0
NRN1,Nrn1,5,1,6,0,0,0
NRN1L,Nrn1l,31,10,41,0,0,0
NRP1,Nrp1,6,6,12,7.970874,0,0
NRP2,Nrp2,3,-7,-4,1.262136,0,0
NRROS,Nrros,-7,-8,-15,0,0,0
NRSN1,Nrsn1,9,-1,8,0,0,0
NRSN2,Nrsn2,-1,0,-1,46.242718,0,225
NRTN,Nrtn,1,3,4,4.582524,0,0
NRXN1,Nrxn1,5,5,10,0,0,0
NRXN2,Nrxn2,15,3,18,2.038835,0,0
NRXN3,Nrxn3,8,-2,6,1.504854,0,0
NSA2,Nsa2,5,-7,-2,34.572816,0,0
NSD1,Nsd1,3,-3,0,3.291262,0,0
NSD2,Nsd2,11,-2,9,6.980583,0,0
NSD3,Nsd3,7,-1,6,2.485437,0,0
NSDHL,Nsdhl,-5,-3,-8,4.407767,0,0
NSF,Nsf,6,-4,2,0,0,0
NSFL1C,Nsfl1c,4,-8,-4,45.757282,0,0
NSG1,Nsg1,9,-4,5,0,0,0
NSG2,Nsg2,14,6,20,9.330097,0,0
NSL1,Nsl1,5,-4,1,18.300971,0,0
NSMAF,Nsmaf,5,-7,-2,1.398058,0,0
NSMCE1,Nsmce1,3,-6,-3,0,0,0
NSMCE2,Nsmce2,6,2,8,20.320388,0,0
NSMCE3,Nsmce3,6,-3,3,7.038835,0,0
NSMCE4A,Nsmce4a,1,-2,-1,4.368932,0,0
NSMF,Nsmf,6,-8,-2,6.941748,0,0
NSRP1,Nsrp1,-3,2,-1,0,0,0
NSUN2,Nsun2,7,-7,0,0,0,0
NSUN3,Nsun3,-1,-3,-4,2.660194,0,0
NSUN4,Nsun4,4,-3,1,16.029126,0,0
NSUN5,Nsun5,5,-8,-3,3.485437,0,0
NSUN6,Nsun6,20,-4,16,4,0,0
NSUN7,Nsun7,-1,-13,-14,0,0,0
NT5C,Nt5c,-4,-4,-8,19.650485,0,0
NT5C1A,Nt5c1a,-1,6,5,0,0,0
NT5C1B,Nt5c1b,-1,-3,-4,0,0,0
NT5C2,Nt5c2,6,-10,-4,18.737864,0,0
NT5C3B,Nt5c3b,-1,-3,-4,1.174757,0,0
NT5DC1,Nt5dc1,-1,-11,-12,7.524272,3.666667,0
NT5DC2,Nt5dc2,6,-4,2,12.029126,0,0
NT5DC3,Nt5dc3,1,-2,-1,11.31068,0,0
NT5E,Nt5e,4,0,4,6.097087,0,0
NT5M,Nt5m,-1,-1,-2,3.417476,0,0
NTAN1,Ntan1,8,-5,3,68.116505,26,0
NTF3,Ntf3,-3,-8,-11,0,0,0
NTHL1,Nthl1,5,-5,0,7.116505,0,0
NTM,Ntm,4,-5,-1,0,0,0
NTMT1,Ntmt1,8,-2,6,21.116505,0,0
NTN1,Ntn1,8,1,9,0,0,0
NTN3,Ntn3,-1,-4,-5,0.941748,0,0
NTN4,Ntn4,24,3,27,1.398058,0,0
NTN5,Ntn5,14,2,16,6.407767,0,0
NTNG1,Ntng1,-3,-6,-9,2.126214,0,0
NTNG2,Ntng2,4,2,6,0,0,0
NTPCR,Ntpcr,3,-5,-2,4.436893,0,0
NTRK1,Ntrk1,4,1,5,5.456311,0,0
NTRK2,Ntrk2,6,-6,0,2.339806,0,0
NTRK3,Ntrk3,10,-10,0,0,0,0
NTS,Nts,6,4,10,0,0,0
NTSR1,Ntsr1,-1,0,-1,0,0,0
NTSR2,Ntsr2,0,4,4,0,0,0
NUAK1,Nuak1,7,-3,4,3.281553,0,0
NUAK2,Nuak2,5,-2,3,1.184466,0,0
NUB1,Nub1,3,-6,-3,8.31068,0,0
NUBP1,Nubp1,5,-7,-2,4.262136,0,0
NUBP2,Nubp2,6,-4,2,0,0,0
NUBPL,Nubpl,2,-5,-3,0,0,0
NUCB1,Nucb1,49,-2,47,98.699029,0,0
NUCB2,Nucb2,3,-7,-4,64.504854,0,0
NUCKS1,Nucks1,6,-3,3,12.436893,0,0
NUDC,Nudc,23,1,24,262.563107,45.041667,224
NUDCD1,Nudcd1,5,-6,-1,9.31068,0,0
NUDCD2,Nudcd2,1,-4,-3,3.776699,0,0
NUDCD3,Nudcd3,8,-2,6,13.436893,0,0
NUDT1,Nudt1,9,-5,4,5.669903,0,0
NUDT10,Nudt10,3,-2,1,0,0,0
NUDT11,Nudt11,8,2,10,0.912621,0,0
NUDT12,Nudt12,-8,-6,-14,3.038835,0,0
NUDT13,Nudt13,4,1,5,0,0,0
NUDT14,Nudt14,1,-4,-3,2.92233,0,0
NUDT15,Nudt15,0,-6,-6,5.728155,0,0
NUDT16,Nudt16,4,-8,-4,1.679612,0,0
NUDT16L1,Nudt16l1,4,-3,1,0.970874,0,0
NUDT17,Nudt17,41,-4,37,5.31068,0,0
NUDT18,Nudt18,-11,-1,-12,1.737864,0,0
NUDT19,Nudt19,0,2,2,1.058252,0,0
NUDT2,Nudt2,4,-1,3,30.320388,0,0
NUDT21,Nudt21,12,-2,10,3.466019,0,0
NUDT22,Nudt22,4,-2,2,6.980583,0,0
NUDT3,Nudt3,4,-3,1,6.116505,0,0
NUDT4,Nudt4,10,-1,9,19.067961,0,0
NUDT5,Nudt5,7,-4,3,0,0,0
NUDT6,Nudt6,-3,-7,-10,4.84466,0,0
NUDT7,Nudt7,3,-1,2,0,0,0
NUDT8,Nudt8,-20,-3,-23,0.708738,0,0
NUDT9,Nudt9,16,0,16,110.679612,7.75,0
NUF2,Nuf2,2,-10,-8,44.582524,0,97
NUFIP1,Nufip1,-12,-4,-16,1.427184,0,0
NUFIP2,Nufip2,13,1,14,36.592233,11.166667,0
NUGGC,Nuggc,4,-10,-6,0,0,0
NUMA1,Numa1,8,-2,6,22.271845,0,0
NUMB,Numb,8,3,11,11.970874,0,0
NUMBL,Numbl,0,-7,-7,1.223301,0,0
NUP107,Nup107,1,-3,-2,5.679612,0,0
NUP133,Nup133,3,-1,2,6.38835,0,0
NUP153,Nup153,5,-2,3,16.174757,0,0
NUP155,Nup155,5,-1,4,23.07767,0,0
NUP160,Nup160,1,-5,-4,10.834951,0,0
NUP188,Nup188,7,-10,-3,5.61165,0,0
NUP205,Nup205,10,-3,7,1.543689,0,0
NUP210,Nup210,4,2,6,1.009709,0,0
NUP210L,Nup210l,6,-8,-2,0,0,0
NUP214,Nup214,0,-5,-5,9.553398,0,0
NUP35,Nup35,3,-8,-5,0.864078,0,0
NUP37,Nup37,2,-10,-8,14.242718,0,0
NUP43,Nup43,1,-3,-2,0,0,0
NUP50,Nup50,3,-4,-1,24.427184,0,0
NUP54,Nup54,1,-5,-4,13.572816,0,0
NUP62,Nup62,6,-3,3,33.815534,0,0
NUP62CL,Nup62cl,6,7,13,0,0,0
NUP85,Nup85,2,-5,-3,5.07767,0,0
NUP88,Nup88,-1,-1,-2,34.854369,0,0
NUP93,Nup93,9,-8,1,11.980583,0,0
NUP98,Nup98,5,-3,2,0,0,0
NUPR1,Nupr1,3,10,13,0,0,0
NUS1,Nus1,7,-3,4,8.048544,0,0
NUSAP1,Nusap1,5,-5,0,5.271845,0,0
NUTF2,Nutf2,3,1,4,83.029126,0,0
NVL,Nvl,6,-4,2,1.932039,0,0
NWD1,Nwd1,6,-1,5,0,0,0
NWD2,Nwd2,0,0,0,0,0,0
NXF1,Nxf1,8,-3,5,8.737864,0,0
NXF2,Nxf2,8,0,8,0,0,0
NXF3,Nxf3,2,-2,0,5.84466,0,0
NXN,Nxn,8,-5,3,0.68932,0,0
NXNL1,Nxnl1,16,-1,15,0,0,0
NXNL2,Nxnl2,-1,6,5,0,0,0
NXPE2,Nxpe2,0,-7,-7,0,0,0
NXPE3,Nxpe3,3,-8,-5,3.475728,0,0
NXPE4,Nxpe4,3,-5,-2,0,0,0
NXPH1,Nxph1,5,0,5,0,0,0
NXPH2,Nxph2,-2,-1,-3,0,0,0
NXPH3,Nxph3,6,3,9,0,0,0
NXPH4,Nxph4,9,1,10,9.718447,0,0
NXT1,Nxt1,-6,-1,-7,1.660194,0,0
NXT2,Nxt2,56,1,57,149.145631,18.416667,0
NYAP1,Nyap1,4,-6,-2,7.349515,0,0
NYAP2,Nyap2,-1,0,-1,0,0,0
NYNRIN,Nynrin,6,-6,0,0,0,0
NYX,Nyx,3,1,4,2.349515,0,0
OAF,Oaf,-3,-2,-5,3.339806,0,0
OARD1,Oard1,2,-7,-5,14.912621,0,0
OAS2,Oas2,0,0,0,0,0,0
OAS3,Oas3,-1,-5,-6,2.126214,0,0
OAT,Oat,13,-6,7,0.776699,0,0
OAZ1,Oaz1,5,-1,4,102.330097,40.833333,0
OAZ2,Oaz2,7,-4,3,2.174757,0,0
OAZ3,Oaz3,0,5,5,9,0,0
OBI1,Obi1,6,-9,-3,1.242718,0,0
OBP2A,Obp2a,4,14,18,0,0,0
OBP2B,Obp2b,3,5,8,0,0,0
OBSCN,Obscn,7,7,14,0,0,0
OBSL1,Obsl1,11,-6,5,0,0,0
OC90,Oc90,1,-7,-6,0,0,0
OCA2,Oca2,3,6,9,0,0,0
OCEL1,Ocel1,6,-1,5,6.543689,0,0
OCIAD1,Ociad1,10,-3,7,5.757282,0,0
OCIAD2,Ociad2,0,3,3,1.058252,0,0
OCLN,Ocln,2,1,3,15.990291,0,0
OCM,Ocm,1,-10,-9,7.495146,0,0
OCRL,Ocrl,2,0,2,3.737864,0,0
OCSTAMP,Ocstamp,0,2,2,0,0,0
ODAM,Odam,-2,2,0,0,0,0
ODAPH,Odaph,9,-7,2,0,0,0
ODC1,Odc1,6,0,6,41.368932,0,0
ODF1,Odf1,5,2,7,0,0,0
ODF2,Odf2,8,-1,7,22.203883,0,0
ODF2L,Odf2l,2,-7,-5,3.912621,0,0
ODF3,Odf3,1,-6,-5,0,0,0
ODF3B,Odf3b,4,4,8,0,0,0
ODF3L1,Odf3l1,8,-11,-3,0,0,0
ODF3L2,Odf3l2,9,3,12,18.271845,0,0
ODF4,Odf4,5,1,6,0,0,0
ODR4,Odr4,-3,-1,-4,2.912621,0,0
OFD1,Ofd1,0,-2,-2,3.31068,0,0
OGA,Oga,6,0,6,0,0,0
OGDH,Ogdh,9,-4,5,4.262136,0,0
OGDHL,Ogdhl,9,4,13,3.572816,0,0
OGFOD1,Ogfod1,-1,-3,-4,3.466019,0,0
OGFOD2,Ogfod2,1,1,2,2.271845,0,0
OGFOD3,Ogfod3,0,-3,-3,0,0,0
OGFR,Ogfr,-6,-7,-13,2.990291,0,0
OGFRL1,Ogfrl1,3,-10,-7,3.436893,0,0
OGG1,Ogg1,6,-6,0,1.640777,0,0
OGN,Ogn,-2,-7,-9,0,0,0
OGT,Ogt,6,-3,3,11.951456,0,0
OIP5,Oip5,1,-9,-8,5.271845,0,0
OIT3,Oit3,50,0,50,0,0,0
OLA1,Ola1,6,-4,2,2.572816,0,0
OLAH,Olah,12,-2,10,0,0,0
OLFM1,Olfm1,19,-3,16,12.524272,0,0
OLFM2,Olfm2,12,-4,8,8.592233,0,0
OLFM3,Olfm3,-1,-4,-5,0,0,0
OLFM4,Olfm4,-1,2,1,0,0,0
OLFML1,Olfml1,-5,5,0,0,0,0
OLFML2A,Olfml2a,0,3,3,2.320388,0,0
OLFML2B,Olfml2b,3,0,3,1.446602,0,0
OLFML3,Olfml3,16,0,16,0,0,0
OLIG1,Olig1,3,3,6,0,0,0
OLIG2,Olig2,4,1,5,0,0,0
OLIG3,Olig3,-1,1,0,0,0,0
OLR1,Olr1,2,5,7,0,0,0
OMA1,Oma1,3,-6,-3,11.61165,0,0
OMD,Omd,1,5,6,0,0,0
OMG,Omg,3,-5,-2,2.699029,0,0
OMP,Omp,1,0,1,0,0,0
ONECUT1,Onecut1,-1,-1,-2,0,0,0
ONECUT2,Onecut2,4,4,8,0.883495,0,0
ONECUT3,Onecut3,1,-1,0,6.31068,0,0
OOEP,Ooep,66,-3,63,0,0,0
OOSP1,Oosp1,15,5,20,0,0,0
OOSP2,Oosp2,3,-3,0,0,0,0
OOSP3,Oosp3,6,1,7,0,0,0
OPA1,Opa1,7,-1,6,77.941748,0,0
OPA3,Opa3,2,-4,-2,0,0,0
OPALIN,Opalin,2,-4,-2,0,0,0
OPCML,Opcml,-3,-1,-4,2.669903,0,0
OPHN1,Ophn1,3,-12,-9,3.097087,0,0
OPLAH,Oplah,0,0,0,0,0,0
OPN1MW,Opn1mw,1,-1,0,4.349515,0,0
OPN1SW,Opn1sw,-1,-4,-5,0,0,0
OPN3,Opn3,5,-4,1,16.07767,0,0
OPN4,Opn4,-1,-3,-4,0,0,0
OPN5,Opn5,9,0,9,0,0,0
OPRD1,Oprd1,22,-3,19,13.951456,0,0
OPRK1,Oprk1,3,1,4,0,0,0
OPRL1,Oprl1,1,-2,-1,6.349515,16.958333,0
OPRM1,Oprm1,-1,0,-1,0,0,0
OPTC,Optc,0,-5,-5,0,0,0
OPTN,Optn,2,-2,0,0,0,0
ORAI1,Orai1,-4,-10,-14,12.485437,0,0
ORAI2,Orai2,2,-4,-2,58.912621,0,0
ORAI3,Orai3,3,-2,1,17.932039,0,0
ORC1,Orc1,-3,-1,-4,6.038835,0,0
ORC2,Orc2,-4,-2,-6,6.368932,0,0
ORC3,Orc3,1,-4,-3,4.873786,0,0
ORC4,Orc4,5,0,5,4.912621,0,0
ORC5,Orc5,6,-6,0,22.514563,0,0
ORC6,Orc6,1,-8,-7,0,0,0
ORM1,Orm1,2,12,14,0,0,0
ORM2,Orm2,2,9,11,0,0,0
ORMDL1,Ormdl1,2,-4,-2,4.718447,0,0
ORMDL2,Ormdl2,3,-2,1,0,0,0
ORMDL3,Ormdl3,5,2,7,7.621359,0,0
OS9,Os9,6,1,7,0,0,0
OSBP,Osbp,6,-3,3,6.427184,5.416667,0
OSBP2,Osbp2,2,3,5,3.262136,0,0
OSBPL10,Osbpl10,6,-2,4,7.873786,0,0
OSBPL11,Osbpl11,5,-2,3,3.446602,0,0
OSBPL1A,Osbpl1a,10,-4,6,43.23301,0,0
OSBPL2,Osbpl2,5,-2,3,8.330097,0,0
OSBPL3,Osbpl3,17,-1,16,9.970874,0,0
OSBPL5,Osbpl5,3,-5,-2,0,0,0
OSBPL6,Osbpl6,2,0,2,6.893204,0,0
OSBPL7,Osbpl7,0,-6,-6,7.92233,0,0
OSBPL8,Osbpl8,8,-3,5,11.825243,0,0
OSBPL9,Osbpl9,4,-6,-2,1.07767,0,0
OSCAR,Oscar,7,4,11,13.38835,0,0
OSCP1,Oscp1,19,-6,13,52.029126,0,0
OSER1,Oser1,7,-2,5,10.805825,0,0
OSGEP,Osgep,4,1,5,5.058252,0,0
OSGEPL1,Osgepl1,1,-7,-6,0,0,0
OSGIN1,Osgin1,7,8,15,14.029126,0,0
OSGIN2,Osgin2,-7,-5,-12,7.048544,0,0
OSM,Osm,23,6,29,0,0,0
OSMR,Osmr,-1,0,-1,13.019417,0,0
OSR1,Osr1,-7,1,-6,0,0,0
OSR2,Osr2,23,-3,20,2.650485,0,0
OST4,Ost4,5,-2,3,10.747573,0,0
OSTC,Ostc,5,-12,-7,0,0,0
OSTF1,Ostf1,3,-3,0,4.621359,0,0
OSTM1,Ostm1,8,6,14,8.572816,0,0
OSTN,Ostn,-2,-7,-9,0,0,0
OTC,Otc,0,3,3,0,0,0
OTOA,Otoa,2,-8,-6,13.514563,0,0
OTOF,Otof,5,0,5,10.330097,0,0
OTOG,Otog,-6,-7,-13,0,0,0
OTOGL,Otogl,4,2,6,0,0,0
OTOL1,Otol1,2,0,2,0,0,0
OTOP1,Otop1,5,-7,-2,0,0,0
OTOP2,Otop2,2,-2,0,1.223301,0,0
OTOP3,Otop3,-1,-1,-2,0,0,0
OTOR,Otor,40,0,40,1.669903,0,0
OTOS,Otos,2,3,5,4.990291,0,0
OTP,Otp,18,0,18,0,0,0
OTUB1,Otub1,10,-1,9,64.533981,0,0
OTUB2,Otub2,-1,-4,-5,4.582524,0,0
OTUD1,Otud1,36,5,41,4.533981,0,0
OTUD3,Otud3,5,-1,4,5.708738,0,0
OTUD4,Otud4,6,-1,5,13.106796,0,0
OTUD5,Otud5,7,-2,5,28.165049,4.5,0
OTUD6A,Otud6a,6,3,9,0,0,0
OTUD6B,Otud6b,2,-8,-6,5.048544,0,0
OTUD7A,Otud7a,4,-10,-6,2.68932,0,0
OTUD7B,Otud7b,8,-4,4,23.737864,0,0
OTULIN,Otulin,15,-3,12,42.601942,5,0
OTULINL,Otulinl,3,-4,-1,4.048544,0,0
OTX1,Otx1,3,-8,-5,3,0,0
OTX2,Otx2,1,-3,-2,0,0,0
OVCA2,Ovca2,3,-4,-1,58.757282,0,0
OVCH2,Ovch2,-5,1,-4,0,0,0
OVGP1,Ovgp1,30,-1,29,0,0,0
OVOL1,Ovol1,9,-6,3,1.572816,0,0
OVOL2,Ovol2,-3,-11,-14,0,0,0
OVOL3,Ovol3,12,-2,10,15.165049,0,0
OXA1L,Oxa1l,4,-2,2,0,0,0
OXCT1,Oxct1,1,-1,0,4.961165,0,0
OXGR1,Oxgr1,-12,-7,-19,0,0,0
OXLD1,Oxld1,-4,-2,-6,0,0,0
OXNAD1,Oxnad1,4,-2,2,24.834951,0,0
OXR1,Oxr1,-1,-3,-4,22.165049,0,0
OXSM,Oxsm,-1,-8,-9,5.825243,0,0
OXSR1,Oxsr1,2,-5,-3,3.902913,0,0
OXT,Oxt,49,18,67,0,0,0
OXTR,Oxtr,17,-5,12,7.640777,0,0
P2RX1,P2rx1,2,-4,-2,0,0,0
P2RX2,P2rx2,-2,-8,-10,0,0,0
P2RX3,P2rx3,5,-9,-4,20.932039,0,0
P2RX4,P2rx4,-3,-5,-8,0,0,0
P2RX5,P2rx5,19,-4,15,0.737864,0,0
P2RX6,P2rx6,14,-4,10,0,0,0
P2RX7,P2rx7,2,17,19,0,0,0
P2RY1,P2ry1,9,2,11,13.339806,0,0
P2RY10,P2ry10,0,6,6,0,0,0
P2RY12,P2ry12,1,-1,0,0,0,0
P2RY13,P2ry13,-1,-6,-7,0,0,0
P2RY14,P2ry14,4,-1,3,0,0,0
P2RY2,P2ry2,-6,3,-3,1.262136,0,0
P2RY4,P2ry4,0,-4,-4,0,0,0
P2RY6,P2ry6,0,-8,-8,0,0,0
P3H1,P3h1,7,-3,4,2.990291,0,0
P3H2,P3h2,5,-2,3,9.330097,0,0
P3H3,P3h3,10,-2,8,5.009709,0,0
P3H4,P3h4,-4,1,-3,2.679612,0,0
P4HA1,P4ha1,10,15,25,79.359223,16.833333,0
P4HA2,P4ha2,19,8,27,149.417476,52.041667,0
P4HA3,P4ha3,2,0,2,0,0,0
P4HB,P4hb,9,0,9,2.796117,0,0
P4HTM,P4htm,10,3,13,77.359223,0,0
PA2G4,Pa2g4,6,-5,1,23.009709,0,0
PABPC1,Pabpc1,10,-7,3,12.087379,0,0
PABPC1L,Pabpc1l,0,-4,-4,0,0,0
PABPC4,Pabpc4,5,-3,2,9.262136,0,0
PABPC4L,Pabpc4l,37,-2,35,33.456311,0,0
PABPC5,Pabpc5,-9,-6,-15,0,0,0
PABPN1,Pabpn1,5,3,8,6.135922,0,0
PABPN1L,Pabpn1l,-7,6,-1,0,0,0
PACC1,Pacc1,3,-2,1,8.31068,0,0
PACRG,Pacrg,-1,5,4,14.553398,0,0
PACS1,Pacs1,8,-1,7,36.165049,0,0
PACS2,Pacs2,3,-3,0,6.300971,0,0
PACSIN1,Pacsin1,0,-6,-6,3.456311,0,0
PACSIN2,Pacsin2,6,2,8,0.932039,0,0
PACSIN3,Pacsin3,0,-6,-6,4.242718,0,0
PADI1,Padi1,1,-3,-2,0,0,0
PADI2,Padi2,1,2,3,0,0,0
PADI3,Padi3,2,-1,1,22.941748,0,0
PADI4,Padi4,13,3,16,0,0,0
PADI6,Padi6,2,-6,-4,0,0,0
PAF1,Paf1,8,-2,6,6.504854,0,0
PAFAH1B1,Pafah1b1,9,0,9,5.543689,0,0
PAFAH1B2,Pafah1b2,8,-1,7,8.553398,0,0
PAFAH1B3,Pafah1b3,9,-2,7,3.165049,0,0
PAFAH2,Pafah2,3,-2,1,18.932039,0,0
PAG1,Pag1,5,-4,1,9.757282,3.625,0
PAH,Pah,-3,3,0,0,0,0
PAICS,Paics,8,-1,7,7.650485,0,0
PAIP1,Paip1,10,-3,7,17.699029,0,0
PAIP2,Paip2,7,1,8,4.737864,0,0
PAIP2B,Paip2b,1,-7,-6,0,0,0
PAK1,Pak1,6,-2,4,11.970874,0,0
PAK1IP1,Pak1ip1,-6,-2,-8,0.951456,0,0
PAK2,Pak2,8,-4,4,14.796117,0,0
PAK3,Pak3,13,-4,9,0,0,0
PAK4,Pak4,8,-4,4,38.708738,0,0
PAK5,Pak5,-1,-6,-7,0,0,0
PAK6,Pak6,3,4,7,3.31068,0,0
PALB2,Palb2,-14,-9,-23,16.135922,0,155
PALD1,Pald1,1,-2,-1,0.621359,0,0
PALLD,Palld,11,-2,9,15.203883,0,0
PALM,Palm,5,-6,-1,0,0,0
PALM3,Palm3,-5,-4,-9,4.145631,0,0
PALMD,Palmd,1,5,6,0,0,0
PAM,Pam,6,2,8,14.737864,0,0
PAM16,Pam16,8,-1,7,4.184466,0,0
PAMR1,Pamr1,-1,4,3,0,0,0
PAN2,Pan2,10,-4,6,8.048544,0,0
PAN3,Pan3,3,0,3,3.097087,0,0
PANK1,Pank1,7,-1,6,3.864078,0,0
PANK2,Pank2,3,-7,-4,7.912621,0,0
PANK3,Pank3,8,3,11,7.679612,0,0
PANK4,Pank4,-5,-6,-11,6.07767,0,0
PANX1,Panx1,-1,-3,-4,9.184466,0,0
PANX2,Panx2,0,-6,-6,0,0,0
PANX3,Panx3,3,-5,-2,0,0,0
PAOX,Paox,-1,-4,-5,0,0,0
PAPLN,Papln,1,3,4,0,0,0
PAPOLA,Papola,17,0,17,136.223301,81.041667,0
PAPOLB,Papolb,4,6,10,7.660194,0,0
PAPOLG,Papolg,2,-6,-4,11.932039,0,0
PAPPA,Pappa,2,-1,1,0.980583,0,0
PAPPA2,Pappa2,0,-2,-2,0,0,0
PAPSS1,Papss1,8,-8,0,3.398058,0,0
PAPSS2,Papss2,2,2,4,1.058252,0,0
PAQR3,Paqr3,12,-3,9,10.252427,0,0
PAQR4,Paqr4,-1,-3,-4,9.650485,0,0
PAQR5,Paqr5,-14,-11,-25,0,0,0
PAQR6,Paqr6,5,6,11,0,0,0
PAQR7,Paqr7,1,-10,-9,14.563107,0,0
PAQR8,Paqr8,-2,-7,-9,1.097087,0,0
PAQR9,Paqr9,11,1,12,0.679612,0,0
PARD3,Pard3,10,-1,9,4.864078,0,0
PARD3B,Pard3b,8,1,9,2.349515,0,0
PARD6A,Pard6a,4,1,5,2.864078,0,0
PARD6B,Pard6b,17,4,21,26.427184,0,0
PARD6G,Pard6g,5,-5,0,0,0,0
PARG,Parg,6,-5,1,21.582524,0,0
PARK7,Park7,10,-5,5,49.067961,11.708333,0
PARL,Parl,-3,-4,-7,11.213592,0,0
PARM1,Parm1,2,6,8,1.15534,0,0
PARN,Parn,5,-2,3,4.320388,0,0
PARP1,Parp1,7,-8,-1,18.563107,0,0
PARP10,Parp10,-2,-6,-8,3.834951,0,0
PARP11,Parp11,3,-16,-13,16.864078,0,0
PARP12,Parp12,1,-1,0,0,0,0
PARP14,Parp14,1,-1,0,29.893204,0,0
PARP16,Parp16,5,-5,0,5.466019,0,0
PARP2,Parp2,2,-6,-4,46.116505,7.041667,0
PARP3,Parp3,5,3,8,11.864078,0,0
PARP4,Parp4,2,-3,-1,2.786408,0,0
PARP6,Parp6,0,-1,-1,0,0,0
PARP8,Parp8,7,-4,3,8.368932,0,0
PARP9,Parp9,-5,-1,-6,10.048544,3.333333,0
PARPBP,Parpbp,4,-14,-10,14.242718,0,0
PARS2,Pars2,-4,-14,-18,4.058252,0,0
PARVA,Parva,6,-2,4,3.834951,0,0
PARVB,Parvb,6,0,6,24.650485,0,0
PARVG,Parvg,18,14,32,3.679612,0,0
PASK,Pask,3,-11,-8,0.92233,0,0
PATE1,Pate1,5,2,7,0,0,0
PATE2,Pate2,-3,-9,-12,0,0,0
PATE3,Pate3,4,0,4,1.533981,0,0
PATE4,Pate4,2,2,4,0,0,0
PATJ,Patj,2,-3,-1,3.252427,0,0
PATL1,Patl1,9,-6,3,4.223301,0,0
PATL2,Patl2,9,-6,3,0,0,0
PATZ1,Patz1,-14,-5,-19,1.553398,0,0
PAWR,Pawr,4,10,14,3.84466,0,0
PAX1,Pax1,-4,-5,-9,0,0,0
PAX2,Pax2,2,-2,0,16.475728,0,0
PAX3,Pax3,3,-8,-5,0,0,0
PAX4,Pax4,2,2,4,0,0,0
PAX5,Pax5,7,3,10,0,0,0
PAX6,Pax6,6,-6,0,1.106796,0,0
PAX7,Pax7,4,-1,3,0,0,0
PAX8,Pax8,-6,-2,-8,89.398058,64.458333,0
PAX9,Pax9,1,-3,-2,6.980583,0,0
PAXBP1,Paxbp1,4,-4,0,15.417476,0,0
PAXIP1,Paxip1,-4,-5,-9,7.368932,0,0
PAXX,Paxx,0,-2,-2,1.126214,0,0
PBDC1,Pbdc1,-11,-3,-14,0,0,0
PBK,Pbk,2,-16,-14,5.524272,0,0
PBRM1,Pbrm1,8,-7,1,16.592233,0,0
PBX1,Pbx1,2,2,4,0,0,0
PBX2,Pbx2,7,-4,3,2.242718,0,0
PBX3,Pbx3,12,-4,8,16.330097,0,0
PBX4,Pbx4,0,-7,-7,39.524272,0,0
PBXIP1,Pbxip1,5,-4,1,0,0,0
PCARE,Pcare,4,-6,-2,0,0,0
PCBD1,Pcbd1,8,8,16,234.349515,143.125,184
PCBD2,Pcbd2,1,-13,-12,4.009709,0,0
PCBP1,Pcbp1,11,1,12,12.203883,0,0
PCBP2,Pcbp2,10,-6,4,18.553398,0,0
PCBP3,Pcbp3,1,-9,-8,0,0,0
PCBP4,Pcbp4,10,3,13,1.194175,0,0
PCCA,Pcca,1,-12,-11,2.359223,0,0
PCCB,Pccb,1,-7,-6,5.61165,0,0
PCDH1,Pcdh1,4,-2,2,6.941748,0,0
PCDH10,Pcdh10,10,-5,5,0,0,0
PCDH11X,Pcdh11x,-3,-1,-4,0,0,0
PCDH12,Pcdh12,5,-6,-1,0,0,0
PCDH15,Pcdh15,0,-3,-3,5.009709,0,0
PCDH17,Pcdh17,1,2,3,0,0,0
PCDH18,Pcdh18,-5,-6,-11,0,0,0
PCDH19,Pcdh19,10,-2,8,0,0,0
PCDH20,Pcdh20,2,0,2,0,0,0
PCDH7,Pcdh7,5,-1,4,0,0,0
PCDH8,Pcdh8,8,-3,5,0.834951,0,0
PCDH9,Pcdh9,5,-3,2,8.805825,0,0
PCDHA1,Pcdha1,5,2,7,0,0,0
PCDHA11,Pcdha11,6,6,12,0,0,0
PCDHA12,Pcdha12,2,-1,1,0,0,0
PCDHA2,Pcdha2,1,-9,-8,0,0,0
PCDHA3,Pcdha3,2,-4,-2,0,0,0
PCDHA4,Pcdha4,-2,3,1,0,0,0
PCDHA5,Pcdha5,3,-4,-1,0,0,0
PCDHA6,Pcdha6,2,-9,-7,0,0,0
PCDHA7,Pcdha7,1,-3,-2,0,0,0
PCDHA8,Pcdha8,5,-3,2,0,0,0
PCDHA9,Pcdha9,3,-1,2,0,0,0
PCDHAC1,Pcdhac1,4,-3,1,5.951456,0,0
PCDHAC2,Pcdhac2,4,0,4,6.436893,0,0
PCDHB1,Pcdhb1,-1,2,1,0,0,0
PCDHB10,Pcdhb10,2,2,4,0,0,0
PCDHB11,Pcdhb11,4,3,7,0,0,0
PCDHB12,Pcdhb12,-1,-5,-6,0,0,0
PCDHB13,Pcdhb13,-1,-2,-3,0,0,0
PCDHB14,Pcdhb14,10,2,12,3.747573,0,0
PCDHB15,Pcdhb15,-1,-1,-2,0,0,0
PCDHB16,Pcdhb16,-1,3,2,0,0,0
PCDHB2,Pcdhb2,8,-2,6,0,0,0
PCDHB3,Pcdhb3,2,2,4,0,0,0
PCDHB4,Pcdhb4,0,-3,-3,0,0,0
PCDHB5,Pcdhb5,4,-2,2,0,0,0
PCDHB6,Pcdhb6,-3,3,0,0,0,0
PCDHB7,Pcdhb7,-1,-1,-2,0,0,0
PCDHB8,Pcdhb8,1,-2,-1,0,0,0
PCDHB9,Pcdhb9,-2,-5,-7,0,0,0
PCDHGA1,Pcdhga1,15,-5,10,0,0,0
PCDHGA10,Pcdhga10,-1,3,2,0,0,0
PCDHGA11,Pcdhga11,7,0,7,0,0,0
PCDHGA12,Pcdhga12,5,-5,0,0,0,0
PCDHGA2,Pcdhga2,11,7,18,0,0,0
PCDHGA3,Pcdhga3,9,3,12,0,0,0
PCDHGA4,Pcdhga4,3,-4,-1,0,0,0
PCDHGA5,Pcdhga5,4,2,6,0,0,0
PCDHGA6,Pcdhga6,3,1,4,0,0,0
PCDHGA7,Pcdhga7,5,2,7,0,0,0
PCDHGA8,Pcdhga8,5,1,6,0,0,0
PCDHGA9,Pcdhga9,4,5,9,0,0,0
PCDHGB1,Pcdhgb1,5,1,6,0,0,0
PCDHGB2,Pcdhgb2,1,-1,0,0,0,0
PCDHGB4,Pcdhgb4,2,3,5,0,0,0
PCDHGB5,Pcdhgb5,7,6,13,0,0,0
PCDHGB6,Pcdhgb6,0,1,1,0,0,0
PCDHGB7,Pcdhgb7,7,2,9,0,0,0
PCDHGC3,Pcdhgc3,5,5,10,0,0,0
PCDHGC4,Pcdhgc4,13,-12,1,0,0,0
PCDHGC5,Pcdhgc5,2,2,4,0,0,0
PCED1A,Pced1a,12,-1,11,4.514563,0,0
PCED1B,Pced1b,-19,-3,-22,6.514563,0,0
PCF11,Pcf11,7,2,9,3.339806,0,0
PCGF1,Pcgf1,-1,-7,-8,16.194175,0,0
PCGF2,Pcgf2,12,1,13,27.320388,0,0
PCGF3,Pcgf3,3,-1,2,1.873786,0,0
PCGF5,Pcgf5,7,3,10,1.300971,0,0
PCGF6,Pcgf6,2,-4,-2,1.834951,0,0
PCID2,Pcid2,1,-2,-1,11.135922,0,0
PCIF1,Pcif1,-4,-3,-7,12.106796,0,0
PCK1,Pck1,40,8,48,11.174757,0,116
PCK2,Pck2,-1,4,3,5.281553,0,0
PCLAF,Pclaf,2,-12,-10,0,0,0
PCLO,Pclo,1,1,2,9.427184,0,0
PCM1,Pcm1,7,-6,1,26.165049,0,0
PCMT1,Pcmt1,6,-5,1,7.834951,0,0
PCMTD1,Pcmtd1,-5,-5,-10,3.31068,0,0
PCMTD2,Pcmtd2,2,-7,-5,8.592233,0,0
PCNA,Pcna,-2,0,-2,10.92233,0,0
PCNP,Pcnp,15,-3,12,9.854369,0,0
PCNT,Pcnt,5,-6,-1,1.31068,0,0
PCNX2,Pcnx2,12,-3,9,4.038835,0,0
PCNX3,Pcnx3,14,1,15,4.07767,0,0
PCNX4,Pcnx4,8,-1,7,44.961165,0,0
PCOLCE,Pcolce,-1,-3,-4,2.048544,0,0
PCOLCE2,Pcolce2,-1,-6,-7,4.417476,0,0
PCP2,Pcp2,9,-7,2,4.495146,0,0
PCP4,Pcp4,0,6,6,0,0,0
PCP4L1,Pcp4l1,13,3,16,0,0,0
PCSK1,Pcsk1,5,1,6,4.038835,0,0
PCSK1N,Pcsk1n,18,2,20,6.038835,0,0
PCSK2,Pcsk2,3,-3,0,0,0,0
PCSK4,Pcsk4,5,-10,-5,46.291262,0,0
PCSK5,Pcsk5,98,2,100,0,0,0
PCSK6,Pcsk6,4,-2,2,0,0,0
PCSK7,Pcsk7,10,-8,2,11.582524,0,0
PCSK9,Pcsk9,-17,1,-16,1.446602,0,0
PCTP,Pctp,4,-9,-5,16.68932,0,0
PCYOX1,Pcyox1,5,-5,0,12.504854,0,0
PCYOX1L,Pcyox1l,-5,-3,-8,14.699029,0,0
PCYT1A,Pcyt1a,9,-4,5,9.873786,0,0
PCYT1B,Pcyt1b,2,-3,-1,5.582524,0,0
PCYT2,Pcyt2,0,0,0,1.15534,0,0
PDAP1,Pdap1,11,-2,9,7.495146,0,0
PDC,Pdc,9,-5,4,0,0,0
PDCD1,Pdcd1,14,1,15,26.378641,0,0
PDCD10,Pdcd10,1,-7,-6,2.951456,0,0
PDCD11,Pdcd11,6,-1,5,0,0,0
PDCD1LG2,Pdcd1lg2,1,1,2,0,0,0
PDCD2,Pdcd2,-2,4,2,10.825243,0,0
PDCD2L,Pdcd2l,-3,-1,-4,2.990291,0,0
PDCD4,Pdcd4,5,-9,-4,4.902913,0,0
PDCD5,Pdcd5,6,-8,-2,3.213592,0,0
PDCD6,Pdcd6,11,-4,7,34.699029,0,0
PDCD6IP,Pdcd6ip,5,-1,4,6.825243,0,0
PDCD7,Pdcd7,0,-3,-3,2.563107,0,0
PDCL,Pdcl,5,-2,3,0.932039,0,0
PDCL2,Pdcl2,4,-9,-5,0,0,0
PDCL3,Pdcl3,0,1,1,2.84466,0,0
PDE10A,Pde10a,4,-1,3,0.854369,0,0
PDE11A,Pde11a,2,6,8,13.194175,0,0
PDE12,Pde12,6,-1,5,5.271845,0,0
PDE1A,Pde1a,1,-8,-7,0,0,0
PDE1B,Pde1b,8,-1,7,0,0,0
PDE1C,Pde1c,17,-7,10,0,0,0
PDE2A,Pde2a,36,7,43,2.145631,0,0
PDE3A,Pde3a,0,3,3,2.378641,0,0
PDE3B,Pde3b,6,3,9,3.650485,0,0
PDE4A,Pde4a,7,-11,-4,89.23301,0,0
PDE4B,Pde4b,1,-3,-2,0,0,0
PDE4C,Pde4c,5,4,9,5.38835,0,0
PDE4D,Pde4d,3,-3,0,1.291262,0,0
PDE4DIP,Pde4dip,14,-8,6,13.699029,0,0
PDE5A,Pde5a,7,-5,2,2.864078,0,0
PDE6A,Pde6a,4,3,7,0,0,0
PDE6B,Pde6b,5,-3,2,0,0,0
PDE6C,Pde6c,2,-3,-1,0,0,0
PDE6D,Pde6d,16,-7,9,24.776699,0,0
PDE6G,Pde6g,34,11,45,42.359223,0,0
PDE6H,Pde6h,0,-15,-15,1.84466,0,0
PDE7A,Pde7a,3,-2,1,6.786408,0,0
PDE7B,Pde7b,1,-2,-1,0,0,0
PDE8A,Pde8a,4,-5,-1,16.203883,0,0
PDE8B,Pde8b,-6,-5,-11,2.941748,0,0
PDE9A,Pde9a,3,-1,2,0,0,0
PDF,Pdf,0,4,4,7.009709,0,0
PDGFA,Pdgfa,3,0,3,0,0,0
PDGFB,Pdgfb,-1,1,0,0,0,0
PDGFC,Pdgfc,3,-2,1,0,0,0
PDGFD,Pdgfd,-1,0,-1,0,0,0
PDGFRA,Pdgfra,5,2,7,1.640777,0,0
PDGFRB,Pdgfrb,-3,0,-3,0,0,0
PDGFRL,Pdgfrl,-2,-4,-6,2.961165,0,0
PDHA1,Pdha1,1,-6,-5,2.796117,0,0
PDHA2,Pdha2,0,-1,-1,0,0,0
PDHB,Pdhb,-1,-3,-4,6.621359,0,0
PDHX,Pdhx,5,-2,3,8.553398,0,0
PDIA2,Pdia2,19,-10,9,0,0,0
PDIA3,Pdia3,7,2,9,6.815534,0,0
PDIA4,Pdia4,11,-3,8,5.184466,0,0
PDIA5,Pdia5,-2,-14,-16,12.427184,4.708333,0
PDIA6,Pdia6,10,-6,4,27.776699,0,0
PDIK1L,Pdik1l,-14,-7,-21,4.660194,0,0
PDILT,Pdilt,15,-6,9,0,0,0
PDK1,Pdk1,-5,0,-5,11.902913,0,0
PDK2,Pdk2,3,-8,-5,2.961165,0,0
PDK3,Pdk3,6,-2,4,3.582524,0,0
PDK4,Pdk4,7,12,19,0.951456,0,0
PDLIM1,Pdlim1,5,-5,0,2.563107,0,0
PDLIM2,Pdlim2,6,2,8,0,0,0
PDLIM3,Pdlim3,4,4,8,1.84466,0,0
PDLIM4,Pdlim4,7,5,12,7.485437,0,0
PDLIM5,Pdlim5,17,-1,16,5,0,0
PDLIM7,Pdlim7,5,-5,0,1.126214,0,0
PDP1,Pdp1,8,-9,-1,6.669903,0,0
PDP2,Pdp2,4,-1,3,2.23301,0,0
PDPK1,Pdpk1,8,-5,3,6.495146,0,0
PDPN,Pdpn,5,2,7,0,0,0
PDPR,Pdpr,7,-7,0,8.262136,0,0
PDRG1,Pdrg1,7,1,8,8.07767,0,0
PDS5A,Pds5a,6,-2,4,3.902913,0,0
PDS5B,Pds5b,3,-4,-1,2.990291,0,0
PDSS1,Pdss1,4,-3,1,6.92233,0,0
PDSS2,Pdss2,4,-5,-1,2.621359,0,0
PDX1,Pdx1,0,1,1,0,0,0
PDXDC1,Pdxdc1,9,-2,7,14.262136,4.083333,0
PDXK,Pdxk,7,-2,5,2.087379,0,0
PDXP,Pdxp,2,-2,0,3.737864,0,0
PDYN,Pdyn,7,4,11,0,0,0
PDZD11,Pdzd11,-1,0,-1,4.145631,0,0
PDZD2,Pdzd2,6,-1,5,0.951456,0,0
PDZD4,Pdzd4,13,-7,6,0,0,0
PDZD7,Pdzd7,12,-4,8,0.825243,0,0
PDZD8,Pdzd8,3,-1,2,0,0,0
PDZD9,Pdzd9,8,-6,2,0,0,0
PDZK1,Pdzk1,37,-1,36,55.067961,0,0
PDZK1IP1,Pdzk1ip1,5,-6,-1,0,0,0
PDZRN3,Pdzrn3,10,4,14,8.330097,0,0
PDZRN4,Pdzrn4,1,-3,-2,0,0,0
PEAK1,Peak1,3,-5,-2,2.368932,0,0
PEAR1,Pear1,-1,-4,-5,0,0,0
PEBP1,Pebp1,5,-5,0,6.407767,0,0
PEBP4,Pebp4,10,-4,6,0,0,0
PECAM1,Pecam1,1,6,7,1.475728,0,0
PECR,Pecr,2,-3,-1,4.165049,0,312
PEF1,Pef1,8,-4,4,24.368932,0,0
PEG10,Peg10,14,5,19,1.747573,0,0
PEG3,Peg3,6,2,8,0,0,0
PELI1,Peli1,8,-1,7,6.067961,0,0
PELI2,Peli2,15,-2,13,1.728155,0,0
PELI3,Peli3,-2,2,0,1.009709,0,0
PELO,Pelo,2,-6,-4,0,0,0
PELP1,Pelp1,-1,-5,-6,6.601942,0,0
PEMT,Pemt,4,-5,-1,11.466019,0,0
PENK,Penk,-1,-6,-7,3.864078,0,0
PEPD,Pepd,6,-3,3,2.815534,0,0
PER1,Per1,3,4,7,0,0,0
PER2,Per2,-4,5,1,7.640777,0,0
PER3,Per3,4,-4,0,4.61165,0,0
PERCC1,Percc1,7,5,12,0,0,0
PERM1,Perm1,17,-5,12,10.116505,0,0
PERP,Perp,2,2,4,8.456311,0,0
PES1,Pes1,4,-2,2,60.456311,0,0
PET100,Pet100,-6,-5,-11,0,0,0
PET117,Pet117,-15,-17,-32,15.126214,0,0
PEX1,Pex1,5,-5,0,8.592233,0,0
PEX10,Pex10,7,-5,2,7.116505,0,0
PEX11A,Pex11a,-2,-1,-3,21.640777,0,0
PEX11B,Pex11b,-10,-3,-13,5.23301,0,0
PEX11G,Pex11g,-3,-10,-13,12.786408,0,0
PEX12,Pex12,3,1,4,1.398058,0,0
PEX13,Pex13,2,-3,-1,4.902913,0,0
PEX14,Pex14,-8,-2,-10,59.174757,14.625,0
PEX16,Pex16,1,-3,-2,11.436893,0,0
PEX19,Pex19,7,-6,1,0,0,0
PEX2,Pex2,9,-4,5,10.213592,0,0
PEX26,Pex26,5,-2,3,0.728155,0,0
PEX3,Pex3,-5,0,-5,46.194175,0,0
PEX5,Pex5,8,-7,1,11.165049,0,0
PEX5L,Pex5l,2,-4,-2,3.543689,0,0
PEX6,Pex6,11,-1,10,8.126214,0,0
PEX7,Pex7,2,-5,-3,6.359223,0,0
PF4,Pf4,2,-14,-12,0,0,0
PFAS,Pfas,2,-5,-3,7.067961,0,0
PFDN1,Pfdn1,5,-4,1,0,0,0
PFDN2,Pfdn2,12,-3,9,5.300971,0,0
PFDN4,Pfdn4,4,-7,-3,11.145631,0,0
PFDN5,Pfdn5,3,-2,1,54.213592,0,0
PFDN6,Pfdn6,8,4,12,4.84466,0,0
PFKFB1,Pfkfb1,-7,-24,-31,0,0,0
PFKFB2,Pfkfb2,-6,-11,-17,17.951456,0,0
PFKFB3,Pfkfb3,11,0,11,4.932039,0,0
PFKFB4,Pfkfb4,8,-2,6,1.165049,0,0
PFKL,Pfkl,0,-1,-1,9.203883,0,0
PFKM,Pfkm,9,-10,-1,82.718447,0,0
PFKP,Pfkp,6,-5,1,3.398058,0,0
PFN1,Pfn1,12,-3,9,2.592233,0,0
PFN2,Pfn2,4,-1,3,16.592233,0,0
PFN3,Pfn3,-2,-2,-4,2.466019,0,0
PFN4,Pfn4,7,-5,2,11.019417,0,0
PGA5,Pga5,7,3,10,2.533981,0,0
PGAM1,Pgam1,9,1,10,20.84466,0,0
PGAM2,Pgam2,18,-10,8,0,0,0
PGAM5,Pgam5,0,0,0,404.601942,195.791667,103
PGAP1,Pgap1,8,0,8,2.912621,0,0
PGAP2,Pgap2,6,-7,-1,4.776699,0,0
PGAP3,Pgap3,0,-1,-1,2.893204,0,0
PGAP4,Pgap4,2,-4,-2,0,0,0
PGAP6,Pgap6,11,-3,8,19.427184,0,0
PGBD1,Pgbd1,3,-2,1,8.592233,0,0
PGBD5,Pgbd5,6,4,10,2.368932,0,0
PGC,Pgc,-1,-2,-3,0,0,0
PGD,Pgd,11,1,12,37.601942,0,0
PGF,Pgf,141,5,146,40.747573,0,0
PGGHG,Pgghg,6,3,9,62.048544,4.791667,0
PGGT1B,Pggt1b,-3,-5,-8,4.592233,0,0
PGK1,Pgk1,6,-4,2,246.92233,159.916667,0
PGK2,Pgk2,-1,1,0,0,0,0
PGLS,Pgls,4,-5,-1,9.038835,0,0
PGLYRP1,Pglyrp1,4,1,5,0,0,0
PGLYRP2,Pglyrp2,1,-4,-3,0,0,0
PGLYRP3,Pglyrp3,-3,0,-3,0,0,0
PGLYRP4,Pglyrp4,0,-5,-5,0,0,0
PGM1,Pgm1,13,-4,9,2.563107,0,0
PGM2,Pgm2,-4,-4,-8,4.097087,0,0
PGM2L1,Pgm2l1,1,1,2,5.407767,0,0
PGM3,Pgm3,10,1,11,8.650485,0,0
PGM5,Pgm5,0,3,3,2.873786,0,0
PGP,Pgp,0,-5,-5,0.912621,0,0
PGPEP1,Pgpep1,3,1,4,2.640777,4.125,0
PGPEP1L,Pgpep1l,5,1,6,0,0,0
PGR,Pgr,4,0,4,2.097087,0,0
PGRMC1,Pgrmc1,8,-5,3,2.058252,0,0
PGRMC2,Pgrmc2,7,-3,4,10.242718,0,0
PGS1,Pgs1,2,0,2,17.708738,0,0
PHACTR1,Phactr1,6,0,6,0,0,0
PHACTR2,Phactr2,7,2,9,4.84466,0,0
PHACTR3,Phactr3,3,-8,-5,0,0,0
PHACTR4,Phactr4,5,-6,-1,5.582524,0,0
PHAX,Phax,7,1,8,6.300971,0,0
PHB,Phb,7,-2,5,13.23301,0,0
PHB2,Phb2,7,-3,4,13.456311,0,0
PHC1,Phc1,2,-5,-3,23.679612,0,0
PHC2,Phc2,-13,-2,-15,57.883495,2.458333,0
PHC3,Phc3,11,-6,5,5.194175,0,0
PHETA1,Pheta1,3,-7,-4,4.640777,0,0
PHETA2,Pheta2,-12,-14,-26,0,0,0
PHEX,Phex,3,-11,-8,0,0,0
PHF1,Phf1,3,6,9,3.640777,0,0
PHF10,Phf10,8,-2,6,7.271845,0,0
PHF12,Phf12,8,-1,7,0.864078,0,0
PHF13,Phf13,2,0,2,6.339806,0,0
PHF14,Phf14,7,-7,0,7.805825,0,0
PHF19,Phf19,4,-12,-8,9.679612,0,0
PHF2,Phf2,13,-1,12,0,0,0
PHF20,Phf20,1,-2,-1,34.184466,0,0
PHF20L1,Phf20l1,5,-4,1,17.524272,0,0
PHF21A,Phf21a,5,-11,-6,3.184466,0,0
PHF21B,Phf21b,8,-3,5,0,0,0
PHF23,Phf23,5,-3,2,5.407767,0,0
PHF24,Phf24,9,0,9,0,0,0
PHF3,Phf3,7,-3,4,8.262136,0,0
PHF5A,Phf5a,6,-3,3,8.572816,0,0
PHF6,Phf6,6,-1,5,1.533981,0,0
PHF7,Phf7,-4,-6,-10,5.970874,0,0
PHF8,Phf8,8,-4,4,33.242718,0,0
PHGDH,Phgdh,4,5,9,4.097087,0,0
PHGR1,Phgr1,0,5,5,0,0,0
PHIP,Phip,5,-5,0,10.582524,0,0
PHKA1,Phka1,6,2,8,2.805825,0,0
PHKA2,Phka2,1,-7,-6,7.300971,0,0
PHKB,Phkb,4,-5,-1,9.970874,0,0
PHKG1,Phkg1,42,7,49,0,0,0
PHKG2,Phkg2,6,1,7,1.883495,0,0
PHLDA1,Phlda1,3,42,45,8.728155,0,0
PHLDA2,Phlda2,6,29,35,0,0,0
PHLDA3,Phlda3,10,7,17,2.320388,0,0
PHLDB1,Phldb1,8,1,9,0,0,0
PHLDB2,Phldb2,2,0,2,7.864078,0,0
PHLDB3,Phldb3,3,-2,1,0.951456,0,0
PHLPP1,Phlpp1,10,1,11,4.495146,0,0
PHLPP2,Phlpp2,3,-2,1,0,0,0
PHOSPHO1,Phospho1,11,-2,9,0,0,0
PHOSPHO2,Phospho2,-9,-8,-17,12.990291,0,0
PHOX2A,Phox2a,-2,-4,-6,0,0,0
PHOX2B,Phox2b,8,2,10,0,0,0
PHPT1,Phpt1,12,-3,9,0,0,0
PHRF1,Phrf1,1,-5,-4,0,0,0
PHTF1,Phtf1,6,-2,4,12.718447,0,0
PHTF2,Phtf2,5,-4,1,7.048544,0,0
PHYH,Phyh,5,2,7,35.067961,0,0
PHYHD1,Phyhd1,1,0,1,27.640777,15.083333,0
PHYHIP,Phyhip,1,-11,-10,0,0,0
PHYHIPL,Phyhipl,5,-3,2,0,0,0
PHYKPL,Phykpl,6,-7,-1,5.019417,0,0
PI15,Pi15,-8,-3,-11,0,0,0
PI16,Pi16,5,-5,0,0,0,0
PI4K2A,Pi4k2a,2,-1,1,1.368932,0,0
PI4K2B,Pi4k2b,-2,2,0,0,0,0
PI4KA,Pi4ka,5,-6,-1,8.669903,0,0
PI4KB,Pi4kb,11,-1,10,9.31068,0,0
PIANP,Pianp,12,-5,7,1.941748,0,0
PIAS1,Pias1,8,-4,4,1.184466,0,0
PIAS2,Pias2,6,-8,-2,25.951456,0,0
PIAS3,Pias3,2,-7,-5,6.601942,0,0
PIAS4,Pias4,2,-3,-1,4.38835,0,0
PIBF1,Pibf1,4,-5,-1,3.029126,0,0
PICALM,Picalm,8,-1,7,4.087379,0,0
PICK1,Pick1,-4,-6,-10,10.757282,0,0
PID1,Pid1,5,-1,4,1.932039,0,0
PIDD1,Pidd1,-2,-6,-8,2.582524,0,0
PIEZO1,Piezo1,-3,1,-2,3.174757,0,0
PIEZO2,Piezo2,4,-5,-1,0,0,0
PIF1,Pif1,-26,-17,-43,0,0,0
PIFO,Pifo,8,-9,-1,0,0,0
PIGA,Piga,-4,-6,-10,5.106796,0,0
PIGB,Pigb,4,-5,-1,3.126214,0,0
PIGBOS1,Pigbos1,-10,-13,-23,3.126214,0,0
PIGC,Pigc,4,0,4,20.543689,0,0
PIGF,Pigf,2,-6,-4,31.126214,0,0
PIGG,Pigg,6,-8,-2,10.019417,0,0
PIGH,Pigh,3,-6,-3,12.533981,4.916667,0
PIGK,Pigk,5,-2,3,3.932039,0,0
PIGL,Pigl,9,0,9,7.553398,0,0
PIGM,Pigm,3,-5,-2,4.961165,0,0
PIGN,Pign,10,-8,2,3.572816,0,0
PIGO,Pigo,0,-1,-1,5.417476,0,0
PIGP,Pigp,-4,5,1,9.728155,0,0
PIGQ,Pigq,8,-6,2,38.475728,0,0
PIGR,Pigr,0,-1,-1,0,0,0
PIGS,Pigs,8,-3,5,1.475728,0,0
PIGT,Pigt,7,-2,5,0,0,0
PIGU,Pigu,5,-3,2,10.087379,4.208333,0
PIGV,Pigv,2,-3,-1,7.048544,0,0
PIGW,Pigw,-1,-10,-11,2.631068,0,0
PIGX,Pigx,5,-4,1,43.621359,0,0
PIGZ,Pigz,7,9,16,3.019417,0,0
PIH1D1,Pih1d1,0,-5,-5,0,0,0
PIH1D2,Pih1d2,6,-4,2,6.650485,0,0
PIK3AP1,Pik3ap1,4,1,5,0,0,0
PIK3C2A,Pik3c2a,-1,-2,-3,2.339806,0,0
PIK3C2B,Pik3c2b,5,-7,-2,12.854369,0,0
PIK3C2G,Pik3c2g,1,0,1,2.466019,0,0
PIK3C3,Pik3c3,6,-5,1,0,0,0
PIK3CA,Pik3ca,7,-1,6,10.466019,0,0
PIK3CB,Pik3cb,10,-7,3,25.990291,0,0
PIK3CD,Pik3cd,4,-15,-11,32.572816,0,0
PIK3CG,Pik3cg,5,-3,2,0,0,0
PIK3IP1,Pik3ip1,-5,-1,-6,0,0,0
PIK3R1,Pik3r1,2,-1,1,9.242718,0,0
PIK3R2,Pik3r2,-3,-7,-10,4.067961,0,0
PIK3R3,Pik3r3,9,-10,-1,8.854369,0,0
PIK3R4,Pik3r4,7,-1,6,0,0,0
PIK3R5,Pik3r5,2,-5,-3,26.368932,0,0
PIK3R6,Pik3r6,-1,-8,-9,0,0,0
PIKFYVE,Pikfyve,5,-1,4,5.15534,0,0
PILRA,Pilra,38,-5,33,0,0,0
PIM1,Pim1,4,-6,-2,3.203883,0,0
PIM2,Pim2,-3,-2,-5,3.815534,0,0
PIM3,Pim3,8,-1,7,1.252427,0,0
PIMREG,Pimreg,-2,-19,-21,3.23301,0,0
PIN1,Pin1,7,-6,1,84.757282,0,0
PIN4,Pin4,-2,-6,-8,0,0,0
PINK1,Pink1,6,-2,4,5.932039,0,0
PINLYP,Pinlyp,-9,-15,-24,5.349515,0,0
PINX1,Pinx1,-1,-4,-5,5.854369,0,0
PIP,Pip,1,1,2,0,0,0
PIP4K2A,Pip4k2a,2,4,6,2.553398,0,0
PIP4K2B,Pip4k2b,13,-3,10,4.92233,0,0
PIP4K2C,Pip4k2c,7,-2,5,6.15534,0,0
PIP4P1,Pip4p1,-8,-1,-9,7.145631,0,0
PIP4P2,Pip4p2,-5,3,-2,16.84466,0,0
PIP5K1A,Pip5k1a,6,-1,5,0,0,0
PIP5K1B,Pip5k1b,5,4,9,0,0,0
PIP5K1C,Pip5k1c,8,-2,6,0,0,0
PIP5KL1,Pip5kl1,31,11,42,1.572816,0,0
PIPOX,Pipox,-2,11,9,0,0,0
PIR,Pir,2,-3,-1,8.242718,0,0
PIRT,Pirt,-1,0,-1,7.912621,0,0
PISD,Pisd,4,-4,0,4.893204,0,0
PITHD1,Pithd1,4,-6,-2,8.650485,0,0
PITPNA,Pitpna,6,-2,4,15.524272,0,0
PITPNB,Pitpnb,5,-5,0,44.951456,0,0
PITPNC1,Pitpnc1,14,3,17,17.883495,0,0
PITPNM1,Pitpnm1,6,-6,0,59.145631,0,0
PITPNM2,Pitpnm2,1,-2,-1,0.776699,0,0
PITPNM3,Pitpnm3,-5,-11,-16,0,0,0
PITRM1,Pitrm1,1,5,6,1.601942,0,0
PITX1,Pitx1,4,0,4,7.582524,0,0
PITX2,Pitx2,24,-3,21,2.640777,0,0
PITX3,Pitx3,1,0,1,0.834951,0,0
PIWIL1,Piwil1,3,-7,-4,0,0,0
PIWIL2,Piwil2,2,2,4,0,0,0
PIWIL4,Piwil4,2,-2,0,0.990291,0,0
PJA1,Pja1,7,0,7,1.61165,0,0
PJA2,Pja2,8,-6,2,4.378641,0,0
PJVK,Pjvk,9,-20,-11,3.718447,0,0
PKD1,Pkd1,11,-3,8,4.242718,0,0
PKD1L1,Pkd1l1,1,1,2,0,0,0
PKD1L2,Pkd1l2,-1,-3,-4,0,0,0
PKD1L3,Pkd1l3,7,-5,2,0,0,0
PKD2,Pkd2,4,-2,2,4.038835,0,0
PKD2L1,Pkd2l1,13,-3,10,0,0,0
PKD2L2,Pkd2l2,6,-12,-6,1.533981,0,0
PKDCC,Pkdcc,8,0,8,1.252427,0,0
PKDREJ,Pkdrej,3,-9,-6,1.737864,0,0
PKHD1,Pkhd1,-2,1,-1,0,0,0
PKHD1L1,Pkhd1l1,1,-4,-3,7.592233,0,0
PKIA,Pkia,8,-1,7,19.932039,0,0
PKIB,Pkib,5,-2,3,11.825243,0,0
PKIG,Pkig,5,2,7,65.029126,0,0
PKLR,Pklr,-3,-1,-4,0,0,0
PKM,Pkm,10,1,11,9.31068,0,0
PKMYT1,Pkmyt1,0,-7,-7,2.970874,0,0
PKN1,Pkn1,10,-3,7,1.262136,0,0
PKN2,Pkn2,9,-4,5,13.029126,0,0
PKN3,Pkn3,-1,4,3,13.368932,0,0
PKNOX1,Pknox1,7,2,9,177.902913,72.5,0
PKNOX2,Pknox2,2,-5,-3,0,0,0
PKP1,Pkp1,4,-7,-3,20.961165,7.958333,0
PKP2,Pkp2,6,2,8,5.223301,0,0
PKP3,Pkp3,0,1,1,0,0,0
PKP4,Pkp4,5,-4,1,11.398058,0,0
PLA1A,Pla1a,6,0,6,8.543689,0,0
PLA2G10,Pla2g10,31,-13,18,0,0,0
PLA2G12A,Pla2g12a,5,-11,-6,3.097087,0,0
PLA2G12B,Pla2g12b,62,13,75,0,0,0
PLA2G15,Pla2g15,5,-3,2,1.300971,0,0
PLA2G1B,Pla2g1b,3,-3,0,0,0,0
PLA2G2A,Pla2g2a,8,1,9,0,0,0
PLA2G2C,Pla2g2c,0,-7,-7,1.834951,0,0
PLA2G2D,Pla2g2d,3,1,4,0,0,0
PLA2G2E,Pla2g2e,1,9,10,0,0,0
PLA2G2F,Pla2g2f,2,2,4,0,0,0
PLA2G3,Pla2g3,-3,-1,-4,0,0,0
PLA2G4A,Pla2g4a,2,-8,-6,0,0,0
PLA2G4B,Pla2g4b,2,8,10,0,0,0
PLA2G4C,Pla2g4c,15,21,36,0,0,0
PLA2G4D,Pla2g4d,1,-1,0,0,0,0
PLA2G4E,Pla2g4e,-3,-1,-4,0,0,0
PLA2G4F,Pla2g4f,7,0,7,0,0,0
PLA2G5,Pla2g5,-4,4,0,0,0,0
PLA2G6,Pla2g6,11,-2,9,6.029126,0,0
PLA2G7,Pla2g7,7,-10,-3,0.902913,0,0
PLA2R1,Pla2r1,-1,5,4,0,0,0
PLAA,Plaa,2,-5,-3,3.932039,0,0
PLAAT1,Plaat1,2,-4,-2,8.456311,0,0
PLAAT3,Plaat3,12,0,12,0,0,0
PLAAT5,Plaat5,1,0,1,0,0,0
PLAC1,Plac1,-6,-6,-12,66.126214,0,0
PLAC8,Plac8,1,-6,-5,2.048544,0,0
PLAC8L1,Plac8l1,55,-11,44,0,0,0
PLAC9,Plac9a,6,-4,2,3.203883,0,0
PLAG1,Plag1,9,4,13,2.38835,0,0
PLAGL1,Plagl1,4,3,7,33.475728,8.291667,0
PLAGL2,Plagl2,-1,-9,-10,21.349515,0,0
PLAT,Plat,-3,10,7,0,0,0
PLAU,Plau,-23,2,-21,21.378641,7.5,0
PLAUR,Plaur,2,3,5,6.728155,0,0
PLB1,Plb1,4,-7,-3,0,0,0
PLBD1,Plbd1,-2,-13,-15,0,0,0
PLBD2,Plbd2,7,-5,2,1.932039,0,0
PLCB1,Plcb1,8,1,9,4.038835,0,0
PLCB2,Plcb2,-10,-3,-13,1.398058,0,0
PLCB3,Plcb3,10,-3,7,7.796117,0,0
PLCB4,Plcb4,-1,-1,-2,4.223301,0,0
PLCD1,Plcd1,18,-3,15,14.543689,0,0
PLCD3,Plcd3,5,2,7,0,0,0
PLCD4,Plcd4,31,-4,27,11.106796,0,0
PLCE1,Plce1,5,-1,4,13.718447,0,0
PLCG1,Plcg1,10,-5,5,3.650485,0,0
PLCG2,Plcg2,20,0,20,0,0,0
PLCH1,Plch1,4,0,4,43.252427,0,0
PLCH2,Plch2,8,4,12,6.747573,0,0
PLCL1,Plcl1,4,4,8,0.970874,0,0
PLCL2,Plcl2,6,2,8,0,0,0
PLCXD1,Plcxd1,-1,-7,-8,0,0,0
PLCXD2,Plcxd2,6,2,8,6.194175,0,0
PLCXD3,Plcxd3,1,-1,0,2.485437,0,0
PLCZ1,Plcz1,13,2,15,0,0,0
PLD1,Pld1,-12,-2,-14,8.165049,0,0
PLD2,Pld2,-4,-7,-11,1.378641,0,0
PLD3,Pld3,13,-1,12,6.23301,0,0
PLD4,Pld4,1,1,2,0,0,0
PLD5,Pld5,0,-1,-1,0,0,0
PLD6,Pld6,-1,-5,-6,1.106796,0,0
PLEC,Plec,-2,-1,-3,29.058252,0,0
PLEK,Plek,-4,-4,-8,0,0,0
PLEK2,Plek2,5,-1,4,4.834951,0,0
PLEKHA1,Plekha1,3,-4,-1,13.805825,0,0
PLEKHA2,Plekha2,2,3,5,1.135922,0,0
PLEKHA3,Plekha3,9,-5,4,3.834951,0,0
PLEKHA4,Plekha4,5,-5,0,22.15534,0,0
PLEKHA5,Plekha5,4,4,8,3.640777,0,0
PLEKHA6,Plekha6,6,3,9,97.145631,0,0
PLEKHA7,Plekha7,-5,6,1,0.951456,0,0
PLEKHA8,Plekha8,7,-5,2,16.048544,0,0
PLEKHB1,Plekhb1,17,1,18,0,0,0
PLEKHB2,Plekhb2,6,-5,1,0,0,0
PLEKHD1,Plekhd1,2,-6,-4,0,0,0
PLEKHF1,Plekhf1,-10,7,-3,0,0,0
PLEKHF2,Plekhf2,6,-3,3,12.747573,0,0
PLEKHG1,Plekhg1,3,9,12,120.184466,0,0
PLEKHG2,Plekhg2,5,-2,3,23.368932,0,0
PLEKHG3,Plekhg3,-3,0,-3,10.912621,0,0
PLEKHG4,Plekhg4,-13,4,-9,11.873786,0,0
PLEKHG5,Plekhg5,5,6,11,7.446602,0,0
PLEKHG6,Plekhg6,1,-6,-5,0,0,0
PLEKHH1,Plekhh1,5,-6,-1,2.203883,0,0
PLEKHH2,Plekhh2,-1,-8,-9,13.339806,0,0
PLEKHH3,Plekhh3,4,2,6,1.902913,0,0
PLEKHJ1,Plekhj1,-6,-1,-7,6.242718,0,0
PLEKHM1,Plekhm1,9,-6,3,0,0,0
PLEKHM2,Plekhm2,11,-3,8,0,0,0
PLEKHM3,Plekhm3,9,-11,-2,23.563107,0,0
PLEKHN1,Plekhn1,2,-8,-6,1.621359,0,0
PLEKHO1,Plekho1,9,-2,7,7.912621,0,0
PLEKHO2,Plekho2,9,-1,8,0.92233,0,0
PLEKHS1,Plekhs1,7,0,7,0,0,0
PLET1,Plet1,1,7,8,0,0,0
PLG,Plg,4,-2,2,0,0,0
PLGRKT,Plgrkt,-6,-1,-7,0,0,0
PLIN1,Plin1,12,0,12,0,0,0
PLIN2,Plin2,0,7,7,2.563107,0,0
PLIN3,Plin3,7,-1,6,1.31068,0,0
PLIN4,Plin4,2,-3,-1,2.398058,0,0
PLIN5,Plin5,5,2,7,2.883495,0,0
PLK1,Plk1,-9,-17,-26,4.067961,0,0
PLK2,Plk2,0,4,4,7.407767,0,0
PLK3,Plk3,-3,6,3,4.572816,0,0
PLK4,Plk4,-17,1,-16,4.757282,0,0
PLK5,Plk5,6,-4,2,6.087379,0,0
PLLP,Pllp,6,-8,-2,0,0,0
PLN,Pln,-2,-16,-18,0,0,0
PLOD1,Plod1,17,2,19,107.92233,48.041667,0
PLOD2,Plod2,5,0,5,24.621359,0,0
PLOD3,Plod3,15,-4,11,52.834951,6.166667,0
PLP1,Plp1,3,-4,-1,0,0,0
PLP2,Plp2,-4,-5,-9,2.941748,0,0
PLPBP,Plpbp,9,2,11,1.184466,0,0
PLPP1,Plpp1,2,-6,-4,2.961165,0,0
PLPP2,Plpp2,5,-3,2,0,0,0
PLPP3,Plpp3,14,2,16,1.436893,0,0
PLPP4,Plpp4,1,-9,-8,0,0,0
PLPP5,Plpp5,3,-1,2,2.504854,0,0
PLPP6,Plpp6,-18,-2,-20,5.456311,0,0
PLPP7,Plpp7,6,2,8,0,0,0
PLPPR1,Plppr1,2,0,2,0,0,0
PLPPR2,Plppr2,0,-9,-9,5.951456,0,0
PLPPR3,Plppr3,-2,-9,-11,0,0,0
PLPPR4,Plppr4,0,-1,-1,0,0,0
PLPPR5,Plppr5,57,0,57,42.932039,0,0
PLRG1,Plrg1,6,-1,5,1.330097,0,0
PLS1,Pls1,6,-3,3,15.640777,0,0
PLS3,Pls3,11,-1,10,0,0,0
PLSCR1,Plscr1,2,5,7,5.640777,0,0
PLSCR2,Plscr2,16,6,22,0.951456,0,0
PLSCR3,Plscr3,3,-4,-1,3.23301,0,0
PLSCR4,Plscr4,10,1,11,2.038835,0,0
PLSCR5,Plscr5,2,0,2,0,0,0
PLTP,Pltp,6,-2,4,0,0,0
PLVAP,Plvap,36,0,36,0,0,0
PLXDC1,Plxdc1,14,-7,7,23.466019,0,0
PLXDC2,Plxdc2,0,4,4,6.320388,26,0
PLXNA1,Plxna1,8,0,8,0,0,0
PLXNA2,Plxna2,7,-4,3,2.436893,0,0
PLXNA3,Plxna3,4,3,7,1.203883,0,0
PLXNA4,Plxna4,-3,0,-3,0,0,0
PLXNB1,Plxnb1,9,2,11,31.718447,0,0
PLXNB2,Plxnb2,6,-4,2,10,0,0
PLXNB3,Plxnb3,0,5,5,0,0,0
PLXNC1,Plxnc1,14,-2,12,0,0,0
PLXND1,Plxnd1,-1,-2,-3,0,0,0
PM20D1,Pm20d1,3,-5,-2,0,0,0
PM20D2,Pm20d2,-1,-1,-2,4.417476,0,0
PMAIP1,Pmaip1,15,24,39,9.563107,0,0
PMCH,Pmch,2,-9,-7,0,0,0
PMEL,Pmel,-2,-7,-9,1.747573,0,0
PMEPA1,Pmepa1,23,0,23,13.980583,0,0
PMF1,Pmf1,8,-2,6,19.883495,30.375,0
PMFBP1,Pmfbp1,1,3,4,0,0,0
PMIS2,Pmis2,7,-13,-6,0,0,0
PML,Pml,5,-6,-1,15.330097,0,0
PMM1,Pmm1,4,-4,0,0,0,0
PMM2,Pmm2,-5,-1,-6,22.864078,0,0
PMP2,Pmp2,2,5,7,0,0,0
PMP22,Pmp22,5,3,8,15.456311,0,0
PMPCA,Pmpca,2,-2,0,1.349515,0,0
PMPCB,Pmpcb,7,-4,3,6.84466,0,0
PMS1,Pms1,4,-12,-8,4.718447,0,0
PMS2,Pms2,6,-8,-2,10.252427,0,0
PMVK,Pmvk,27,-2,25,114.126214,5.541667,0
PNCK,Pnck,64,3,67,7.38835,0,0
PNISR,Pnisr,9,-4,5,0,0,0
PNKD,Pnkd,5,-5,0,15.456311,0,0
PNKP,Pnkp,9,1,10,14.941748,0,107
PNLDC1,Pnldc1,175,8,183,0,0,0
PNLIP,Pnlip,0,0,0,0,0,0
PNLIPRP1,Pnliprp1,-3,8,5,0,0,0
PNLIPRP2,Pnliprp2,-1,0,-1,0,0,0
PNMA1,Pnma1,10,-7,3,56.708738,0,0
PNMA2,Pnma2,4,3,7,2.932039,0,0
PNMA3,Pnma3,-1,0,-1,0,0,0
PNMA5,Pnma5,3,-3,0,0,0,0
PNMT,Pnmt,12,8,20,0,0,0
PNN,Pnn,5,1,6,24.407767,0,142
PNO1,Pno1,-2,-3,-5,2.213592,0,0
PNOC,Pnoc,-2,-7,-9,0,0,0
PNP,Pnp,8,-3,5,14.883495,0,0
PNPLA1,Pnpla1,9,-1,8,0,0,0
PNPLA2,Pnpla2,4,-2,2,0,0,0
PNPLA3,Pnpla3,-3,-4,-7,0,0,0
PNPLA5,Pnpla5,4,0,4,0,0,0
PNPLA6,Pnpla6,11,-14,-3,23.320388,0,0
PNPLA7,Pnpla7,16,2,18,2.786408,0,0
PNPLA8,Pnpla8,8,1,9,2.84466,0,0
PNPO,Pnpo,0,3,3,7.533981,0,0
PNPT1,Pnpt1,1,-1,0,4.893204,0,0
PNRC1,Pnrc1,9,1,10,9.951456,0,0
PNRC2,Pnrc2,0,-3,-3,6.834951,0,0
POC1A,Poc1a,6,-4,2,5.300971,0,0
POC1B,Poc1b,4,-1,3,0,0,0
POC5,Poc5,-7,-4,-11,1.165049,0,0
PODN,Podn,4,0,4,0,0,0
PODNL1,Podnl1,8,-3,5,20.38835,0,0
PODXL,Podxl,4,0,4,2.572816,0,0
PODXL2,Podxl2,6,0,6,9.864078,0,0
POF1B,Pof1b,-1,0,-1,0,0,0
POFUT1,Pofut1,2,-6,-4,21.349515,0,0
POFUT2,Pofut2,3,-2,1,85.262136,0,0
POGK,Pogk,-5,-6,-11,8.15534,0,0
POGLUT1,Poglut1,10,-3,7,0,0,0
POGLUT2,Poglut2,-3,-6,-9,0,0,0
POGLUT3,Poglut3,3,-3,0,3.368932,0,0
POGZ,Pogz,14,-3,11,3.300971,0,0
POLA1,Pola1,2,0,2,3.873786,0,0
POLA2,Pola2,-16,-3,-19,5.223301,0,0
POLB,Polb,5,-6,-1,1.31068,0,0
POLD1,Pold1,3,-2,1,24.495146,0,0
POLD2,Pold2,4,0,4,26.524272,0,0
POLD3,Pold3,-6,-8,-14,34.417476,0,0
POLD4,Pold4,5,-1,4,26.07767,0,0
POLDIP2,Poldip2,8,-3,5,8.087379,0,0
POLDIP3,Poldip3,10,-3,7,2.359223,0,0
POLE,Pole,7,-10,-3,9.291262,0,0
POLE2,Pole2,-6,-6,-12,6.757282,0,0
POLE3,Pole3,3,-5,-2,79.669903,9.541667,0
POLE4,Pole4,4,-4,0,9.009709,0,0
POLG,Polg,6,-6,0,38.029126,0,0
POLG2,Polg2,17,-2,15,5.718447,0,0
POLH,Polh,-2,-2,-4,8.203883,0,0
POLI,Poli,-7,0,-7,32.097087,0,0
POLK,Polk,5,-1,4,4.456311,0,0
POLL,Poll,1,-7,-6,30.941748,0,0
POLM,Polm,-4,1,-3,8.941748,0,0
POLN,Poln,-1,-4,-5,2.893204,0,0
POLQ,Polq,3,-2,1,21.990291,0,0
POLR1A,Polr1a,6,-2,4,0,0,0
POLR1B,Polr1b,4,-3,1,5.427184,0,0
POLR1C,Polr1c,1,-5,-4,13.679612,0,0
POLR1D,Polr1d,2,-1,1,0.970874,0,0
POLR1E,Polr1e,1,-4,-3,2.213592,0,0
POLR1F,Polr1f,2,-2,0,16.009709,0,0
POLR1G,Polr1h,1,0,1,20.563107,0,0
POLR1H,Polr1has,-2,-11,-13,8.699029,0,0
POLR2A,Polr2a,-3,-4,-7,11.650485,0,0
POLR2B,Polr2b,8,-6,2,0,0,0
POLR2C,Polr2c,5,-2,3,12,0,0
POLR2D,Polr2d,3,-6,-3,12.941748,0,0
POLR2E,Polr2e,5,-2,3,0.747573,0,0
POLR2F,Polr2f,6,-8,-2,1.135922,0,0
POLR2G,Polr2g,5,-6,-1,0,0,0
POLR2H,Polr2h,3,-1,2,5.087379,0,0
POLR2I,Polr2i,2,-4,-2,15.165049,0,0
POLR2J,Polr2j,7,-5,2,16.747573,0,0
POLR2K,Polr2k,1,-5,-4,6.747573,0,0
POLR2L,Polr2l,2,-1,1,2.592233,0,0
POLR2M,Polr2m,6,5,11,8.553398,0,0
POLR3A,Polr3a,7,-2,5,13.252427,0,0
POLR3B,Polr3b,1,-2,-1,23.815534,0,0
POLR3C,Polr3c,2,-4,-2,8.660194,0,0
POLR3D,Polr3d,3,-5,-2,2.932039,0,0
POLR3E,Polr3e,5,-1,4,67.378641,0,97
POLR3F,Polr3f,-4,-6,-10,11.737864,0,0
POLR3G,Polr3g,0,-3,-3,15.38835,0,0
POLR3GL,Polr3gl,2,-2,0,0,0,0
POLR3H,Polr3h,0,-4,-4,12.31068,0,0
POLR3K,Polr3k,0,-7,-7,0,0,0
POLRMT,Polrmt,3,-7,-4,36.621359,0,0
POM121,Pom121,6,-2,4,2.048544,0,0
POM121L12,Pom121l12,0,-6,-6,0,0,0
POM121L2,Pom121l2,4,-14,-10,1.990291,0,0
POMC,Pomc,2,-3,-1,0,0,0
POMGNT1,Pomgnt1,6,-9,-3,3.92233,0,0
POMGNT2,Pomgnt2,1,0,1,9.815534,0,0
POMK,Pomk,9,-3,6,0.834951,0,0
POMP,Pomp,7,1,8,2.563107,0,0
POMT1,Pomt1,10,-1,9,5.407767,0,0
POMT2,Pomt2,11,-3,8,53.650485,4.916667,0
PON1,Pon1,1,0,1,0,0,0
PON2,Pon2,1,-8,-7,9.873786,0,0
PON3,Pon3,11,0,11,0,0,0
POP1,Pop1,-2,-6,-8,8.262136,0,0
POP4,Pop4,2,-4,-2,0,0,0
POP5,Pop5,4,2,6,4.242718,0,0
POP7,Pop7,1,-4,-3,5.92233,0,0
POPDC2,Popdc2,7,2,9,0,0,0
POPDC3,Popdc3,5,-14,-9,4.61165,0,0
POR,Por,10,2,12,19.601942,0,0
PORCN,Porcn,8,-11,-3,1.84466,0,0
POSTN,Postn,-4,0,-4,0,0,0
POTEG,Poteg,1,-8,-7,0,0,0
POU1F1,Pou1f1,7,-10,-3,0,0,0
POU2AF1,Pou2af1,6,0,6,0,0,0
POU2F1,Pou2f1,5,-6,-1,6.466019,0,0
POU2F2,Pou2f2,56,-9,47,0,0,0
POU2F3,Pou2f3,1,-3,-2,0,0,0
POU3F1,Pou3f1,23,-2,21,0,0,0
POU3F2,Pou3f2,14,1,15,0.815534,0,0
POU3F3,Pou3f3,6,-1,5,0,0,0
POU3F4,Pou3f4,2,1,3,0,0,0
POU4F1,Pou4f1,1,-4,-3,0,0,0
POU4F2,Pou4f2,1,-4,-3,0,0,0
POU4F3,Pou4f3,15,-3,12,0,0,0
POU5F1,Pou5f1,6,1,7,1.252427,0,0
POU5F2,Pou5f2,3,-10,-7,0,0,0
POU6F1,Pou6f1,7,-13,-6,0,0,0
POU6F2,Pou6f2,0,-3,-3,0,0,0
PP2D1,Pp2d1,4,-7,-3,0,0,0
PPA1,Ppa1,4,-6,-2,10.398058,0,0
PPA2,Ppa2,5,-6,-1,29.825243,0,0
PPAN,Ppan,-6,-2,-8,111.68932,0,0
PPARA,Ppara,2,6,8,1.15534,0,0
PPARD,Ppard,1,-2,-1,5.31068,0,0
PPARG,Pparg,3,-15,-12,4.495146,0,0
PPARGC1A,Ppargc1a,10,11,21,1.398058,0,0
PPARGC1B,Ppargc1b,-16,-1,-17,4.912621,0,0
PPAT,Ppat,8,-2,6,7.650485,0,0
PPBP,Ppbp,2,-13,-11,0,0,0
PPCDC,Ppcdc,0,-7,-7,0,0,0
PPCS,Ppcs,-4,-1,-5,2.796117,0,0
PPDPF,Ppdpf,3,-7,-4,2.563107,0,0
PPEF1,Ppef1,5,4,9,30.873786,0,0
PPEF2,Ppef2,1,2,3,8.825243,0,0
PPFIA1,Ppfia1,11,-1,10,0,0,0
PPFIA2,Ppfia2,-2,-9,-11,0,0,0
PPFIA3,Ppfia3,11,-2,9,0,0,0
PPFIA4,Ppfia4,-10,1,-9,0,0,0
PPFIBP1,Ppfibp1,7,-2,5,4.106796,0,0
PPFIBP2,Ppfibp2,0,-2,-2,0.815534,0,0
PPHLN1,Pphln1,1,-9,-8,5.300971,0,0
PPIA,Ppia,6,-5,1,5.320388,0,0
PPIB,Ppib,10,-3,7,11.368932,0,0
PPIC,Ppic,4,-2,2,29.097087,0,0
PPID,Ppid,14,-3,11,190.61165,21.458333,0
PPIE,Ppie,8,-3,5,3.281553,0,0
PPIF,Ppif,4,-2,2,25.873786,10.208333,0
PPIG,Ppig,4,-4,0,0,0,0
PPIH,Ppih,10,-1,9,8.252427,0,0
PPIL1,Ppil1,4,-4,0,5.504854,0,0
PPIL2,Ppil2,3,0,3,2.747573,0,0
PPIL3,Ppil3,2,-6,-4,4.495146,0,0
PPIL4,Ppil4,7,-2,5,14.252427,0,0
PPIL6,Ppil6,2,-6,-4,55.436893,0,0
PPIP5K1,Ppip5k1,6,-2,4,2.815534,0,0
PPIP5K2,Ppip5k2,2,-10,-8,4.970874,0,0
PPL,Ppl,2,-5,-3,0,0,0
PPM1A,Ppm1a,3,-7,-4,6.737864,0,0
PPM1B,Ppm1b,6,-6,0,2.15534,0,0
PPM1D,Ppm1d,7,-9,-2,21.485437,0,0
PPM1E,Ppm1e,4,-4,0,0,0,0
PPM1F,Ppm1f,5,-3,2,2.92233,0,0
PPM1G,Ppm1g,9,-4,5,22.708738,2.916667,0
PPM1H,Ppm1h,3,1,4,10.271845,0,0
PPM1J,Ppm1j,8,-3,5,3.019417,0,0
PPM1K,Ppm1k,11,4,15,4.68932,0,0
PPM1L,Ppm1l,3,-2,1,8.805825,0,0
PPM1M,Ppm1m,7,1,8,5.378641,0,0
PPM1N,Ppm1n,14,4,18,1.213592,0,0
PPME1,Ppme1,7,-2,5,12.485437,0,0
PPOX,Ppox,-4,1,-3,0,0,0
PPP1CA,Ppp1ca,8,1,9,9.475728,0,0
PPP1CB,Ppp1cb,9,0,9,12.669903,0,0
PPP1CC,Ppp1cc,8,1,9,11.669903,0,0
PPP1R10,Ppp1r10,4,-6,-2,0,0,0
PPP1R11,Ppp1r11,6,-3,3,6.912621,0,0
PPP1R12A,Ppp1r12a,10,-1,9,7.15534,0,0
PPP1R12B,Ppp1r12b,3,-2,1,2.242718,0,0
PPP1R12C,Ppp1r12c,5,-2,3,23.737864,0,0
PPP1R13B,Ppp1r13b,3,-6,-3,11.757282,0,0
PPP1R13L,Ppp1r13l,8,-4,4,20.563107,0,0
PPP1R14A,Ppp1r14a,0,-6,-6,0,0,0
PPP1R14B,Ppp1r14b,10,-3,7,3.543689,0,0
PPP1R14C,Ppp1r14c,3,-5,-2,0,0,0
PPP1R14D,Ppp1r14d,6,-16,-10,0,0,0
PPP1R15A,Ppp1r15a,57,11,68,23.339806,0,0
PPP1R15B,Ppp1r15b,7,-1,6,17.048544,0,0
PPP1R16A,Ppp1r16a,4,0,4,58.291262,0,0
PPP1R16B,Ppp1r16b,2,6,8,2.728155,0,0
PPP1R17,Ppp1r17,0,-6,-6,0,0,0
PPP1R18,Ppp1r18,18,-1,17,39.553398,7.375,0
PPP1R1A,Ppp1r1a,7,0,7,0,0,0
PPP1R1B,Ppp1r1b,-3,-5,-8,0,0,0
PPP1R1C,Ppp1r1c,1,1,2,0,0,0
PPP1R2,Ppp1r2,3,-3,0,4.126214,0,0
PPP1R21,Ppp1r21,3,-5,-2,13.553398,0,0
PPP1R26,Ppp1r26,5,-11,-6,6.854369,0,0
PPP1R27,Ppp1r27,42,-8,34,20.631068,0,0
PPP1R32,Ppp1r32,31,1,32,18.68932,0,0
PPP1R35,Ppp1r35,-14,0,-14,3.475728,0,0
PPP1R36,Ppp1r36,15,2,17,3.825243,0,0
PPP1R37,Ppp1r37,8,0,8,46.669903,0,0
PPP1R3A,Ppp1r3a,-1,-1,-2,0,0,0
PPP1R3B,Ppp1r3b,0,1,1,1.291262,0,0
PPP1R3C,Ppp1r3c,53,9,62,5.893204,0,0
PPP1R3D,Ppp1r3d,-16,-2,-18,7.067961,0,0
PPP1R3E,Ppp1r3e,-9,-6,-15,12.165049,0,0
PPP1R3F,Ppp1r3f,7,-2,5,5.883495,0,0
PPP1R3G,Ppp1r3g,1,-2,-1,1.757282,0,0
PPP1R42,Ppp1r42,46,-4,42,3.864078,0,0
PPP1R7,Ppp1r7,11,0,11,0.92233,0,0
PPP1R8,Ppp1r8,-10,-8,-18,17.339806,0,0
PPP1R9A,Ppp1r9a,6,-1,5,2.757282,0,0
PPP1R9B,Ppp1r9b,9,-3,6,4.533981,0,0
PPP2CA,Ppp2ca,6,-1,5,5.048544,0,0
PPP2CB,Ppp2cb,18,-2,16,38.621359,4.583333,0
PPP2R1A,Ppp2r1a,11,-2,9,16.242718,0,0
PPP2R1B,Ppp2r1b,3,-8,-5,9.864078,0,0
PPP2R2A,Ppp2r2a,8,0,8,2.514563,0,0
PPP2R2B,Ppp2r2b,12,5,17,0.864078,0,0
PPP2R2C,Ppp2r2c,-1,1,0,22.68932,0,0
PPP2R2D,Ppp2r2d,6,-4,2,0,0,0
PPP2R3A,Ppp2r3a,2,2,4,2.815534,0,0
PPP2R3C,Ppp2r3c,13,-1,12,5.776699,0,0
PPP2R5A,Ppp2r5a,1,-1,0,10.475728,0,0
PPP2R5B,Ppp2r5b,1,-3,-2,7.514563,0,0
PPP2R5C,Ppp2r5c,6,-2,4,9.436893,0,0
PPP2R5D,Ppp2r5d,12,-6,6,2.621359,0,0
PPP2R5E,Ppp2r5e,7,-5,2,9.126214,0,0
PPP3CA,Ppp3ca,6,0,6,0,0,0
PPP3CB,Ppp3cb,9,-9,0,27.854369,0,0
PPP3CC,Ppp3cc,0,-4,-4,3.184466,0,0
PPP3R1,Ppp3r1,4,0,4,13.893204,0,0
PPP3R2,Ppp3r2,5,-4,1,0,0,0
PPP4C,Ppp4c,15,-6,9,6.660194,0,0
PPP4R1,Ppp4r1,6,-7,-1,3.747573,0,0
PPP4R2,Ppp4r2,10,0,10,3.126214,0,0
PPP4R3A,Ppp4r3a,5,-5,0,11.495146,0,0
PPP4R3B,Ppp4r3b,10,-7,3,20.660194,0,0
PPP4R4,Ppp4r4,-9,0,-9,0,0,0
PPP5C,Ppp5c,7,-3,4,21.31068,0,0
PPP6C,Ppp6c,4,1,5,10.699029,0,0
PPP6R1,Ppp6r1,9,0,9,28.271845,0,0
PPP6R2,Ppp6r2,8,-8,0,0.825243,0,0
PPP6R3,Ppp6r3,8,-1,7,39.76699,0,0
PPRC1,Pprc1,-16,-1,-17,3.514563,0,0
PPT1,Ppt1,6,0,6,6.145631,0,0
PPT2,Ppt2,6,-3,3,12.893204,0,0
PPTC7,Pptc7,3,-2,1,0,0,0
PPWD1,Ppwd1,-1,-5,-6,0,0,0
PPY,Ppy,3,3,6,4.378641,0,0
PQBP1,Pqbp1,4,-1,3,0,0,0
PRADC1,Pradc1,0,-7,-7,161.194175,11.5,181
PRAF2,Praf2,4,0,4,0,0,0
PRAG1,Prag1,11,2,13,1.398058,0,0
PRAM1,Pram1,-1,-7,-8,4.436893,0,0
PRAP1,Prap1,10,0,10,0,0,0
PRB1,Prb1,1,0,1,0,0,0
PRC1,Prc1,5,-1,4,16.669903,0,0
PRCC,Prcc,6,0,6,5.864078,0,0
PRCD,Prcd,4,3,7,2.834951,0,0
PRCP,Prcp,14,-1,13,5.61165,0,0
PRDM1,Prdm1,14,5,19,3.776699,0,0
PRDM10,Prdm10,9,-1,8,65.718447,0,0
PRDM11,Prdm11,-1,-4,-5,21.757282,0,0
PRDM12,Prdm12,3,-8,-5,0,0,0
PRDM13,Prdm13,0,2,2,0,0,0
PRDM14,Prdm14,11,6,17,0,0,0
PRDM15,Prdm15,3,-10,-7,2.582524,0,0
PRDM16,Prdm16,5,-2,3,0,0,0
PRDM2,Prdm2,8,-10,-2,6.106796,0,0
PRDM4,Prdm4,9,-4,5,47.495146,0,0
PRDM5,Prdm5,2,-2,0,2.291262,0,0
PRDM6,Prdm6,19,1,20,0,0,0
PRDM8,Prdm8,-5,-8,-13,6.980583,0,0
PRDM9,Prdm9,-3,-6,-9,1.213592,0,0
PRDX1,Prdx1,7,0,7,64.359223,0,0
PRDX2,Prdx2,1,4,5,9.951456,0,0
PRDX3,Prdx3,6,-6,0,13.805825,0,0
PRDX4,Prdx4,7,-6,1,10.61165,0,0
PRDX5,Prdx5,10,-2,8,103.174757,11.583333,0
PRDX6,Prdx6,8,-5,3,29.582524,5.166667,0
PREB,Preb,0,-5,-5,4.553398,0,0
PRELID1,Prelid1,6,1,7,12.825243,0,0
PRELID2,Prelid2,0,-6,-6,5.398058,0,0
PRELID3A,Prelid3a,-5,-9,-14,11.456311,0,0
PRELID3B,Prelid3b,8,-2,6,12.980583,0,0
PRELP,Prelp,2,6,8,12.320388,0,0
PREP,Prep,2,-3,-1,9.825243,0,0
PREPL,Prepl,8,-7,1,21.893204,0,0
PREX1,Prex1,19,1,20,14.407767,0,0
PREX2,Prex2,2,-1,1,0,0,0
PRF1,Prf1,-8,0,-8,2.834951,0,0
PRG2,Prg2,6,9,15,0,0,0
PRG3,Prg3,10,1,11,0,0,0
PRG4,Prg4,4,1,5,0,0,0
PRH1,Prh1,21,0,21,0,0,0
PRICKLE1,Prickle1,4,10,14,2.427184,0,0
PRICKLE2,Prickle2,16,0,16,4.68932,0,0
PRICKLE3,Prickle3,-3,-8,-11,3.514563,0,0
PRICKLE4,Prickle4,5,0,5,17.961165,0,0
PRIM1,Prim1,0,-5,-5,4.271845,0,0
PRIM2,Prim2,0,-1,-1,16.61165,0,0
PRIMA1,Prima1,5,-4,1,0,0,0
PRIMPOL,Primpol,0,-5,-5,0,0,0
PRKAA1,Prkaa1,-1,-3,-4,26.31068,0,0
PRKAA2,Prkaa2,4,3,7,5.07767,0,0
PRKAB1,Prkab1,4,4,8,11.92233,0,0
PRKAB2,Prkab2,5,7,12,28.621359,0,0
PRKACA,Prkaca,8,-3,5,2.776699,0,0
PRKACB,Prkacb,7,-1,6,21.271845,0,0
PRKAG1,Prkag1,6,-3,3,15.504854,0,0
PRKAG2,Prkag2,5,-11,-6,7.126214,0,0
PRKAG3,Prkag3,2,7,9,0.737864,0,0
PRKAR1A,Prkar1a,7,-4,3,58.553398,0,0
PRKAR1B,Prkar1b,5,-9,-4,30.252427,0,0
PRKAR2A,Prkar2a,5,-3,2,6.15534,0,0
PRKAR2B,Prkar2b,7,-8,-1,34.650485,0,0
PRKCA,Prkca,5,-3,2,4.262136,0,0
PRKCB,Prkcb,6,-1,5,0,0,0
PRKCD,Prkcd,-1,-2,-3,7.281553,0,0
PRKCE,Prkce,4,4,8,5.145631,0,0
PRKCG,Prkcg,15,-6,9,46.019417,0,0
PRKCH,Prkch,21,-1,20,3.067961,0,0
PRKCI,Prkci,4,3,7,4.252427,0,0
PRKCQ,Prkcq,0,7,7,0,0,0
PRKCSH,Prkcsh,10,-3,7,140.087379,13.583333,0
PRKCZ,Prkcz,9,-1,8,0,0,0
PRKD1,Prkd1,17,6,23,14.533981,0,0
PRKD2,Prkd2,23,0,23,90.07767,0,0
PRKD3,Prkd3,-1,-2,-3,11.883495,0,0
PRKDC,Prkdc,9,-1,8,2.76699,0,0
PRKG1,Prkg1,2,-7,-5,5.776699,0,0
PRKG2,Prkg2,2,3,5,0,0,0
PRKN,Prkn,11,-2,9,14.553398,0,0
PRKRA,Prkra,3,-7,-4,3.718447,0,0
PRKRIP1,Prkrip1,7,2,9,3.679612,0,0
PRKX,Prkx,5,0,5,2,0,0
PRL,Prl,-2,1,-1,0,0,0
PRLH,Prlh,5,1,6,0,0,0
PRLHR,Prlhr,0,1,1,0,0,0
PRLR,Prlr,31,2,33,17.320388,0,0
PRM1,Prm1,1,12,13,0,0,0
PRM2,Prm2,5,0,5,0,0,0
PRM3,Prm3,12,2,14,0,0,0
PRMT1,Prmt1,8,-4,4,11.009709,0,0
PRMT2,Prmt2,7,-6,1,39.067961,13.708333,0
PRMT3,Prmt3,4,0,4,83.524272,26.916667,0
PRMT5,Prmt5,8,-7,1,62.126214,0,76
PRMT6,Prmt6,-20,-7,-27,3.563107,0,0
PRMT7,Prmt7,2,-5,-3,13.203883,0,0
PRMT8,Prmt8,-1,1,0,0,0,0
PRMT9,Prmt9,-1,-5,-6,3.543689,0,0
PRND,Prnd,-4,1,-3,0,0,0
PRNP,Prnp,8,1,9,9.174757,0,0
PROB1,Prob1,0,-5,-5,1.786408,0,0
PROC,Proc,2,3,5,1.009709,0,0
PROCA1,Proca1,56,7,63,3.932039,0,0
PROCR,Procr,1,2,3,0,0,0
PRODH,Prodh,4,-4,0,0,0,0
PRODH2,Prodh2,12,7,19,0,0,0
PROK1,Prok1,5,-1,4,0,0,0
PROK2,Prok2,-2,-7,-9,0,0,0
PROKR1,Prokr1,-1,1,0,0,0,0
PROKR2,Prokr2,3,0,3,0,0,0
PROM1,Prom1,5,3,8,0,0,0
PROM2,Prom2,9,8,17,112.737864,176,0
PROP1,Prop1,1,7,8,0,0,0
PRORP,Prorp,8,-7,1,5.776699,0,0
PROS1,Pros1,4,-2,2,10.262136,0,0
PROSER1,Proser1,7,-3,4,1.194175,0,0
PROSER2,Proser2,7,10,17,0,0,0
PROSER3,Proser3,4,-13,-9,19.504854,0,0
PROX1,Prox1,45,-3,42,0,0,0
PROX2,Prox2,10,-12,-2,0,0,0
PROZ,Proz,3,-8,-5,2,0,0
PRPF18,Prpf18,5,-3,2,5.087379,0,0
PRPF19,Prpf19,6,-3,3,4.194175,0,0
PRPF3,Prpf3,4,-1,3,8.990291,0,0
PRPF31,Prpf31,4,-2,2,17.320388,0,0
PRPF38A,Prpf38a,6,2,8,6.038835,0,0
PRPF38B,Prpf38b,6,-2,4,3.631068,0,0
PRPF39,Prpf39,0,2,2,3.805825,0,0
PRPF4,Prpf4,4,-3,1,9.834951,0,0
PRPF40A,Prpf40a,6,-4,2,7.815534,0,0
PRPF40B,Prpf40b,8,-8,0,7.621359,0,0
PRPF4B,Prpf4b,5,-2,3,0,0,0
PRPF6,Prpf6,6,-3,3,6.854369,0,0
PRPF8,Prpf8,12,0,12,2.825243,0,0
PRPH,Prph,6,-2,4,0,0,0
PRPH2,Prph2,8,-2,6,0,0,0
PRPS1,Prps1,7,-1,6,0,0,0
PRPS1L1,Prps1l1,7,-3,4,0,0,0
PRPS2,Prps2,1,1,2,3.873786,0,0
PRPSAP1,Prpsap1,7,-1,6,13.533981,0,0
PRPSAP2,Prpsap2,1,-3,-2,0.980583,0,0
PRR11,Prr11,6,-1,5,0,0,0
PRR12,Prr12,-1,-4,-5,5.543689,0,0
PRR13,Prr13,6,-2,4,33.38835,0,0
PRR14,Prr14,6,0,6,16.087379,0,0
PRR14L,Prr14l,6,-11,-5,5.242718,0,0
PRR15,Prr15,-2,5,3,1.320388,0,0
PRR15L,Prr15l,-17,-2,-19,0,0,0
PRR16,Prr16,2,-3,-1,6.495146,0,0
PRR18,Prr18,51,10,61,0,0,0
PRR19,Prr19,1,-1,0,3.165049,0,0
PRR22,Prr22,-13,-17,-30,0,0,0
PRR27,Prr27,7,-9,-2,0,0,0
PRR29,Prr29,-6,8,2,28.029126,0,0
PRR3,Prr3,8,-2,6,6.864078,0,0
PRR30,Prr30,1,2,3,4.553398,0,0
PRR32,Prr32,5,-9,-4,0,0,0
PRR33,Prr33,0,-5,-5,0,0,0
PRR36,Prr36,14,-3,11,14.883495,0,0
PRR5,Prr5,2,2,4,0,0,0
PRR5L,Prr5l,8,5,13,1.252427,0,0
PRR7,Prr7,3,0,3,66.048544,0,0
PRR9,Prr9,3,0,3,0,0,0
PRRC1,Prrc1,4,-3,1,3.475728,0,0
PRRC2A,Prrc2a,11,-5,6,9.087379,0,0
PRRC2C,Prrc2c,10,-1,9,9.650485,0,0
PRRG1,Prrg1,2,-1,1,0,0,0
PRRG2,Prrg2,10,0,10,11.669903,0,0
PRRG3,Prrg3,-1,1,0,0,0,0
PRRG4,Prrg4,10,12,22,10.475728,0,0
PRRT1,Prrt1,10,-2,8,12.893204,0,0
PRRT2,Prrt2,12,1,13,2.76699,0,0
PRRT3,Prrt3,4,2,6,4.262136,0,0
PRRT4,Prrt4,10,-1,9,7.368932,0,0
PRRX1,Prrx1,-4,-2,-6,1.407767,0,0
PRRX2,Prrx2,-5,1,-4,0,0,0
PRSS1,Prss1,3,-1,2,0,0,0
PRSS12,Prss12,-3,-11,-14,3.92233,0,0
PRSS16,Prss16,4,1,5,24.660194,0,0
PRSS2,Prss2,-2,-5,-7,0,0,0
PRSS21,Prss21,1,-6,-5,11.359223,0,0
PRSS22,Prss22,0,10,10,1.436893,0,0
PRSS23,Prss23,0,3,3,0,0,0
PRSS27,Prss27,11,-2,9,11.815534,0,0
PRSS3,Prss3,1,-1,0,4.84466,0,0
PRSS33,Prss33,5,-7,-2,0,0,0
PRSS35,Prss35,2,1,3,0,0,0
PRSS36,Prss36,-15,-4,-19,0,0,0
PRSS37,Prss37,0,-2,-2,0,0,0
PRSS38,Prss38,3,-4,-1,0,0,0
PRSS41,Prss41,1,6,7,0,0,0
PRSS48,Prss48,-5,-7,-12,0,0,0
PRSS50,Prss50,1,2,3,0,0,0
PRSS51,Prss51,1,5,6,0,0,0
PRSS53,Prss53,-6,-3,-9,0,0,0
PRSS54,Prss54,0,-4,-4,0,0,0
PRSS55,Prss55,53,4,57,64.300971,0,0
PRSS56,Prss56,-2,-10,-12,0,0,0
PRSS57,Prss57,5,-17,-12,1.650485,0,0
PRSS58,Prss58,1,-3,-2,0,0,0
PRSS8,Prss8,-4,-8,-12,0,0,0
PRTG,Prtg,2,2,4,6.281553,0,0
PRTN3,Prtn3,9,24,33,1.553398,0,0
PRUNE1,Prune1,9,-4,5,6.61165,0,0
PRUNE2,Prune2,2,-1,1,2.126214,0,0
PRX,Prx,21,-5,16,0,0,0
PRXL2A,Prxl2a,9,-8,1,0,0,0
PRXL2B,Prxl2b,-2,10,8,2.126214,0,0
PRXL2C,Prxl2c,1,-1,0,3.834951,0,0
PSAP,Psap,13,2,15,2.825243,0,0
PSAPL1,Psapl1,0,0,0,0,0,0
PSAT1,Psat1,10,3,13,2.15534,0,0
PSCA,Psca,-17,15,-2,25.834951,0,0
PSD,Psd,3,-7,-4,3.019417,0,0
PSD2,Psd2,-2,-2,-4,0,0,0
PSD3,Psd3,4,0,4,7.135922,0,0
PSD4,Psd4,0,-15,-15,0,0,0
PSEN1,Psen1,7,-4,3,5.533981,0,0
PSEN2,Psen2,-2,-1,-3,12.912621,0,0
PSENEN,Psenen,8,-10,-2,0,0,0
PSIP1,Psip1,4,-3,1,6.495146,0,0
PSKH1,Pskh1,0,-6,-6,5.757282,0,0
PSMA1,Psma1,7,-5,2,15.097087,0,0
PSMA2,Psma2,-3,-11,-14,2.203883,0,0
PSMA3,Psma3,7,-3,4,41.436893,0,0
PSMA4,Psma4,8,1,9,19.213592,0,0
PSMA5,Psma5,4,-8,-4,0.980583,0,0
PSMA6,Psma6,2,-3,-1,2.116505,0,0
PSMA7,Psma7,7,0,7,8.834951,0,0
PSMA8,Psma8,-3,-5,-8,0,0,0
PSMB1,Psmb1,10,-3,7,2.776699,0,0
PSMB10,Psmb10,2,0,2,2.718447,0,0
PSMB11,Psmb11,8,-7,1,0,0,0
PSMB2,Psmb2,2,6,8,5.699029,0,0
PSMB3,Psmb3,11,-3,8,0,0,0
PSMB4,Psmb4,8,-3,5,0,0,0
PSMB5,Psmb5,9,-2,7,3.864078,0,0
PSMB6,Psmb6,6,-3,3,4.592233,0,0
PSMB7,Psmb7,7,-6,1,7.728155,0,0
PSMB8,Psmb8,0,6,6,0,0,0
PSMB9,Psmb9,1,-4,-3,3.417476,0,0
PSMC1,Psmc1,8,-5,3,5.135922,0,0
PSMC2,Psmc2,6,-5,1,9.728155,0,0
PSMC3,Psmc3,3,-3,0,2.776699,0,0
PSMC3IP,Psmc3ip,8,-1,7,22.951456,0,0
PSMC4,Psmc4,6,-4,2,1.116505,0,0
PSMC5,Psmc5,7,-9,-2,47.466019,0,0
PSMC6,Psmc6,11,-9,2,1.990291,0,0
PSMD1,Psmd1,6,-3,3,1.873786,0,0
PSMD10,Psmd10,11,-5,6,24.300971,0,0
PSMD11,Psmd11,11,-4,7,10.805825,0,0
PSMD12,Psmd12,6,1,7,17.15534,0,0
PSMD13,Psmd13,11,-5,6,8.533981,0,0
PSMD14,Psmd14,4,2,6,6.116505,0,0
PSMD2,Psmd2,8,-4,4,11.436893,0,0
PSMD3,Psmd3,7,-2,5,14.330097,0,0
PSMD4,Psmd4,6,-5,1,7.165049,0,0
PSMD5,Psmd5,0,-4,-4,10.058252,0,0
PSMD6,Psmd6,0,-4,-4,29.466019,0,0
PSMD7,Psmd7,2,-8,-6,6.475728,0,0
PSMD8,Psmd8,5,-1,4,6.320388,0,0
PSMD9,Psmd9,7,-1,6,8.504854,0,0
PSME1,Psme1,5,-1,4,2.582524,0,0
PSME2,Psme2,4,-5,-1,3.165049,0,0
PSME3,Psme3,7,-4,3,1.184466,0,0
PSME3IP1,Psme3ip1,12,-1,11,2.873786,0,0
PSME4,Psme4,5,-1,4,8.097087,3.333333,0
PSMF1,Psmf1,4,2,6,32,0,0
PSMG1,Psmg1,-3,-2,-5,9.31068,0,0
PSMG2,Psmg2,6,-6,0,8.145631,0,0
PSMG3,Psmg3,0,2,2,11.223301,0,0
PSMG4,Psmg4,3,-5,-2,12.407767,0,0
PSORS1C2,Psors1c2,19,1,20,0,0,0
PSPC1,Pspc1,9,-5,4,0,0,0
PSPH,Psph,-1,-2,-3,187.699029,98.958333,0
PSPN,Pspn,11,27,38,3.359223,0,0
PSRC1,Psrc1,-8,-2,-10,4.38835,0,0
PSTK,Pstk,-6,-3,-9,4.776699,0,0
PSTPIP1,Pstpip1,4,-3,1,0,0,0
PSTPIP2,Pstpip2,-2,-3,-5,0,0,0
PTAFR,Ptafr,0,0,0,0,0,0
PTAR1,Ptar1,5,-6,-1,6.436893,0,0
PTBP1,Ptbp1,4,-1,3,0,0,0
PTBP2,Ptbp2,4,-2,2,7.446602,0,0
PTBP3,Ptbp3,9,-2,7,11.262136,0,0
PTCD1,Ptcd1,0,-2,-2,11.300971,0,0
PTCD2,Ptcd2,0,-1,-1,0,0,0
PTCD3,Ptcd3,-4,-4,-8,0,0,0
PTCH1,Ptch1,9,-2,7,3.097087,0,0
PTCH2,Ptch2,10,4,14,0,0,0
PTCHD1,Ptchd1,-3,-1,-4,6.291262,0,0
PTCHD4,Ptchd4,-5,-6,-11,0,0,0
PTCRA,Ptcra,8,16,24,0,0,0
PTDSS1,Ptdss1,4,-1,3,12.15534,0,0
PTDSS2,Ptdss2,8,0,8,7.92233,0,0
PTEN,Pten,8,1,9,12.097087,0,0
PTER,Pter,-2,-7,-9,1.291262,0,0
PTF1A,Ptf1a,2,2,4,0,0,0
PTGDR,Ptgdr,1,-4,-3,0,0,0
PTGDR2,Ptgdr2,1,-3,-2,0,0,0
PTGDS,Ptgds,30,6,36,0,0,0
PTGER1,Ptger1,41,-5,36,74.592233,13.958333,0
PTGER2,Ptger2,14,3,17,0,0,0
PTGER3,Ptger3,31,0,31,0,0,0
PTGER4,Ptger4,3,1,4,1.067961,0,0
PTGES,Ptges,-3,5,2,0,0,0
PTGES2,Ptges2,7,-2,5,4.223301,0,0
PTGES3,Ptges3,27,0,27,433.650485,210.708333,124
PTGES3L,Ptges3l,2,-9,-7,45.417476,0,0
PTGFR,Ptgfr,5,2,7,1.106796,0,0
PTGFRN,Ptgfrn,5,0,5,0,0,0
PTGIR,Ptgir,6,0,6,0,0,0
PTGIS,Ptgis,3,-1,2,0,0,0
PTGR1,Ptgr1,4,-2,2,0.84466,0,0
PTGR2,Ptgr2,3,-10,-7,20.970874,0,0
PTGS1,Ptgs1,5,-6,-1,1.961165,0,0
PTGS2,Ptgs2,18,6,24,42.76699,0,0
PTH,Pth,-6,2,-4,0,0,0
PTH1R,Pth1r,3,4,7,0,0,0
PTH2,Pth2,13,2,15,0,0,0
PTH2R,Pth2r,3,2,5,10.427184,0,0
PTHLH,Pthlh,36,0,36,6.84466,0,0
PTK2,Ptk2,8,-5,3,5.378641,0,0
PTK2B,Ptk2b,-1,1,0,3.446602,0,0
PTK6,Ptk6,6,-5,1,5.446602,0,0
PTK7,Ptk7,5,-1,4,0,0,0
PTMA,Ptma,7,-2,5,10.825243,0,0
PTMS,Ptms,8,-6,2,49.456311,0,0
PTN,Ptn,5,0,5,0,0,0
PTOV1,Ptov1,12,-4,8,277.970874,130.958333,0
PTP4A1,Ptp4a1,4,-8,-4,5.097087,0,0
PTP4A2,Ptp4a2,9,-2,7,8.553398,0,0
PTP4A3,Ptp4a3,-9,-3,-12,17.825243,0,0
PTPA,Ptpa,12,-3,9,11.669903,0,0
PTPDC1,Ptpdc1,0,-12,-12,7.601942,0,0
PTPMT1,Ptpmt1,3,-5,-2,3.932039,0,0
PTPN1,Ptpn1,2,-3,-1,106.485437,0,0
PTPN11,Ptpn11,7,-1,6,17.116505,0,0
PTPN12,Ptpn12,5,-1,4,0,0,0
PTPN13,Ptpn13,3,5,8,114.184466,0,0
PTPN14,Ptpn14,8,-1,7,7.961165,0,0
PTPN18,Ptpn18,5,4,9,3.058252,0,0
PTPN2,Ptpn2,6,-2,4,20.504854,0,0
PTPN20,Ptpn20,8,-12,-4,0,0,0
PTPN21,Ptpn21,7,-1,6,31.330097,0,0
PTPN22,Ptpn22,45,9,54,0,0,0
PTPN23,Ptpn23,8,-3,5,6.592233,0,0
PTPN3,Ptpn3,-3,0,-3,14.543689,0,0
PTPN4,Ptpn4,9,-6,3,11.126214,0,0
PTPN5,Ptpn5,3,10,13,0,0,0
PTPN6,Ptpn6,28,-5,23,13.873786,0,0
PTPN7,Ptpn7,6,8,14,0,0,0
PTPN9,Ptpn9,5,-5,0,7.126214,0,0
PTPRA,Ptpra,1,-2,-1,4.446602,0,0
PTPRB,Ptprb,-1,-1,-2,1.213592,0,0
PTPRC,Ptprc,4,-1,3,0,0,0
PTPRCAP,Ptprcap,-19,2,-17,1.951456,0,0
PTPRD,Ptprd,7,-1,6,4.15534,0,0
PTPRE,Ptpre,-11,-7,-18,0,0,0
PTPRF,Ptprf,11,2,13,9.776699,0,0
PTPRH,Ptprh,3,-2,1,3.038835,0,0
PTPRJ,Ptprj,0,-6,-6,2.504854,0,0
PTPRK,Ptprk,5,-1,4,10.252427,0,0
PTPRM,Ptprm,7,-5,2,0,0,0
PTPRN,Ptprn,20,11,31,1.242718,0,0
PTPRN2,Ptprn2,6,6,12,0,0,0
PTPRO,Ptpro,0,0,0,1.252427,0,0
PTPRQ,Ptprq,1,-6,-5,0,0,0
PTPRR,Ptprr,0,0,0,2.786408,0,0
PTPRS,Ptprs,4,-2,2,6.776699,0,0
PTPRT,Ptprt,3,-4,-1,0,0,0
PTPRU,Ptpru,2,2,4,21.194175,0,0
PTPRZ1,Ptprz1,6,-1,5,2.446602,0,0
PTRH1,Ptrh1,0,0,0,6.61165,0,0
PTRH2,Ptrh2,2,-6,-4,2.320388,0,0
PTRHD1,Ptrhd1,4,-10,-6,5.281553,0,0
PTS,Pts,1,-8,-7,5.679612,0,0
PTTG1,Pttg1,3,-18,-15,2.572816,0,0
PTTG1IP,Pttg1ip,7,-4,3,2.223301,0,0
PTX3,Ptx3,-8,1,-7,4.524272,0,0
PTX4,Ptx4,10,1,11,1.262136,0,0
PUDP,Pudp,-13,-4,-17,3.009709,0,0
PUF60,Puf60,6,-7,-1,12.524272,0,0
PUM1,Pum1,9,-4,5,50.087379,0,0
PUM2,Pum2,8,-3,5,17.553398,0,0
PUM3,Pum3,-6,-3,-9,8.31068,0,0
PURA,Pura,11,-6,5,20.834951,0,0
PURB,Purb,7,3,10,8.106796,0,0
PURG,Purg,18,-8,10,0,0,0
PUS1,Pus1,1,0,1,2.708738,0,0
PUS10,Pus10,7,-4,3,4.902913,0,0
PUS3,Pus3,4,-8,-4,11.669903,0,0
PUS7,Pus7,-4,-5,-9,11.291262,0,0
PUS7L,Pus7l,3,-13,-10,7.330097,0,0
PUSL1,Pusl1,-7,-9,-16,3.038835,0,0
PVALB,Pvalb,2,-2,0,0,0,0
PVR,Pvr,2,5,7,2.951456,0,0
PVRIG,Pvrig,14,-4,10,1.76699,0,0
PWP1,Pwp1,2,-1,1,6.339806,0,0
PWP2,Pwp2,-26,-1,-27,1.815534,0,0
PWWP2A,Pwwp2a,5,-2,3,7.262136,0,0
PWWP2B,Pwwp2b,4,1,5,0,0,0
PWWP3A,Pwwp3a,20,-17,3,578.990291,288.25,438
PWWP3B,Pwwp3b,8,3,11,9.436893,0,0
PXDC1,Pxdc1,7,-1,6,1.135922,0,0
PXDN,Pxdn,7,-6,1,6.271845,0,0
PXK,Pxk,7,0,7,13.126214,0,0
PXMP2,Pxmp2,6,-9,-3,9.291262,0,0
PXMP4,Pxmp4,3,0,3,3.019417,0,102
PXN,Pxn,7,-3,4,3.456311,0,0
PXT1,Pxt1,4,-7,-3,10.553398,0,0
PXYLP1,Pxylp1,6,-5,1,3.106796,0,0
PYCARD,Pycard,4,1,5,0,0,0
PYCR1,Pycr1,3,2,5,0.912621,0,0
PYCR2,Pycr2,4,0,4,4.291262,0,0
PYGB,Pygb,9,2,11,1.048544,0,0
PYGL,Pygl,2,-2,0,8.524272,0,0
PYGM,Pygm,15,3,18,0,0,0
PYGO1,Pygo1,3,2,5,1.805825,0,0
PYGO2,Pygo2,10,0,10,10.320388,0,0
PYM1,Pym1,-14,-15,-29,3.92233,0,0
PYROXD1,Pyroxd1,3,-1,2,5.038835,0,0
PYROXD2,Pyroxd2,0,5,5,0,0,0
PYURF,Pyurf,1,-2,-1,18.116505,0,0
PYY,Pyy,17,-5,12,0.650485,0,0
PZP,Pzp,-1,5,4,0,0,0
QDPR,Qdpr,4,-1,3,14.019417,0,0
QPCT,Qpct,8,7,15,0,0,0
QPCTL,Qpctl,-1,0,-1,1.038835,0,0
QPRT,Qprt,6,0,6,0,0,0
QRFP,Qrfp,11,-4,7,0,0,0
QRFPR,Qrfpr,7,-4,3,0,0,0
QRICH1,Qrich1,-1,-4,-5,7.145631,0,0
QRICH2,Qrich2,20,-3,17,0,0,0
QRSL1,Qrsl1,1,-8,-7,1.23301,0,0
QSER1,Qser1,8,-1,7,5.07767,0,0
QSOX1,Qsox1,9,-2,7,2.533981,0,0
QSOX2,Qsox2,1,-4,-3,11.834951,0,0
QTRT1,Qtrt1,8,3,11,26.466019,0,0
QTRT2,Qtrt2,-1,-2,-3,30.38835,0,0
R3HCC1,R3hcc1,6,-12,-6,10.252427,0,0
R3HCC1L,R3hcc1l,0,-5,-5,0,0,0
R3HDM1,R3hdm1,6,-4,2,1.679612,0,0
R3HDM2,R3hdm2,2,-10,-8,12.601942,0,0
R3HDM4,R3hdm4,11,-4,7,0,0,0
R3HDML,R3hdml,2,0,2,0,0,0
RAB10,Rab10,6,-1,5,5.980583,0,0
RAB11A,Rab11a,8,-3,5,29.048544,0,0
RAB11B,Rab11b,4,-3,1,7.23301,0,0
RAB11FIP1,Rab11fip1,8,5,13,2.475728,0,0
RAB11FIP2,Rab11fip2,2,-5,-3,55.31068,0,0
RAB11FIP3,Rab11fip3,2,0,2,2.582524,0,0
RAB11FIP4,Rab11fip4,-9,-3,-12,5.669903,0,0
RAB11FIP5,Rab11fip5,3,-4,-1,2.621359,0,0
RAB12,Rab12,5,0,5,16.563107,0,0
RAB13,Rab13,3,-1,2,2.174757,0,0
RAB14,Rab14,4,-5,-1,5.572816,0,0
RAB15,Rab15,5,1,6,1.291262,0,0
RAB17,Rab17,18,0,18,3.184466,0,0
RAB18,Rab18,3,3,6,19.825243,0,0
RAB19,Rab19,6,-6,0,0,0,0
RAB1A,Rab1a,6,-2,4,7.679612,0,0
RAB1B,Rab1b,11,-4,7,2.466019,0,0
RAB20,Rab20,-2,7,5,0,0,0
RAB21,Rab21,6,-1,5,10.223301,0,0
RAB22A,Rab22a,-1,-4,-5,5.252427,0,0
RAB23,Rab23,4,-3,1,5.271845,0,0
RAB24,Rab24,-3,-7,-10,12.825243,0,0
RAB25,Rab25,17,2,19,0,0,0
RAB26,Rab26,-6,-9,-15,0,0,0
RAB27A,Rab27a,0,5,5,1.174757,0,0
RAB27B,Rab27b,-4,1,-3,5.825243,0,0
RAB28,Rab28,2,-4,-2,25.543689,0,0
RAB29,Rab29,3,-6,-3,0.854369,0,0
RAB2A,Rab2a,7,0,7,0.699029,0,0
RAB2B,Rab2b,1,-5,-4,14.84466,0,0
RAB30,Rab30,18,-3,15,0,0,0
RAB31,Rab31,17,1,18,1.019417,0,0
RAB32,Rab32,2,3,5,9.708738,0,0
RAB33A,Rab33a,3,-2,1,0,0,0
RAB33B,Rab33b,2,0,2,3.446602,0,0
RAB34,Rab34,4,1,5,6.436893,0,0
RAB35,Rab35,3,-5,-2,5.679612,0,0
RAB36,Rab36,-2,-6,-8,94.563107,0,0
RAB37,Rab37,1,-2,-1,0,0,0
RAB38,Rab38,-1,-3,-4,0,0,0
RAB39B,Rab39b,9,0,9,0,0,0
RAB3A,Rab3a,13,3,16,1.165049,0,0
RAB3B,Rab3b,2,0,2,1.145631,0,0
RAB3C,Rab3c,0,-1,-1,0,0,0
RAB3D,Rab3d,4,-6,-2,13.07767,0,0
RAB3GAP1,Rab3gap1,6,-1,5,1.07767,0,0
RAB3GAP2,Rab3gap2,4,-3,1,2.961165,0,0
RAB3IL1,Rab3il1,-5,-7,-12,3.106796,0,0
RAB3IP,Rab3ip,6,-4,2,102.815534,0,0
RAB40B,Rab40b,0,-7,-7,6.873786,0,0
RAB40C,Rab40c,-6,-3,-9,2.281553,0,0
RAB42,Rab42,-1,5,4,0,0,0
RAB43,Rab43,-1,-3,-4,2.495146,0,0
RAB44,Rab44,18,10,28,0,0,0
RAB4A,Rab4a,5,-2,3,25.873786,0,0
RAB4B,Rab4b,20,-5,15,3.427184,0,0
RAB5A,Rab5a,6,1,7,9.912621,0,0
RAB5B,Rab5b,10,-5,5,3.854369,0,0
RAB5C,Rab5c,8,-3,5,0,0,0
RAB5IF,Rab5if,3,-1,2,7.378641,0,0
RAB6A,Rab6a,11,1,12,5.174757,0,0
RAB6B,Rab6b,23,-4,19,4.582524,0,0
RAB7B,Rab7b,-2,0,-2,6.495146,0,0
RAB8A,Rab8a,4,0,4,14.592233,0,0
RAB8B,Rab8b,5,-9,-4,2.543689,0,0
RAB9B,Rab9b,2,-5,-3,0,0,0
RABAC1,Rabac1,9,-4,5,0.970874,0,0
RABEP1,Rabep1,8,-1,7,8.330097,0,0
RABEP2,Rabep2,7,-6,1,7.320388,0,0
RABEPK,Rabepk,12,-1,11,3.834951,0,0
RABGAP1,Rabgap1,5,-11,-6,4.679612,0,0
RABGAP1L,Rabgap1l,7,-8,-1,5.15534,0,0
RABGEF1,Rabgef1,7,-4,3,4.834951,0,0
RABGGTA,Rabggta,-1,-8,-9,26.902913,0,0
RABGGTB,Rabggtb,4,-11,-7,14.048544,0,0
RABIF,Rabif,6,-7,-1,6.834951,0,0
RABL3,Rabl3,7,-7,0,10.699029,0,0
RABL6,Rabl6,6,-1,5,5.660194,4.791667,0
RAC1,Rac1,9,1,10,43.242718,0,0
RAC2,Rac2,-1,2,1,0,0,0
RAC3,Rac3,10,-2,8,0,0,0
RACGAP1,Racgap1,6,-8,-2,3.048544,0,0
RACK1,Rack1,8,-5,3,5.087379,0,0
RAD1,Rad1,5,-1,4,0,0,0
RAD17,Rad17,2,-3,-1,12.135922,0,0
RAD18,Rad18,5,-6,-1,11.223301,0,0
RAD21,Rad21,8,-2,6,8.786408,0,0
RAD23A,Rad23a,-1,-7,-8,12.68932,0,0
RAD23B,Rad23b,6,-4,2,22.203883,0,0
RAD50,Rad50,6,-4,2,0,0,0
RAD51,Rad51,-1,0,-1,1.320388,0,0
RAD51AP1,Rad51ap1,-2,-13,-15,2.456311,0,0
RAD51AP2,Rad51ap2,4,0,4,0,0,0
RAD51B,Rad51b,0,-7,-7,0,0,0
RAD51C,Rad51c,9,3,12,12.019417,0,0
RAD51D,Rad51d,3,-4,-1,1.61165,0,0
RAD52,Rad52,11,-2,9,13.563107,0,0
RAD54B,Rad54b,0,-2,-2,8.475728,0,0
RAD54L,Rad54l,8,-10,-2,2.61165,0,0
RAD54L2,Rad54l2,8,-3,5,40.213592,0,0
RAD9A,Rad9a,10,-3,7,6.533981,0,0
RAD9B,Rad9b,3,-5,-2,15.262136,0,0
RADIL,Radil,5,-5,0,13.126214,0,0
RADX,Radx,7,0,7,0,0,0
RAE1,Rae1,4,-2,2,3.446602,7.708333,0
RAET1E,Raet1e,-6,6,0,0,0,0
RAF1,Raf1,11,-4,7,13.514563,0,0
RAG1,Rag1,12,1,13,19.194175,0,0
RAG2,Rag2,1,-7,-6,0,0,0
RAI1,Rai1,-13,0,-13,10.165049,0,0
RAI14,Rai14,6,-2,4,12.640777,0,0
RAI2,Rai2,8,0,8,1.252427,0,0
RALA,Rala,3,-5,-2,5.398058,0,0
RALB,Ralb,6,0,6,70.07767,0,0
RALBP1,Ralbp1,7,-1,6,5.990291,0,0
RALGAPA1,Ralgapa1,4,0,4,18.708738,0,0
RALGAPA2,Ralgapa2,2,-5,-3,2.281553,0,0
RALGAPB,Ralgapb,3,-3,0,6.126214,0,0
RALGDS,Ralgds,-7,-10,-17,5.165049,0,0
RALGPS1,Ralgps1,6,-10,-4,2.368932,0,0
RALGPS2,Ralgps2,3,-5,-2,1.009709,0,0
RALY,Raly,6,1,7,55.815534,15.166667,0
RALYL,Ralyl,0,-7,-7,2.563107,0,0
RAMAC,Ramac,5,-6,-1,0,0,0
RAMP1,Ramp1,2,4,6,1.23301,0,0
RAMP2,Ramp2,1,-5,-4,0,0,0
RAMP3,Ramp3,2,14,16,0,0,0
RAN,Ran,4,-3,1,78.621359,26.833333,0
RANBP1,Ranbp1,7,-7,0,14.436893,0,0
RANBP10,Ranbp10,10,-2,8,88.213592,0,0
RANBP17,Ranbp17,0,-10,-10,1.796117,0,0
RANBP2,Ranbp2,7,-4,3,8.961165,0,0
RANBP3,Ranbp3,8,-3,5,17.087379,0,0
RANBP3L,Ranbp3l,9,-5,4,0,0,0
RANBP6,Ranbp6,-2,-5,-7,4.728155,0,0
RANBP9,Ranbp9,8,3,11,17.961165,0,0
RANGAP1,Rangap1,24,-2,22,322.213592,73.5,143
RANGRF,Rangrf,10,-4,6,0,0,0
RAP1A,Rap1a,6,-3,3,6.864078,0,0
RAP1B,Rap1b,8,1,9,9.631068,0,0
RAP1GAP,Rap1gap,21,-4,17,18.398058,0,0
RAP1GAP2,Rap1gap2,4,-4,0,0,0,0
RAP1GDS1,Rap1gds1,9,-1,8,8.650485,0,0
RAP2A,Rap2a,10,2,12,2.067961,0,237
RAP2B,Rap2b,3,1,4,16.174757,0,0
RAP2C,Rap2c,5,5,10,1.980583,0,0
RAPGEF1,Rapgef1,12,-2,10,25.320388,0,0
RAPGEF2,Rapgef2,8,-1,7,10.38835,0,0
RAPGEF3,Rapgef3,15,3,18,4.116505,0,0
RAPGEF4,Rapgef4,5,0,5,2.504854,0,0
RAPGEF5,Rapgef5,-2,1,-1,8.330097,0,0
RAPGEF6,Rapgef6,4,-3,1,2.019417,0,0
RAPGEFL1,Rapgefl1,-6,-2,-8,0,0,0
RAPH1,Raph1,9,-3,6,4.873786,0,0
RAPSN,Rapsn,18,-9,9,0,0,0
RARA,Rara,8,-2,6,2.019417,0,0
RARB,Rarb,3,2,5,25.252427,0,0
RARG,Rarg,3,-6,-3,5.067961,0,0
RARRES1,Rarres1,0,1,1,0,0,0
RARRES2,Rarres2,-4,-2,-6,0,0,0
RARS2,Rars2,3,-10,-7,4.873786,0,0
RASA1,Rasa1,4,0,4,24.970874,0,0
RASA2,Rasa2,2,-7,-5,4.359223,0,0
RASA3,Rasa3,-6,-7,-13,1.213592,0,0
RASA4,Rasa4,2,4,6,2.38835,0,0
RASAL1,Rasal1,0,-6,-6,0,0,0
RASAL2,Rasal2,6,-3,3,6.058252,0,0
RASAL3,Rasal3,-1,-4,-5,0,0,0
RASD1,Rasd1,74,7,81,2.029126,0,0
RASD2,Rasd2,1,-1,0,0,0,0
RASEF,Rasef,4,-8,-4,4.796117,0,0
RASGEF1A,Rasgef1a,4,-2,2,0,0,0
RASGEF1B,Rasgef1b,9,11,20,1.485437,0,0
RASGEF1C,Rasgef1c,4,9,13,1.514563,0,0
RASGRF1,Rasgrf1,0,-11,-11,0.893204,0,0
RASGRF2,Rasgrf2,8,0,8,0,0,0
RASGRP1,Rasgrp1,21,-3,18,13.019417,0,0
RASGRP2,Rasgrp2,13,10,23,0,0,0
RASGRP3,Rasgrp3,9,0,9,2.242718,0,0
RASGRP4,Rasgrp4,1,4,5,1.097087,0,0
RASIP1,Rasip1,-4,-1,-5,4.475728,0,0
RASL10A,Rasl10a,11,-3,8,28.76699,0,0
RASL10B,Rasl10b,10,-7,3,0,0,0
RASL11A,Rasl11a,58,14,72,0.893204,0,0
RASL11B,Rasl11b,15,-2,13,1.417476,0,0
RASL12,Rasl12,15,-7,8,0,0,0
RASSF1,Rassf1,-3,-1,-4,4.038835,0,0
RASSF10,Rassf10,-5,-13,-18,6.058252,0,0
RASSF2,Rassf2,3,-11,-8,0,0,0
RASSF3,Rassf3,4,-5,-1,0,0,0
RASSF4,Rassf4,7,-2,5,3.757282,0,0
RASSF5,Rassf5,-5,7,2,7.281553,0,0
RASSF6,Rassf6,-3,-13,-16,5.009709,0,0
RASSF7,Rassf7,-15,-12,-27,1.184466,0,0
RASSF8,Rassf8,-1,3,2,13.184466,0,0
RASSF9,Rassf9,20,-5,15,11.951456,0,0
RAVER1,Raver1,0,-2,-2,9.194175,0,0
RAVER2,Raver2,4,0,4,8.466019,0,0
RAX,Rax,6,0,6,0,0,0
RB1,Rb1,2,3,5,2.475728,0,0
RB1CC1,Rb1cc1,9,-1,8,2.893204,0,0
RBAK,Rbak,13,-6,7,3.291262,0,0
RBBP4,Rbbp4,5,-2,3,8.990291,0,0
RBBP5,Rbbp5,6,-4,2,20.194175,0,0
RBBP6,Rbbp6,-2,-4,-6,6.417476,0,0
RBBP7,Rbbp7,6,4,10,2.359223,0,0
RBBP8,Rbbp8,2,-4,-2,7.757282,0,0
RBBP8NL,Rbbp8nl,2,-1,1,10.456311,0,0
RBBP9,Rbbp9,1,-4,-3,3.398058,0,0
RBCK1,Rbck1,4,-2,2,2.475728,0,0
RBFA,Rbfa,-2,0,-2,8.174757,0,0
RBFOX1,Rbfox1,2,1,3,0,0,0
RBFOX2,Rbfox2,12,-1,11,3.834951,0,0
RBFOX3,Rbfox3,38,2,40,0,0,0
RBIS,Rbis,-1,1,0,10.029126,0,0
RBKS,Rbks,1,-11,-10,6.194175,0,0
RBL1,Rbl1,-3,-5,-8,8.058252,0,0
RBL2,Rbl2,4,1,5,4.970874,0,0
RBM10,Rbm10,5,-2,3,0.84466,0,0
RBM11,Rbm11,-3,-4,-7,0,0,0
RBM12,Rbm12,-7,-12,-19,28.533981,8.833333,0
RBM14,Rbm14,9,-2,7,2.601942,0,0
RBM15,Rbm15,9,-1,8,10.330097,0,0
RBM15B,Rbm15b,2,-5,-3,9.543689,0,0
RBM17,Rbm17,7,-6,1,15.601942,0,0
RBM18,Rbm18,2,-2,0,10.31068,0,0
RBM19,Rbm19,6,-1,5,1.776699,0,0
RBM20,Rbm20,3,1,4,1.582524,0,0
RBM22,Rbm22,7,-4,3,5.252427,0,0
RBM24,Rbm24,22,1,23,0,0,0
RBM25,Rbm25,7,-3,4,43.747573,0,0
RBM26,Rbm26,2,-1,1,0,0,0
RBM27,Rbm27,4,-2,2,2.786408,0,0
RBM28,Rbm28,3,-2,1,16.194175,0,0
RBM3,Rbm3,1,2,3,27.679612,0,0
RBM33,Rbm33,5,4,9,5.601942,0,0
RBM34,Rbm34,4,-3,1,1.524272,0,0
RBM38,Rbm38,9,0,9,3.203883,0,0
RBM39,Rbm39,2,-4,-2,0,0,0
RBM4,Rbm4,7,-2,5,0,0,0
RBM41,Rbm41,4,-3,1,0,0,0
RBM42,Rbm42,7,-1,6,1.07767,0,0
RBM43,Rbm43,-5,-6,-11,3.194175,0,0
RBM44,Rbm44,-6,1,-5,0,0,0
RBM45,Rbm45,-8,2,-6,10.223301,0,0
RBM46,Rbm46,3,-12,-9,0,0,0
RBM47,Rbm47,1,5,6,10.417476,0,0
RBM48,Rbm48,11,1,12,8.592233,0,0
RBM4B,Rbm4b,-4,0,-4,4.84466,0,0
RBM5,Rbm5,1,-2,-1,0.757282,0,0
RBM6,Rbm6,6,-6,0,5.825243,0,0
RBM7,Rbm7,4,-5,-1,5.883495,0,0
RBM8A,Rbm8a,6,0,6,3.058252,0,0
RBMS1,Rbms1,-1,-2,-3,5.572816,0,0
RBMS2,Rbms2,9,0,9,0,0,0
RBMS3,Rbms3,7,-3,4,0,0,0
RBMX,Rbmx,6,-5,1,0,0,0
RBMX2,Rbmx2,6,-3,3,6.553398,0,0
RBMXL1,Rbmxl1,4,-5,-1,8.601942,2.541667,0
RBMXL2,Rbmxl2,5,-1,4,0,0,0
RBP1,Rbp1,8,7,15,0,0,0
RBP2,Rbp2,7,-6,1,0,0,0
RBP3,Rbp3,-1,0,-1,0,0,0
RBP4,Rbp4,9,6,15,4.407767,0,0
RBP7,Rbp7,20,1,21,0,0,0
RBPJ,Rbpj,8,-1,7,2,0,0
RBPJL,Rbpjl,-2,-1,-3,1.378641,0,0
RBPMS,Rbpms,9,1,10,2.23301,0,0
RBPMS2,Rbpms2,2,-4,-2,2.796117,0,0
RBSN,Rbsn,7,-5,2,20.106796,0,0
RBX1,Rbx1,4,-3,1,3.466019,0,0
RC3H1,Rc3h1,11,-2,9,2.067961,0,0
RC3H2,Rc3h2,8,-1,7,17.165049,6.666667,0
RCAN1,Rcan1,-3,0,-3,5.592233,0,0
RCAN2,Rcan2,-3,6,3,0,0,0
RCAN3,Rcan3,0,-7,-7,5.961165,0,0
RCBTB1,Rcbtb1,3,-9,-6,0.757282,0,0
RCBTB2,Rcbtb2,4,-4,0,3.747573,0,0
RCC1,Rcc1,12,-3,9,10.961165,0,0
RCC1L,Rcc1l,3,0,3,3.019417,0,0
RCC2,Rcc2,11,1,12,15.679612,0,0
RCCD1,Rccd1,1,-7,-6,0,0,0
RCE1,Rce1,-3,-1,-4,8.252427,0,0
RCHY1,Rchy1,-1,-4,-5,0,0,0
RCL1,Rcl1,6,-5,1,6.980583,0,0
RCN1,Rcn1,9,-5,4,24.941748,0,0
RCN2,Rcn2,3,-7,-4,3.504854,0,0
RCN3,Rcn3,29,-5,24,0,0,0
RCOR1,Rcor1,1,-5,-4,10.203883,0,0
RCOR2,Rcor2,8,-5,3,1.912621,0,0
RCOR3,Rcor3,-2,-10,-12,16.893204,0,0
RCSD1,Rcsd1,-7,5,-2,2.524272,0,0
RCVRN,Rcvrn,7,7,14,0,0,0
RD3,Rd3,2,-10,-8,0,0,0
RD3L,Rd3l,0,-2,-2,0,0,0
RDH10,Rdh10,3,0,3,10.320388,0,0
RDH11,Rdh11,4,-10,-6,0,0,0
RDH12,Rdh12,2,-1,1,0,0,0
RDH13,Rdh13,-1,3,2,4.349515,0,0
RDH14,Rdh14,-15,-3,-18,9.087379,0,0
RDH16,Rdh16,0,0,0,0,0,0
RDH5,Rdh5,5,-3,2,10.864078,0,0
RDH8,Rdh8,10,1,11,0.776699,0,0
RDM1,Rdm1,2,-5,-3,0,0,0
RDX,Rdx,7,-2,5,8.699029,0,0
REC114,Rec114,2,-8,-6,0,0,0
REC8,Rec8,6,-9,-3,0,0,0
RECK,Reck,0,-7,-7,0,0,0
RECQL,Recql,8,1,9,0,0,0
RECQL4,Recql4,4,-2,2,6.660194,0,0
RECQL5,Recql5,3,-3,0,6.747573,0,0
REEP1,Reep1,-1,-8,-9,0,0,0
REEP2,Reep2,6,-11,-5,0,0,0
REEP3,Reep3,0,1,1,11.475728,0,0
REEP4,Reep4,-5,-11,-16,0.796117,0,0
REEP5,Reep5,7,-5,2,10.407767,0,0
REEP6,Reep6,3,5,8,46.291262,0,0
REG3A,Reg3a,2,-3,-1,0,0,0
REG3G,Reg3g,3,3,6,0,0,0
REG4,Reg4,3,5,8,0,0,0
REL,Rel,5,-5,0,6.737864,0,0
RELA,Rela,1,-6,-5,9.757282,0,0
RELB,Relb,0,2,2,0,0,0
RELCH,Relch,3,-3,0,3.572816,0,0
RELL1,Rell1,0,2,2,0.76699,0,0
RELL2,Rell2,-1,-1,-2,0,0,0
RELN,Reln,0,-3,-3,1.31068,0,0
RELT,Relt,0,-9,-9,10.805825,0,0
REM1,Rem1,0,-1,-1,0,0,0
REM2,Rem2,11,3,14,75.058252,0,0
RENBP,Renbp,12,9,21,0,0,0
REP15,Rep15,14,1,15,0,0,0
REPIN1,Repin1,6,-1,5,10.116505,0,0
REPS1,Reps1,3,0,3,8.184466,0,0
REPS2,Reps2,2,3,5,1.203883,0,0
RER1,Rer1,1,-5,-4,34.76699,0,0
RERE,Rere,9,-1,8,9.300971,0,0
RERG,Rerg,6,1,7,8.902913,4.083333,0
RERGL,Rergl,-1,5,4,0,0,0
RESF1,Resf1,0,3,3,10.097087,0,0
RESP18,Resp18,9,-4,5,0,0,0
REST,Rest,11,-2,9,2.84466,0,0
RET,Ret,1,8,9,0.883495,0,0
RETN,Retn,18,15,33,0,0,0
RETNLB,Retnlb,2,3,5,0,0,0
RETREG1,Retreg1,0,-4,-4,2.126214,0,0
RETREG2,Retreg2,6,-5,1,5.932039,0,0
RETREG3,Retreg3,5,-6,-1,0,0,0
RETSAT,Retsat,10,0,10,4.650485,0,0
REV1,Rev1,-1,0,-1,0,0,0
REV3L,Rev3l,7,-1,6,22.669903,0,0
REX1BD,Rex1bd,-3,-3,-6,9.757282,0,0
REXO1,Rexo1,0,-6,-6,2.145631,0,0
REXO2,Rexo2,5,-10,-5,2.524272,0,0
REXO4,Rexo4,4,-2,2,14.456311,0,0
REXO5,Rexo5,3,-8,-5,4.126214,0,0
RFC1,Rfc1,6,-4,2,3.747573,0,0
RFC2,Rfc2,9,-4,5,66.902913,0,0
RFC3,Rfc3,-4,-2,-6,7.563107,0,0
RFC4,Rfc4,3,-3,0,3.466019,0,0
RFC5,Rfc5,-3,-5,-8,110.61165,0,0
RFESD,Rfesd,-17,0,-17,11.708738,0,0
RFFL,Rffl,1,-5,-4,0,0,0
RFK,Rfk,0,-4,-4,14.990291,0,0
RFLNA,Rflna,0,6,6,0,0,0
RFLNB,Rflnb,6,-6,0,0,0,0
RFNG,Rfng,1,1,2,2.213592,0,0
RFPL4B,Rfpl4b,-1,6,5,0,0,0
RFT1,Rft1,2,-5,-3,5.533981,0,0
RFTN1,Rftn1,8,-1,7,0,0,0
RFTN2,Rftn2,29,-4,25,0,0,0
RFWD3,Rfwd3,0,-8,-8,2.427184,0,0
RFX1,Rfx1,4,-9,-5,137.563107,0,0
RFX2,Rfx2,-2,-8,-10,148.68932,0,0
RFX3,Rfx3,19,-5,14,8.019417,0,0
RFX4,Rfx4,2,-7,-5,0,0,0
RFX5,Rfx5,0,-12,-12,1.330097,0,0
RFX6,Rfx6,3,-4,-1,0,0,0
RFX7,Rfx7,7,-3,4,1.728155,0,0
RFX8,Rfx8,-3,-10,-13,0.776699,0,0
RFXANK,Rfxank,3,-6,-3,21.883495,0,0
RFXAP,Rfxap,-8,0,-8,0.650485,0,0
RGCC,Rgcc,9,3,12,0,0,0
RGL1,Rgl1,5,-3,2,2.368932,0,0
RGL2,Rgl2,9,-4,5,3.68932,0,0
RGL3,Rgl3,2,-2,0,1.84466,0,0
RGMA,Rgma,7,-4,3,0,0,0
RGMB,Rgmb,8,7,15,3.378641,0,0
RGN,Rgn,1,2,3,1.184466,0,0
RGP1,Rgp1,9,-10,-1,2.815534,0,0
RGR,Rgr,7,1,8,5.194175,0,0
RGS1,Rgs1,2,10,12,0,0,0
RGS10,Rgs10,0,-9,-9,2.582524,0,0
RGS11,Rgs11,10,2,12,0,0,0
RGS12,Rgs12,6,-9,-3,3.427184,0,0
RGS13,Rgs13,2,-5,-3,0,0,0
RGS14,Rgs14,-13,0,-13,0,0,0
RGS16,Rgs16,35,-6,29,2.61165,0,0
RGS17,Rgs17,5,6,11,0,0,0
RGS18,Rgs18,-2,1,-1,0.68932,0,0
RGS19,Rgs19,-5,-8,-13,0,0,0
RGS2,Rgs2,122,4,126,101.291262,60.833333,0
RGS20,Rgs20,0,5,5,0,0,0
RGS21,Rgs21,0,1,1,0,0,0
RGS22,Rgs22,10,-2,8,0,0,0
RGS3,Rgs3,-13,0,-13,1.582524,0,0
RGS4,Rgs4,-19,-12,-31,0,0,0
RGS5,Rgs5,7,4,11,0,0,0
RGS6,Rgs6,4,2,6,9.854369,0,0
RGS7,Rgs7,0,-1,-1,0,0,0
RGS7BP,Rgs7bp,0,2,2,0,0,0
RGS8,Rgs8,-4,5,1,0,0,0
RGS9,Rgs9,-2,1,-1,6.174757,0,0
RGS9BP,Rgs9bp,1,-1,0,4.466019,0,0
RGSL1,Rgsl1,12,-4,8,0,0,0
RHAG,Rhag,0,-6,-6,0,0,0
RHBDD1,Rhbdd1,6,0,6,19.165049,0,0
RHBDD2,Rhbdd2,11,-6,5,364.76699,60.041667,0
RHBDD3,Rhbdd3,11,-11,0,155.621359,37.791667,0
RHBDF1,Rhbdf1,-4,2,-2,2.359223,0,0
RHBDF2,Rhbdf2,2,5,7,7.184466,0,0
RHBDL1,Rhbdl1,15,7,22,0,0,0
RHBDL2,Rhbdl2,3,-5,-2,0,0,0
RHBDL3,Rhbdl3,5,-4,1,0,0,0
RHBG,Rhbg,-2,-2,-4,0,0,0
RHCG,Rhcg,6,-9,-3,0,0,0
RHD,Rhd,-1,-8,-9,0,0,0
RHEB,Rheb,7,-1,6,9.592233,0,0
RHEBL1,Rhebl1,18,-13,5,42.495146,0,0
RHNO1,Rhno1,6,-3,3,4.194175,0,0
RHO,Rho,5,5,10,0,0,0
RHOA,Rhoa,10,0,10,5.495146,0,0
RHOB,Rhob,26,0,26,2.864078,0,0
RHOBTB1,Rhobtb1,-1,-7,-8,11.165049,0,0
RHOBTB2,Rhobtb2,0,-1,-1,2.242718,0,0
RHOBTB3,Rhobtb3,6,-3,3,3.961165,0,0
RHOC,Rhoc,8,7,15,4.029126,0,0
RHOD,Rhod,4,5,9,0.825243,0,0
RHOF,Rhof,9,5,14,66.38835,0,0
RHOG,Rhog,4,-5,-1,6.563107,0,0
RHOH,Rhoh,3,-1,2,16.475728,0,0
RHOJ,Rhoj,-4,-3,-7,0,0,0
RHOQ,Rhoq,1,6,7,2.407767,0,0
RHOT1,Rhot1,2,-7,-5,5.660194,0,0
RHOT2,Rhot2,7,-8,-1,16.543689,0,0
RHOU,Rhou,5,4,9,0,0,0
RHOV,Rhov,-3,-1,-4,4.961165,0,0
RHPN1,Rhpn1,2,-4,-2,108.106796,0,0
RHPN2,Rhpn2,1,-1,0,0.854369,0,0
RIBC1,Ribc1,-4,-15,-19,3.621359,0,0
RIBC2,Ribc2,-8,-9,-17,0,0,0
RIC1,Ric1,2,-1,1,3.84466,0,0
RIC3,Ric3,0,0,0,0,0,0
RIC8A,Ric8a,7,-4,3,3.873786,0,0
RIC8B,Ric8b,8,-7,1,12,0,0
RICTOR,Rictor,-4,-3,-7,15.757282,0,0
RIDA,Rida,7,-3,4,8.262136,0,0
RIF1,Rif1,1,-4,-3,7.699029,0,0
RIIAD1,Riiad1,8,-2,6,5.883495,0,0
RILP,Rilp,4,2,6,2.961165,0,0
RILPL1,Rilpl1,14,3,17,0.834951,0,0
RILPL2,Rilpl2,-1,-5,-6,0,0,0
RIMBP2,Rimbp2,-1,0,-1,0,0,0
RIMBP3,Rimbp3,1,-3,-2,3.339806,0,0
RIMKLA,Rimkla,8,-4,4,2.805825,0,0
RIMKLB,Rimklb,7,5,12,0,0,0
RIMS1,Rims1,4,-2,2,5.533981,0,0
RIMS2,Rims2,4,-3,1,0.76699,0,0
RIMS3,Rims3,7,-5,2,2.048544,0,0
RIMS4,Rims4,1,3,4,0,0,0
RIN1,Rin1,-2,3,1,5.834951,0,0
RIN2,Rin2,-4,-5,-9,0,0,0
RIN3,Rin3,0,7,7,2.708738,0,0
RING1,Ring1,1,-4,-3,7.242718,0,0
RINL,Rinl,4,3,7,0,0,0
RINT1,Rint1,5,-5,0,10.757282,0,0
RIOK1,Riok1,0,-4,-4,2.640777,0,0
RIOK2,Riok2,-1,-2,-3,0.951456,0,0
RIOK3,Riok3,9,-2,7,2.368932,0,0
RIOX1,Riox1,-11,-5,-16,6.23301,0,0
RIOX2,Riox2,2,-9,-7,60.262136,0,0
RIPK1,Ripk1,1,-2,-1,12.553398,0,0
RIPK2,Ripk2,4,1,5,16.504854,0,0
RIPK3,Ripk3,-6,-12,-18,0,0,0
RIPK4,Ripk4,-6,0,-6,1.07767,0,0
RIPOR1,Ripor1,9,0,9,3.194175,0,0
RIPOR2,Ripor2,9,0,9,0,0,0
RIPOR3,Ripor3,-1,4,3,0,0,0
RIPPLY1,Ripply1,17,-2,15,0,0,0
RIPPLY2,Ripply2,-2,0,-2,0,0,0
RIPPLY3,Ripply3,5,7,12,0,0,0
RIT1,Rit1,8,-6,2,1.048544,0,0
RIT2,Rit2,5,-5,0,0,0,0
RITA1,Rita1,-1,-3,-4,7.174757,0,0
RLBP1,Rlbp1,-7,-2,-9,0,0,0
RLF,Rlf,8,-3,5,12.912621,0,0
RLIM,Rlim,3,-4,-1,0,0,0
RLN1,Rln1,-1,7,6,0,0,0
RLN3,Rln3,3,1,4,2.019417,0,0
RMC1,Rmc1,0,-4,-4,9.087379,0,0
RMDN1,Rmdn1,1,-3,-2,41.446602,0,0
RMDN2,Rmdn2,1,-3,-2,9.61165,0,0
RMDN3,Rmdn3,3,-3,0,7.097087,0,0
RMI1,Rmi1,-4,0,-4,10.699029,0,0
RMI2,Rmi2,-4,0,-4,0.92233,0,0
RMND1,Rmnd1,2,-7,-5,14.417476,0,0
RMND5A,Rmnd5a,8,0,8,5.864078,0,0
RMND5B,Rmnd5b,3,-4,-1,6.883495,0,0
RNASE1,Rnase1,1,-1,0,0,0,0
RNASE10,Rnase10,13,-11,2,0,0,0
RNASE11,Rnase11,2,-2,0,0,0,0
RNASE12,Rnase12,2,-1,1,0,0,0
RNASE13,Rnase13,6,3,9,0,0,0
RNASE4,Rnase4,0,2,2,16.174757,0,0
RNASE6,Rnase6,-9,-7,-16,0,0,0
RNASE9,Rnase9,-1,0,-1,0,0,0
RNASEH1,Rnaseh1,-1,-6,-7,8.776699,0,0
RNASEH2A,Rnaseh2a,1,-8,-7,9.951456,0,0
RNASEH2B,Rnaseh2b,2,-11,-9,5.048544,0,0
RNASEH2C,Rnaseh2c,3,-8,-5,9.475728,0,0
RNASEK,Rnasek,9,7,16,5.68932,0,0
RNASEL,Rnasel,0,6,6,0,0,0
RND1,Rnd1,24,-3,21,0,0,0
RND2,Rnd2,19,-2,17,1.980583,0,0
RND3,Rnd3,18,9,27,3.990291,0,0
RNF10,Rnf10,14,0,14,4.174757,0,0
RNF103,Rnf103,6,-7,-1,2.76699,0,0
RNF11,Rnf11,9,-1,8,5.970874,0,0
RNF111,Rnf111,4,-4,0,1.23301,0,0
RNF112,Rnf112,5,-9,-4,0,0,0
RNF114,Rnf114,4,-1,3,12.805825,0,0
RNF115,Rnf115,5,-6,-1,8.660194,0,0
RNF121,Rnf121,1,-10,-9,0,0,0
RNF122,Rnf122,10,0,10,0,0,0
RNF123,Rnf123,9,-2,7,0,0,0
RNF125,Rnf125,1,8,9,0.92233,0,0
RNF126,Rnf126,3,-10,-7,27.68932,0,0
RNF128,Rnf128,-3,5,2,2.466019,0,0
RNF13,Rnf13,8,-2,6,5.184466,0,0
RNF130,Rnf130,7,-2,5,16.067961,0,0
RNF133,Rnf133,30,-2,28,0,0,0
RNF135,Rnf135,-3,1,-2,5.504854,0,0
RNF138,Rnf138,3,-3,0,0.873786,0,0
RNF139,Rnf139,-3,-5,-8,33.223301,0,0
RNF14,Rnf14,4,-3,1,9.223301,0,0
RNF141,Rnf141,7,-12,-5,75.61165,0,0
RNF144A,Rnf144a,0,-2,-2,1.932039,0,0
RNF144B,Rnf144b,3,-4,-1,5.291262,0,0
RNF145,Rnf145,4,-6,-2,1.76699,0,0
RNF146,Rnf146,3,-7,-4,7.417476,0,0
RNF148,Rnf148,39,-6,33,0,0,0
RNF149,Rnf149,0,1,1,4.446602,0,0
RNF150,Rnf150,5,1,6,3.038835,0,0
RNF151,Rnf151,15,3,18,5.058252,0,0
RNF152,Rnf152,6,-2,4,0,0,0
RNF157,Rnf157,11,-6,5,3.932039,0,0
RNF165,Rnf165,3,0,3,0,0,0
RNF166,Rnf166,3,0,3,9.912621,0,0
RNF167,Rnf167,12,-5,7,4.679612,0,0
RNF168,Rnf168,2,1,3,8.106796,0,0
RNF169,Rnf169,4,-7,-3,10.252427,0,0
RNF17,Rnf17,3,1,4,0,0,0
RNF170,Rnf170,-1,-6,-7,1.009709,0,0
RNF180,Rnf180,-1,-4,-5,2.650485,0,0
RNF181,Rnf181,7,-1,6,0,0,0
RNF182,Rnf182,2,0,2,1.407767,0,0
RNF183,Rnf183,5,-1,4,0,0,0
RNF185,Rnf185,6,-1,5,0,0,0
RNF186,Rnf186,-3,2,-1,0,0,0
RNF187,Rnf187,8,-1,7,5.504854,0,0
RNF19A,Rnf19a,8,-2,6,17.951456,0,0
RNF19B,Rnf19b,5,-1,4,4.213592,0,0
RNF2,Rnf2,5,0,5,0,0,0
RNF20,Rnf20,9,-3,6,5.592233,0,0
RNF207,Rnf207,-1,1,0,4.815534,0,0
RNF208,Rnf208,9,2,11,3.184466,0,0
RNF212,Rnf212,-4,-1,-5,0,0,0
RNF212B,Rnf212b,-4,-3,-7,0,0,0
RNF213,Rnf213,10,0,10,3.699029,0,0
RNF214,Rnf214,9,-3,6,11.582524,0,0
RNF215,Rnf215,7,3,10,0,0,0
RNF216,Rnf216,16,-3,13,54.31068,0,0
RNF217,Rnf217,7,0,7,1.572816,0,0
RNF220,Rnf220,0,-6,-6,10.533981,0,0
RNF222,Rnf222,3,-3,0,0,0,0
RNF223,Rnf223,9,13,22,48.650485,0,0
RNF224,Rnf224,14,14,28,3.184466,0,0
RNF225,Rnf225,45,2,47,3.165049,0,0
RNF227,Rnf227,6,3,9,5.019417,0,0
RNF24,Rnf24,2,-3,-1,8.07767,0,0
RNF25,Rnf25,-4,-5,-9,0,0,0
RNF26,Rnf26,0,-4,-4,0,0,0
RNF31,Rnf31,-9,-3,-12,0,0,0
RNF32,Rnf32,3,-13,-10,57.592233,0,0
RNF34,Rnf34,-3,-3,-6,3.009709,0,0
RNF38,Rnf38,1,-5,-4,3.76699,0,0
RNF39,Rnf39,3,2,5,0,0,0
RNF4,Rnf4,9,-5,4,4.572816,0,0
RNF40,Rnf40,11,-5,6,15.07767,0,0
RNF41,Rnf41,7,-5,2,5.708738,0,0
RNF43,Rnf43,-5,-8,-13,9.504854,0,0
RNF44,Rnf44,10,1,11,9.106796,0,0
RNF5,Rnf5,2,-3,-1,2.15534,0,0
RNF6,Rnf6,4,-2,2,7.194175,0,0
RNF7,Rnf7,5,-8,-3,14.417476,0,0
RNF8,Rnf8,10,0,10,6.281553,0,0
RNFT1,Rnft1,3,-4,-1,32.563107,0,0
RNFT2,Rnft2,6,-3,3,8.165049,0,0
RNGTT,Rngtt,3,-2,1,3.475728,0,0
RNH1,Rnh1,6,1,7,6.466019,0,0
RNLS,Rnls,2,-13,-11,0,0,0
RNMT,Rnmt,7,1,8,10.252427,0,0
RNPC3,Rnpc3,1,-8,-7,1.281553,0,0
RNPEP,Rnpep,9,0,9,1.097087,0,0
RNPEPL1,Rnpepl1,6,4,10,1.631068,0,0
RNPS1,Rnps1,10,-5,5,5.427184,0,0
RO60,Ro60,3,1,4,6.495146,0,0
ROBO1,Robo1,10,-2,8,2.135922,0,0
ROBO2,Robo2,8,-1,7,0,0,0
ROBO3,Robo3,3,0,3,11.145631,0,0
ROBO4,Robo4,-1,9,8,0,0,0
ROCK1,Rock1,8,-2,6,1.76699,0,0
ROCK2,Rock2,6,-2,4,4.330097,0,0
ROGDI,Rogdi,3,-3,0,0.84466,0,0
ROM1,Rom1,4,-2,2,17.145631,0,0
ROMO1,Romo1,1,-1,0,13.572816,0,0
ROPN1,Ropn1,1,-3,-2,1.291262,0,0
ROPN1L,Ropn1l,23,-9,14,24.23301,0,0
ROR1,Ror1,2,2,4,4.165049,0,0
ROR2,Ror2,2,-2,0,0,0,0
RORA,Rora,12,0,12,2.485437,0,0
RORB,Rorb,-1,2,1,0,0,0
RORC,Rorc,-1,10,9,0,0,0
ROS1,Ros1,0,-4,-4,0,0,0
RP1,Rp1,1,-4,-3,0,0,0
RP1L1,Rp1l1,0,0,0,3.504854,0,0
RP2,Rp2,3,-5,-2,39,0,0
RP9,Rp9,10,-4,6,9.15534,0,0
RPA1,Rpa1,7,-3,4,3.582524,0,0
RPA2,Rpa2,3,0,3,0,0,0
RPA3,Rpa3,4,-3,1,0,0,0
RPAIN,Rpain,9,-1,8,34.854369,0,0
RPAP1,Rpap1,8,-5,3,7.320388,0,0
RPAP2,Rpap2,7,-9,-2,10.718447,0,0
RPAP3,Rpap3,4,-3,1,4.15534,0,0
RPE,Rpe,3,-2,1,1.242718,0,0
RPE65,Rpe65,20,-2,18,0,0,0
RPF1,Rpf1,5,-5,0,3.466019,0,0
RPF2,Rpf2,3,-5,-2,17,0,0
RPGR,Rpgr,-4,3,-1,12.592233,0,0
RPGRIP1,Rpgrip1,5,-11,-6,0,0,0
RPGRIP1L,Rpgrip1l,4,4,8,34.349515,0,0
RPH3A,Rph3a,15,-5,10,2.019417,0,0
RPH3AL,Rph3al,2,3,5,93.592233,58.125,0
RPIA,Rpia,3,-7,-4,12.019417,0,0
RPL10,Rpl10,1,-1,0,2.223301,0,0
RPL10A,Rpl10a,7,-3,4,26.572816,0,0
RPL10L,Rpl10l,1,2,3,0,0,0
RPL11,Rpl11,8,-3,5,3.378641,0,0
RPL12,Rpl12,2,-3,-1,19.640777,0,0
RPL13,Rpl13,7,2,9,4.223301,0,0
RPL13A,Rpl13a,0,-4,-4,6.417476,0,0
RPL14,Rpl14,3,-6,-3,2.660194,0,0
RPL15,Rpl15,6,-5,1,15.029126,0,0
RPL17,Rpl17,7,-2,5,5.669903,0,0
RPL18,Rpl18,10,-2,8,112.524272,9,0
RPL18A,Rpl18a,11,-3,8,3.708738,0,0
RPL19,Rpl19,9,-3,6,2.708738,0,0
RPL21,Rpl21,11,-3,8,4.174757,0,0
RPL22,Rpl22,9,-10,-1,15.728155,0,0
RPL22L1,Rpl22l1,-1,-7,-8,18.485437,0,0
RPL23,Rpl23,5,-4,1,2.747573,0,0
RPL23A,Rpl23a,9,-2,7,6.436893,0,0
RPL24,Rpl24,7,-3,4,7.543689,0,0
RPL26,Rpl26,3,-4,-1,10.970874,0,0
RPL27,Rpl27,2,-1,1,5.126214,0,0
RPL27A,Rpl27a,1,-2,-1,4.184466,0,0
RPL28,Rpl28,5,-2,3,14,0,0
RPL29,Rpl29,9,-4,5,60.087379,0,0
RPL3,Rpl3,5,-5,0,7.543689,0,0
RPL30,Rpl30,1,-4,-3,10.815534,0,0
RPL31,Rpl31,6,2,8,7.23301,0,0
RPL32,Rpl32,6,-8,-2,3.15534,0,0
RPL34,Rpl34,9,-1,8,0,0,0
RPL35,Rpl35,9,1,10,11.970874,0,0
RPL35A,Rpl35a,6,-10,-4,1,0,0
RPL36,Rpl36,7,-4,3,9.941748,0,0
RPL36A,Rpl36a,6,-3,3,3.106796,0,0
RPL36AL,Rpl36al,3,-3,0,8.281553,0,0
RPL37,Rpl37,-1,-8,-9,20.912621,0,0
RPL37A,Rpl37a,3,-4,-1,3.601942,0,0
RPL38,Rpl38,5,-5,0,10.067961,0,0
RPL39,Rpl39,7,0,7,67.009709,14.708333,0
RPL39L,Rpl39l,10,-11,-1,2.718447,0,0
RPL3L,Rpl3l,49,3,52,21.058252,0,0
RPL4,Rpl4,8,-5,3,1.252427,0,0
RPL41,Rpl41,5,-1,4,23.029126,0,0
RPL5,Rpl5,8,-4,4,9.495146,0,0
RPL6,Rpl6,8,-1,7,17.116505,0,0
RPL7,Rpl7,9,0,9,10.320388,0,0
RPL7A,Rpl7a,9,-4,5,2,0,0
RPL7L1,Rpl7l1,5,3,8,0,0,0
RPL8,Rpl8,8,-4,4,15.631068,0,0
RPL9,Rpl9,9,-3,6,0,0,0
RPLP0,Rplp0,7,0,7,3.398058,0,0
RPLP1,Rplp1,5,-6,-1,5.165049,0,0
RPLP2,Rplp2,11,-1,10,2.582524,0,0
RPN1,Rpn1,11,-3,8,24.203883,0,0
RPN2,Rpn2,9,-6,3,12.640777,0,0
RPP14,Rpp14,-4,-2,-6,4.718447,0,0
RPP21,Rpp21,4,-3,1,3.854369,0,0
RPP25,Rpp25,-2,0,-2,0,0,0
RPP25L,Rpp25l,-2,-6,-8,4.728155,0,0
RPP30,Rpp30,6,-8,-2,2.029126,0,0
RPP38,Rpp38,0,-5,-5,31.436893,0,0
RPP40,Rpp40,-5,-2,-7,9.029126,0,0
RPRD1A,Rprd1a,10,2,12,0,0,0
RPRD1B,Rprd1b,7,-2,5,6.019417,0,0
RPRD2,Rprd2,9,-7,2,3.07767,0,0
RPRM,Rprm,-1,5,4,4.854369,0,0
RPRML,Rprml,-5,3,-2,18.747573,0,0
RPS10,Rps10,5,-1,4,3.320388,0,0
RPS11,Rps11,7,-7,0,15.378641,0,0
RPS12,Rps12,8,-9,-1,7.048544,0,0
RPS13,Rps13,10,-6,4,4.097087,0,0
RPS14,Rps14,11,-1,10,5.019417,0,0
RPS15,Rps15,8,-1,7,8.76699,0,0
RPS15A,Rps15a,8,-5,3,4.854369,0,0
RPS16,Rps16,11,-1,10,5.524272,0,0
RPS17,Rps17,9,-2,7,0,0,0
RPS18,Rps18,11,4,15,11.126214,0,0
RPS19,Rps19,7,-6,1,6.854369,0,0
RPS19BP1,Rps19bp1,3,-1,2,0,0,0
RPS2,Rps2,8,-2,6,5.058252,0,0
RPS20,Rps20,4,-3,1,12.281553,0,0
RPS21,Rps21,9,-1,8,3.378641,0,0
RPS23,Rps23,5,-7,-2,4.854369,0,0
RPS24,Rps24,4,-4,0,15.126214,0,0
RPS25,Rps25,5,-5,0,0,0,0
RPS26,Rps26,8,-6,2,6.92233,0,0
RPS27,Rps27,6,-5,1,2.174757,0,0
RPS27A,Rps27a,8,-7,1,0,0,0
RPS27L,Rps27l,5,-6,-1,1.524272,0,0
RPS28,Rps28,6,-6,0,10.941748,0,0
RPS29,Rps29,4,-3,1,105.407767,9.75,0
RPS3,Rps3,9,-4,5,10.854369,0,0
RPS4X,Rps4x,4,-1,3,7.68932,0,0
RPS5,Rps5,9,-4,5,2.815534,0,0
RPS6,Rps6,6,-3,3,5.495146,0,0
RPS6KA1,Rps6ka1,0,-7,-7,4.747573,0,0
RPS6KA2,Rps6ka2,3,-8,-5,4.019417,0,0
RPS6KA3,Rps6ka3,1,-6,-5,3.776699,0,0
RPS6KA5,Rps6ka5,4,-10,-6,8,0,0
RPS6KA6,Rps6ka6,0,-2,-2,1.961165,0,0
RPS6KB1,Rps6kb1,10,-4,6,14.339806,0,0
RPS6KB2,Rps6kb2,3,-8,-5,12.398058,0,0
RPS6KC1,Rps6kc1,4,-6,-2,6.38835,0,0
RPS6KL1,Rps6kl1,-4,-5,-9,0,0,0
RPS7,Rps7,4,2,6,22.446602,0,0
RPS8,Rps8,8,-4,4,5.067961,0,0
RPS9,Rps9,10,-6,4,0,0,0
RPSA,Rpsa,10,-6,4,2.291262,0,0
RPTN,Rptn,0,0,0,0,0,0
RPTOR,Rptor,2,0,2,4.533981,0,0
RPUSD1,Rpusd1,1,-7,-6,0,0,0
RPUSD2,Rpusd2,-14,-8,-22,18.640777,0,0
RPUSD3,Rpusd3,5,0,5,7.07767,0,0
RPUSD4,Rpusd4,9,-3,6,7.650485,0,0
RRAD,Rrad,155,18,173,42.524272,24.958333,0
RRAGA,Rraga,5,-5,0,3.067961,0,0
RRAGB,Rragb,3,-5,-2,0,0,0
RRAGC,Rragc,6,2,8,5.135922,0,0
RRAGD,Rragd,9,12,21,0.708738,0,0
RRAS,Rras,5,-1,4,28.495146,0,0
RRAS2,Rras2,4,4,8,3.932039,0,0
RRBP1,Rrbp1,3,-1,2,8.854369,0,0
RREB1,Rreb1,4,-8,-4,0.883495,0,0
RRH,Rrh,40,11,51,0,0,0
RRM1,Rrm1,3,-4,-1,6.097087,0,0
RRM2,Rrm2,2,-7,-5,17.475728,0,0
RRM2B,Rrm2b,-1,2,1,7.961165,0,0
RRN3,Rrn3,7,-2,5,6.592233,0,0
RRNAD1,Rrnad1,7,1,8,10.252427,0,0
RRP1,Rrp1,-2,-3,-5,11.359223,0,0
RRP12,Rrp12,9,-3,6,1.252427,0,0
RRP15,Rrp15,0,-1,-1,7.834951,0,0
RRP1B,Rrp1b,0,-1,-1,9.592233,0,0
RRP36,Rrp36,8,-3,5,4.145631,0,0
RRP7A,Rrp7a,5,-3,2,38.640777,0,0
RRP8,Rrp8,9,-3,6,19.601942,0,0
RRP9,Rrp9,-5,-4,-9,11.864078,0,0
RRS1,Rrs1,2,0,2,6.757282,0,0
RS1,Rs1,0,-1,-1,30.873786,0,0
RSAD1,Rsad1,-1,-4,-5,24.106796,3.708333,0
RSAD2,Rsad2,4,8,12,0,0,0
RSBN1,Rsbn1,15,-3,12,0,0,0
RSBN1L,Rsbn1l,0,-2,-2,13.660194,0,0
RSC1A1,Rsc1a1,-26,0,-26,0,0,0
RSF1,Rsf1,2,-4,-2,5.446602,0,0
RSKR,Rskr,10,-3,7,0,0,0
RSL1D1,Rsl1d1,7,0,7,12.514563,0,0
RSL24D1,Rsl24d1,9,-1,8,2.427184,0,0
RSPH1,Rsph1,4,-3,1,29.009709,0,0
RSPH10B,Rsph10b,58,-4,54,0,0,0
RSPH14,Rsph14,23,-7,16,94.563107,0,0
RSPH4A,Rsph4a,-1,-2,-3,2.747573,0,0
RSPH6A,Rsph6a,21,-1,20,1.524272,0,0
RSPH9,Rsph9,8,-8,0,0,0,0
RSPO1,Rspo1,-5,-3,-8,0,0,0
RSPO2,Rspo2,5,-8,-3,0,0,0
RSPO3,Rspo3,-6,2,-4,0,0,0
RSPO4,Rspo4,-1,-2,-3,0.76699,0,0
RSPRY1,Rspry1,7,-3,4,2.873786,0,0
RSRC1,Rsrc1,7,-7,0,8.893204,0,0
RSRC2,Rsrc2,6,-4,2,0,0,0
RSRP1,Rsrp1,18,20,38,3.398058,0,0
RSU1,Rsu1,2,-1,1,1.38835,0,0
RTBDN,Rtbdn,7,3,10,6.378641,0,0
RTCA,Rtca,2,-3,-1,2.805825,0,0
RTCB,Rtcb,4,-7,-3,0,0,0
RTEL1,Rtel1,9,-7,2,26.126214,0,0
RTF1,Rtf1,-1,-6,-7,4.786408,0,0
RTF2,Rtf2,9,-3,6,78.980583,0,0
RTKN,Rtkn,-5,-8,-13,5.23301,0,0
RTKN2,Rtkn2,3,-4,-1,20.631068,8.125,0
RTL1,Rtl1,-2,0,-2,0,0,0
RTL10,Rtl10,-10,-12,-22,4.456311,0,0
RTL3,Rtl3,0,2,2,0,0,0
RTL4,Rtl4,0,5,5,1.456311,0,0
RTL5,Rtl5,6,1,7,9.485437,0,0
RTL6,Rtl6,-1,-3,-4,11.873786,0,0
RTL8A,Rtl8a,5,6,11,3.320388,0,0
RTL8B,Rtl8b,0,2,2,0,0,0
RTL8C,Rtl8c,4,-13,-9,4.718447,0,0
RTL9,Rtl9,0,1,1,0,0,0
RTN1,Rtn1,5,-7,-2,22.864078,0,0
RTN2,Rtn2,0,-5,-5,1.213592,0,0
RTN3,Rtn3,7,-1,6,9.252427,0,0
RTN4,Rtn4,9,4,13,31.019417,0,0
RTN4IP1,Rtn4ip1,-8,-5,-13,1.23301,0,0
RTN4R,Rtn4r,1,-1,0,0,0,0
RTN4RL1,Rtn4rl1,5,3,8,5.019417,0,0
RTN4RL2,Rtn4rl2,4,-1,3,2.019417,0,0
RTP1,Rtp1,-1,-7,-8,0,0,0
RTP2,Rtp2,1,0,1,0,0,0
RTP3,Rtp3,-16,-4,-20,0.980583,0,0
RTP4,Rtp4,-3,1,-2,1.893204,0,0
RTRAF,Rtraf,9,-6,3,11.174757,0,0
RTTN,Rttn,4,-2,2,32.456311,0,0
RUBCN,Rubcn,7,0,7,9.84466,0,0
RUBCNL,Rubcnl,1,-2,-1,0,0,0
RUFY1,Rufy1,7,-4,3,48.009709,0,0
RUFY2,Rufy2,3,-5,-2,54.504854,5.75,0
RUFY3,Rufy3,7,0,7,7.31068,0,0
RUFY4,Rufy4,0,3,3,0,0,0
RUNDC1,Rundc1,0,-1,-1,45.417476,0,0
RUNDC3A,Rundc3a,7,-2,5,0,0,0
RUNDC3B,Rundc3b,4,4,8,1.640777,0,0
RUNX1,Runx1,4,4,8,1.174757,0,0
RUNX1T1,Runx1t1,17,0,17,2.009709,0,0
RUNX2,Runx2,-2,-8,-10,1.116505,0,0
RUNX3,Runx3,10,-5,5,13.553398,0,0
RUSC1,Rusc1,3,-1,2,3.456311,0,0
RUSC2,Rusc2,8,-8,0,3.048544,0,0
RUSF1,Rusf1,-2,-7,-9,9.883495,0,0
RUVBL1,Ruvbl1,5,-2,3,26.194175,0,0
RUVBL2,Ruvbl2,8,-5,3,32.194175,0,0
RWDD1,Rwdd1,2,-3,-1,21.68932,0,0
RWDD2A,Rwdd2a,2,-9,-7,8.650485,0,0
RWDD2B,Rwdd2b,3,-4,-1,1.126214,0,0
RWDD3,Rwdd3,-7,-17,-24,14.980583,0,0
RXFP1,Rxfp1,7,-5,2,0,0,0
RXFP2,Rxfp2,0,-10,-10,1.378641,0,0
RXFP3,Rxfp3,2,-2,0,0,0,0
RXFP4,Rxfp4,14,0,14,0,0,0
RXRA,Rxra,5,-3,2,54.368932,0,0
RXRB,Rxrb,6,-5,1,0,0,0
RXRG,Rxrg,3,-4,-1,0,0,0
RXYLT1,Rxylt1,-2,-5,-7,8.621359,0,0
RYBP,Rybp,12,-5,7,2.262136,0,0
RYK,Ryk,5,0,5,5.087379,0,0
RYR1,Ryr1,8,-1,7,0,0,0
RYR2,Ryr2,4,2,6,2.533981,0,0
RYR3,Ryr3,1,-6,-5,0,0,0
S100A1,S100a1,-15,-5,-20,1.951456,0,0
S100A10,S100a10,5,3,8,11.262136,0,0
S100A11,S100a11,8,-1,7,3.592233,0,0
S100A13,S100a13,5,5,10,3.563107,0,0
S100A14,S100a14,45,2,47,6.970874,0,0
S100A16,S100a16,7,-4,3,1.747573,0,0
S100A2,S100a2,-2,-5,-7,14.737864,0,0
S100A3,S100a3,-10,18,8,0,0,0
S100A4,S100a4,-4,-4,-8,0,0,0
S100A5,S100a5,-1,5,4,0,0,0
S100A6,S100a6,3,-8,-5,0,0,0
S100A7A,S100a7a,9,3,12,0,0,0
S100A7L2,S100a7l2,-5,-3,-8,0,0,0
S100A8,S100a8,3,5,8,0,0,0
S100A9,S100a9,5,20,25,0,0,0
S100B,S100b,6,-6,0,0,0,0
S100G,S100g,8,-6,2,0,0,0
S100PBP,S100pbp,10,-9,1,15.281553,0,0
S100Z,S100z,14,6,20,1.300971,0,0
S1PR1,S1pr1,12,1,13,0,0,0
S1PR2,S1pr2,-1,-9,-10,14.38835,0,0
S1PR3,S1pr3,9,-5,4,0,0,0
S1PR4,S1pr4,-4,0,-4,0,0,0
S1PR5,S1pr5,-27,-4,-31,0,0,0
SAA1,Saa1,8,17,25,0,0,0
SAA2,Saa2,1,7,8,0,0,0
SAA4,Saa4,-2,0,-2,0,0,0
SAAL1,Saal1,-1,-7,-8,14.84466,0,0
SAC3D1,Sac3d1,1,-4,-3,1.951456,0,0
SACM1L,Sacm1l,2,-7,-5,55.631068,0,0
SACS,Sacs,5,-7,-2,2.339806,0,0
SAE1,Sae1,9,-4,5,13.543689,0,0
SAFB,Safb,7,-4,3,16.106796,0,0
SAFB2,Safb2,4,-6,-2,16.106796,0,0
SAG,Sag,26,-8,18,0,0,0
SALL1,Sall1,2,2,4,0,0,0
SALL2,Sall2,2,-2,0,2.23301,0,0
SALL3,Sall3,14,0,14,3.757282,0,0
SALL4,Sall4,4,-2,2,1.893204,0,0
SAMD1,Samd1,11,6,17,9.223301,0,0
SAMD10,Samd10,-5,-7,-12,6.854369,0,0
SAMD11,Samd11,27,-4,23,1.009709,0,0
SAMD12,Samd12,6,1,7,1.184466,0,0
SAMD13,Samd13,-8,-3,-11,3.951456,0,0
SAMD14,Samd14,27,-4,23,4.495146,0,0
SAMD15,Samd15,1,-1,0,7.660194,0,0
SAMD3,Samd3,8,-11,-3,1.38835,0,0
SAMD4B,Samd4b,8,-2,6,46.417476,0,0
SAMD5,Samd5,-3,0,-3,2.601942,0,0
SAMD7,Samd7,6,-7,-1,0,0,0
SAMD8,Samd8,4,-4,0,29.893204,4.583333,0
SAMD9L,Samd9l,-11,-4,-15,0,0,0
SAMHD1,Samhd1,6,1,7,1.640777,0,0
SAMM50,Samm50,5,-2,3,3.23301,0,0
SAMSN1,Samsn1,0,-1,-1,1.941748,0,0
SAP130,Sap130,4,-4,0,5.019417,0,0
SAP18,Sap18,10,1,11,0,0,0
SAP25,Sap25,15,-2,13,24.563107,0,0
SAP30,Sap30,5,-4,1,1.864078,0,0
SAP30BP,Sap30bp,8,0,8,6.747573,0,0
SAP30L,Sap30l,4,-1,3,0,0,0
SAPCD1,Sapcd1,-32,-11,-43,0,0,0
SAPCD2,Sapcd2,-8,0,-8,3.165049,0,0
SAR1A,Sar1a,6,-3,3,16.378641,3.75,0
SAR1B,Sar1b,7,-11,-4,19.631068,0,0
SARAF,Saraf,13,3,16,97.951456,0,0
SARDH,Sardh,3,-1,2,7.68932,0,0
SARM1,Sarm1,10,0,10,0,0,0
SARNP,Sarnp,9,-7,2,0,0,0
SARS2,Sars2,-8,-5,-13,0,0,0
SART1,Sart1,8,-2,6,12.436893,0,0
SART3,Sart3,1,-1,0,6.883495,0,0
SASH1,Sash1,9,5,14,5.786408,0,0
SASH3,Sash3,-2,2,0,0,0,0
SASS6,Sass6,-5,-11,-16,3.203883,0,0
SAT1,Sat1,13,9,22,0,0,0
SAT2,Sat2,6,1,7,0,0,0
SATB1,Satb1,7,1,8,3.475728,0,0
SATB2,Satb2,5,-3,2,0.941748,0,0
SATL1,Satl1,-1,-3,-4,0,0,0
SAV1,Sav1,10,0,10,17.660194,0,0
SAXO1,Saxo1,4,-2,2,3.067961,0,0
SAXO2,Saxo2,5,-3,2,33.271845,0,0
SAYSD1,Saysd1,0,-7,-7,10.553398,0,0
SBDS,Sbds,3,-1,2,2.339806,0,0
SBF1,Sbf1,6,-3,3,1.669903,0,0
SBF2,Sbf2,-1,0,-1,8.359223,0,0
SBK1,Sbk1,10,4,14,0,0,0
SBK2,Sbk2,3,7,10,0,0,0
SBK3,Sbk3,9,11,20,16.640777,0,0
SBNO1,Sbno1,7,-4,3,2.058252,0,0
SBNO2,Sbno2,4,6,10,11.145631,0,0
SBSN,Sbsn,51,9,60,0,0,0
SBSPON,Sbspon,3,1,4,0,0,0
SC5D,Sc5d,5,3,8,2.902913,0,0
SCAF1,Scaf1,6,-1,5,28.495146,0,0
SCAF11,Scaf11,8,-1,7,12.23301,0,0
SCAF4,Scaf4,9,-4,5,2.737864,0,0
SCAF8,Scaf8,6,-2,4,12.970874,0,0
SCAI,Scai,-1,-1,-2,4.553398,0,0
SCAMP1,Scamp1,5,-3,2,9.135922,0,0
SCAMP2,Scamp2,6,-10,-4,2.291262,0,0
SCAMP3,Scamp3,8,1,9,3.067961,0,0
SCAMP4,Scamp4,7,-8,-1,8.378641,0,0
SCAMP5,Scamp5,9,-8,1,1.708738,0,0
SCAND1,Scand1,-3,-4,-7,28.135922,3.875,114
SCAP,Scap,7,-3,4,10.834951,0,0
SCAPER,Scaper,7,0,7,2,0,0
SCARA3,Scara3,14,-1,13,41.31068,0,0
SCARA5,Scara5,2,-2,0,0,0,0
SCARB1,Scarb1,10,1,11,7.640777,0,0
SCARB2,Scarb2,4,4,8,8.058252,0,0
SCARF1,Scarf1,-1,1,0,2.961165,0,0
SCARF2,Scarf2,-2,0,-2,0,0,0
SCART1,Scart1,1,3,4,0,0,0
SCCPDH,Sccpdh,1,-7,-6,5.582524,0,0
SCEL,Scel,1,1,2,0,0,0
SCFD1,Scfd1,-1,-9,-10,10.135922,0,0
SCFD2,Scfd2,-3,3,0,0,0,0
SCG2,Scg2,15,5,20,1.058252,0,0
SCG3,Scg3,3,5,8,0,0,0
SCG5,Scg5,23,-5,18,0,0,0
SCGB1A1,Scgb1a1,-2,8,6,4.718447,0,0
SCGB1C1,Scgb1c1,10,11,21,2.31068,0,0
SCGB2A2,Scgb2a2,2,-1,1,0,0,0
SCGB2B2,Scgb2b2,-4,-2,-6,0,0,0
SCGB3A1,Scgb3a1,8,0,8,0,0,0
SCGB3A2,Scgb3a2,23,-7,16,0,0,0
SCGN,Scgn,10,-2,8,0,0,0
SCHIP1,Schip1,26,7,33,0,0,0
SCIMP,Scimp,0,-4,-4,3.990291,0,0
SCIN,Scin,0,5,5,0,0,0
SCLT1,Sclt1,2,1,3,6.524272,0,0
SCLY,Scly,1,-2,-1,6.553398,0,0
SCMH1,Scmh1,2,-2,0,3.427184,0,0
SCML2,Scml2,2,3,5,0,0,0
SCML4,Scml4,2,4,6,7.38835,0,0
SCN10A,Scn10a,0,-1,-1,0,0,0
SCN11A,Scn11a,1,0,1,2.543689,0,0
SCN1A,Scn1a,3,-9,-6,0,0,0
SCN1B,Scn1b,1,2,3,1.592233,0,0
SCN2A,Scn2a,-2,-6,-8,0,0,0
SCN2B,Scn2b,3,-7,-4,0,0,0
SCN3A,Scn3a,6,1,7,0,0,0
SCN3B,Scn3b,3,7,10,0,0,0
SCN4A,Scn4a,7,1,8,0,0,0
SCN4B,Scn4b,7,0,7,0,0,0
SCN5A,Scn5a,-4,9,5,17.15534,0,0
SCN7A,Scn7a,44,3,47,0,0,0
SCN8A,Scn8a,4,1,5,9.728155,0,0
SCN9A,Scn9a,2,-2,0,7.213592,0,0
SCNM1,Scnm1,6,-3,3,11.553398,0,0
SCNN1A,Scnn1a,-1,0,-1,0,0,0
SCNN1B,Scnn1b,1,1,2,0.990291,0,0
SCNN1G,Scnn1g,0,3,3,2.543689,0,0
SCO1,Sco1,4,0,4,5.553398,0,0
SCO2,Sco2,-4,-8,-12,1,0,0
SCOC,Scoc,6,-9,-3,23,0,0
SCP2,Scp2,7,-4,3,4.524272,0,0
SCP2D1,Scp2d1,0,-3,-3,0,0,0
SCPEP1,Scpep1,3,-4,-1,1.92233,0,0
SCRG1,Scrg1,6,7,13,0,0,0
SCRIB,Scrib,9,-3,6,27.15534,0,0
SCRN1,Scrn1,10,0,10,3.84466,0,0
SCRN2,Scrn2,-1,-4,-5,6.106796,0,0
SCRN3,Scrn3,3,-2,1,1.213592,0,0
SCRT1,Scrt1,9,-1,8,4.699029,0,0
SCRT2,Scrt2,-2,1,-1,2.805825,0,0
SCT,Sct,31,9,40,0,0,0
SCTR,Sctr,17,-3,14,0,0,0
SCUBE1,Scube1,15,-1,14,30.68932,0,0
SCUBE2,Scube2,36,3,39,0,0,0
SCUBE3,Scube3,-1,0,-1,0.932039,0,0
SCX,Scx,3,12,15,6.737864,0,0
SCYL1,Scyl1,2,-1,1,5.456311,0,0
SCYL2,Scyl2,3,-3,0,11.834951,0,0
SCYL3,Scyl3,-4,-3,-7,23.660194,0,0
SDAD1,Sdad1,4,-7,-3,1.165049,0,0
SDC1,Sdc1,2,-2,0,6.902913,0,0
SDC2,Sdc2,11,1,12,0,0,0
SDC3,Sdc3,7,-1,6,2.048544,0,0
SDC4,Sdc4,-2,2,0,10.271845,0,0
SDCBP,Sdcbp,10,0,10,9.398058,0,0
SDCBP2,Sdcbp2,14,1,15,120.61165,0,0
SDCCAG8,Sdccag8,7,-1,6,4.456311,0,0
SDE2,Sde2,3,0,3,54.106796,0,0
SDF2,Sdf2,5,-3,2,0,0,0
SDF2L1,Sdf2l1,-1,-1,-2,0,0,0
SDF4,Sdf4,5,-3,2,3.145631,0,0
SDHA,Sdha,3,-7,-4,25.446602,0,0
SDHAF1,Sdhaf1,-7,-5,-12,2.339806,0,0
SDHAF2,Sdhaf2,8,2,10,30.466019,0,0
SDHAF3,Sdhaf3,-1,2,1,14.407767,0,0
SDHAF4,Sdhaf4,2,-7,-5,4.145631,0,0
SDHB,Sdhb,11,-6,5,3.854369,0,0
SDHC,Sdhc,10,-4,6,1.291262,0,0
SDHD,Sdhd,10,-3,7,4,0,0
SDK1,Sdk1,-5,0,-5,6.436893,0,0
SDK2,Sdk2,8,-3,5,11.786408,0,0
SDR16C5,Sdr16c5,1,0,1,1.757282,0,0
SDR39U1,Sdr39u1,1,-5,-4,1.009709,0,0
SDR42E1,Sdr42e1,1,-7,-6,0,0,0
SDR9C7,Sdr9c7,5,5,10,0,0,0
SDS,Sds,3,6,9,0,0,0
SDSL,Sdsl,7,9,16,3.281553,0,0
SEBOX,Sebox,5,-1,4,0,0,0
SEC11A,Sec11a,7,-4,3,5.067961,0,0
SEC11C,Sec11c,11,-4,7,3.417476,0,0
SEC13,Sec13,6,-1,5,35.961165,0,0
SEC14L1,Sec14l1,10,-2,8,18.029126,0,0
SEC14L2,Sec14l2,-7,-5,-12,1.368932,0,0
SEC14L3,Sec14l3,2,-1,1,0,0,0
SEC14L4,Sec14l4,0,3,3,0.834951,0,0
SEC14L5,Sec14l5,5,5,10,1.242718,0,0
SEC16A,Sec16a,8,-5,3,8.728155,0,0
SEC16B,Sec16b,2,-7,-5,1.019417,0,0
SEC22A,Sec22a,3,-1,2,8.252427,0,0
SEC22B,Sec22b,4,-2,2,8.76699,0,0
SEC22C,Sec22c,6,-7,-1,36.262136,0,0
SEC23A,Sec23a,5,-4,1,3.737864,0,0
SEC23B,Sec23b,8,-2,6,0.864078,0,0
SEC23IP,Sec23ip,-1,-4,-5,0,0,0
SEC24A,Sec24a,6,0,6,3.485437,0,0
SEC24B,Sec24b,-5,-5,-10,5.339806,0,0
SEC24C,Sec24c,6,-2,4,15.184466,0,0
SEC24D,Sec24d,0,0,0,5.825243,0,0
SEC31A,Sec31a,7,-5,2,8.23301,0,0
SEC31B,Sec31b,20,1,21,0,0,0
SEC61A1,Sec61a1,9,-3,6,10.23301,0,0
SEC61A2,Sec61a2,4,-8,-4,21.660194,0,0
SEC61B,Sec61b,8,7,15,4.708738,0,0
SEC61G,Sec61g,9,-7,2,2.815534,0,0
SEC62,Sec62,7,-2,5,16.504854,0,0
SEC63,Sec63,7,-3,4,1.019417,0,0
SECISBP2,Secisbp2,19,-7,12,15.436893,0,0
SECISBP2L,Secisbp2l,4,-1,3,6.213592,0,0
SEH1L,Seh1l,3,-6,-3,10.087379,0,0
SEL1L,Sel1l,8,-3,5,5.475728,0,0
SEL1L2,Sel1l2,4,-5,-1,1.951456,0,0
SEL1L3,Sel1l3,-10,2,-8,9.61165,0,0
SELE,Sele,4,-6,-2,0,0,0
SELENBP1,Selenbp1,9,2,11,4.669903,0,0
SELENOF,Selenbp2,6,-7,-1,0.805825,0,0
SELENOH,Selenof,6,-7,-1,40.058252,0,0
SELENOI,Selenoh,5,1,6,9.970874,0,0
SELENOK,Selenoi,8,-4,4,18.15534,0,0
SELENOM,Selenok,-5,-7,-12,1.106796,0,0
SELENON,Selenom,10,-3,7,0,0,0
SELENOO,Selenon,4,-2,2,0,0,0
SELENOP,Selenoo,8,-1,7,0,0,0
SELENOS,Selenop,6,5,11,5.407767,0,0
SELENOT,Selenos,8,-1,7,12.145631,0,0
SELENOV,Selenot,4,-7,-3,0,0,0
SELENOW,Selenov,10,-2,8,81.805825,0,0
SELL,Selenow,-4,0,-4,0,0,0
SELP,Sell,0,-4,-4,0,0,0
SELPLG,Selplg,53,12,65,1.262136,0,0
SEM1,Selplg,8,12,20,1.980583,0,0
SEMA3A,Sem1,9,-3,6,0,0,0
SEMA3B,Sema3a,2,-10,-8,4.058252,0,0
SEMA3C,Sema3b,-1,-10,-11,10.446602,0,0
SEMA3D,Sema3c,3,-3,0,4.864078,0,0
SEMA3E,Sema3d,4,-5,-1,1.407767,0,0
SEMA3F,Sema3e,6,-11,-5,1.980583,0,0
SEMA3G,Sema3f,3,-1,2,0,0,0
SEMA4A,Sema3g,67,2,69,0,0,0
SEMA4B,Sema4a,6,-14,-8,95.893204,0,0
SEMA4C,Sema4b,-6,-1,-7,1.864078,0,0
SEMA4D,Sema4c,44,-17,27,33.145631,0,0
SEMA4F,Sema4d,6,0,6,1.92233,0,0
SEMA4G,Sema4f,21,1,22,0,0,0
SEMA5A,Sema4g,4,-1,3,0.902913,0,0
SEMA5B,Sema5a,0,2,2,14.252427,0,0
SEMA6A,Sema5b,8,2,10,2.019417,0,0
SEMA6B,Sema6a,4,4,8,2.980583,0,0
SEMA6C,Sema6b,7,3,10,30.990291,0,0
SEMA6D,Sema6c,8,-1,7,0,0,0
SEMA7A,Sema6d,12,0,12,6.84466,0,0
SEMG1,Sema7a,6,3,9,0,0,0
SENP1,Senp1,6,-3,3,82.718447,0,0
SENP2,Senp2,6,3,9,7.31068,0,0
SENP3,Senp3,3,0,3,44.679612,0,0
SENP5,Senp5,4,-3,1,12.951456,0,0
SENP6,Senp6,5,1,6,9.087379,0,0
SENP7,Senp7,-1,-8,-9,1.31068,0,0
SENP8,Senp8,-1,-7,-8,4.796117,0,0
SEPHS1,Sephs1,9,-8,1,0.941748,0,0
SEPHS2,Sephs2,-11,-7,-18,5.728155,0,0
SEPSECS,Sepsecs,5,-11,-6,9.07767,0,0
SEPTIN1,Septin1,5,0,5,3.359223,0,0
SEPTIN10,Septin10,1,-5,-4,4.485437,0,0
SEPTIN11,Septin11,8,-1,7,5.621359,0,0
SEPTIN12,Septin12,28,-5,23,4.019417,0,0
SEPTIN14,Septin14,2,5,7,0,0,0
SEPTIN2,Septin2,11,-1,10,6.38835,0,0
SEPTIN3,Septin3,8,-3,5,0,0,0
SEPTIN4,Septin4,14,-13,1,5.533981,0,0
SEPTIN5,Septin5,0,-5,-5,12.601942,0,0
SEPTIN6,Septin6,3,-1,2,19.951456,0,0
SEPTIN7,Septin7,9,-6,3,9.834951,0,0
SEPTIN8,Septin8,5,-4,1,2.883495,0,0
SEPTIN9,Septin9,-2,4,2,58.058252,0,0
SERAC1,Serac1,2,-4,-2,0,0,0
SERBP1,Serbp1,11,0,11,7.349515,0,0
SERF2,Serf2,9,4,13,2.601942,0,0
SERGEF,Sergef,10,-7,3,7.048544,0,0
SERINC1,Serinc1,7,0,7,0,0,0
SERINC2,Serinc2,6,3,9,1.883495,0,0
SERINC3,Serinc3,2,-2,0,4.572816,0,0
SERINC4,Serinc4,68,-4,64,190.446602,45.666667,0
SERINC5,Serinc5,12,-3,9,4.621359,0,0
SERP1,Serp1,12,-1,11,18.504854,0,0
SERP2,Serp2,10,-9,1,21.31068,0,0
SERPINA10,Serpina10,3,10,13,0,0,0
SERPINA11,Serpina11,0,1,1,0,0,0
SERPINA12,Serpina12,0,-1,-1,0,0,0
SERPINA5,Serpina5,-2,7,5,3.495146,0,0
SERPINA6,Serpina6,-3,10,7,0,0,0
SERPINA7,Serpina7,8,-6,2,0,0,0
SERPINA9,Serpina9,-2,0,-2,0,0,0
SERPINB10,Serpinb10,9,1,10,0,0,0
SERPINB11,Serpinb11,1,1,2,0,0,0
SERPINB12,Serpinb12,0,0,0,0,0,0
SERPINB13,Serpinb13,1,-2,-1,0,0,0
SERPINB2,Serpinb2,-2,5,3,0,0,0
SERPINB5,Serpinb5,6,1,7,1.679612,0,0
SERPINB7,Serpinb7,3,-2,1,0,0,0
SERPINB8,Serpinb8,-6,-1,-7,2.145631,0,0
SERPINB9,Serpinb9,3,-1,2,0,0,0
SERPINC1,Serpinc1,72,0,72,0,0,0
SERPIND1,Serpind1,0,-2,-2,0,0,0
SERPINE1,Serpine1,17,10,27,3.495146,0,0
SERPINE2,Serpine2,8,10,18,5.893204,0,0
SERPINE3,Serpine3,7,5,12,0,0,0
SERPINF1,Serpinf1,17,-2,15,0,0,0
SERPINF2,Serpinf2,17,26,43,0,0,0
SERPING1,Serping1,0,12,12,0,0,0
SERPINH1,Serpinh1,119,19,138,297.330097,53.875,0
SERPINI1,Serpini1,3,-3,0,2.951456,0,0
SERPINI2,Serpini2,7,-3,4,0,0,0
SERTAD1,Sertad1,15,-5,10,46.38835,0,0
SERTAD2,Sertad2,6,-3,3,3.699029,0,0
SERTAD3,Sertad3,7,-14,-7,61.854369,0,0
SERTAD4,Sertad4,-6,0,-6,7.932039,0,0
SERTM1,Sertm1,-10,0,-10,0,0,0
SESN1,Sesn1,-6,-5,-11,8.941748,0,0
SESN2,Sesn2,28,6,34,7.330097,0,0
SESN3,Sesn3,95,-5,90,15.07767,0,0
SESTD1,Sestd1,6,-2,4,3.669903,0,0
SET,Set,9,0,9,8.281553,0,0
SETBP1,Setbp1,7,-3,4,0,0,0
SETD1A,Setd1a,3,-4,-1,6.932039,0,0
SETD1B,Setd1b,13,-3,10,1.427184,0,0
SETD2,Setd2,8,-3,5,4.349515,0,0
SETD3,Setd3,6,-8,-2,3.407767,0,0
SETD4,Setd4,-1,-6,-7,15.446602,0,0
SETD5,Setd5,11,-1,10,39.359223,0,0
SETD6,Setd6,4,1,5,3.194175,0,0
SETD7,Setd7,7,-1,6,3.339806,0,0
SETDB1,Setdb1,-1,-6,-7,7.68932,0,0
SETDB2,Setdb2,2,-8,-6,2.601942,0,0
SETMAR,Setmar,4,-9,-5,4.106796,0,0
SETX,Setx,4,-1,3,20.873786,0,0
SEZ6,Sez6,8,-6,2,0,0,0
SEZ6L,Sez6l,8,-4,4,7.737864,0,0
SEZ6L2,Sez6l2,3,-3,0,11.504854,0,0
SF1,Sf1,12,1,13,10.951456,0,0
SF3A1,Sf3a1,7,-3,4,56.941748,0,0
SF3A2,Sf3a2,7,-6,1,6.242718,0,0
SF3A3,Sf3a3,7,1,8,21.854369,0,0
SF3B1,Sf3b1,12,0,12,5.15534,0,0
SF3B2,Sf3b2,7,-1,6,9.524272,0,0
SF3B3,Sf3b3,7,-1,6,0,0,0
SF3B4,Sf3b4,10,0,10,4.533981,0,0
SF3B5,Sf3b5,10,-1,9,6.660194,0,0
SF3B6,Sf3b6,10,1,11,9.495146,0,0
SFI1,Sfi1,-1,-3,-4,25.805825,0,0
SFMBT1,Sfmbt1,11,-2,9,3.446602,0,0
SFMBT2,Sfmbt2,4,-13,-9,3.533981,0,0
SFN,Sfn,6,11,17,22.737864,7.583333,0
SFPQ,Sfpq,5,1,6,14.563107,0,0
SFR1,Sfr1,-4,-7,-11,1.116505,0,0
SFRP1,Sfrp1,6,2,8,7.650485,0,0
SFRP2,Sfrp2,-1,-1,-2,0,0,0
SFRP4,Sfrp4,1,8,9,7.747573,0,0
SFRP5,Sfrp5,2,9,11,2.291262,0,0
SFSWAP,Sfswap,9,-3,6,9.038835,0,0
SFT2D1,Sft2d1,3,-6,-3,0,0,0
SFT2D2,Sft2d2,2,2,4,11.582524,0,0
SFT2D3,Sft2d3,-5,-2,-7,58.300971,0,0
SFTA2,Sfta2,3,-5,-2,0,0,0
SFTPA1,Sftpa1,4,-2,2,0,0,0
SFTPB,Sftpb,10,1,11,0,0,0
SFTPC,Sftpc,2,1,3,2.281553,0,0
SFTPD,Sftpd,1,-2,-1,0,0,0
SFXN1,Sfxn1,5,-4,1,3.660194,0,0
SFXN2,Sfxn2,4,-2,2,25.330097,0,0
SFXN3,Sfxn3,8,0,8,0.825243,0,0
SFXN4,Sfxn4,-3,-2,-5,3.941748,0,0
SFXN5,Sfxn5,9,-10,-1,17.669903,0,0
SGCA,Sgca,7,2,9,7.398058,0,0
SGCB,Sgcb,3,-11,-8,3.097087,0,0
SGCD,Sgcd,-1,-6,-7,0,0,0
SGCE,Sgce,6,-7,-1,1.747573,0,0
SGCG,Sgcg,-1,2,1,0,0,0
SGCZ,Sgcz,-1,0,-1,0,0,0
SGF29,Sgf29,8,-7,1,10.398058,0,0
SGIP1,Sgip1,-3,0,-3,0,0,0
SGK1,Sgk1,18,4,22,4.718447,0,0
SGK2,Sgk2,7,-8,-1,0,0,0
SGK3,Sgk3,3,3,6,14.407767,0,0
SGMS1,Sgms1,3,2,5,17.145631,0,0
SGMS2,Sgms2,3,-17,-14,3.349515,0,0
SGO1,Sgo1,0,-3,-3,2.805825,0,0
SGPL1,Sgpl1,5,-2,3,18.524272,5.25,0
SGPP1,Sgpp1,3,2,5,4.902913,0,0
SGPP2,Sgpp2,-2,-12,-14,0,0,0
SGSH,Sgsh,7,1,8,5.669903,0,0
SGSM1,Sgsm1,9,-1,8,15.815534,0,0
SGSM2,Sgsm2,-1,-1,-2,25.368932,0,0
SGSM3,Sgsm3,13,-4,9,7.902913,0,0
SGTA,Sgta,9,-3,6,28.407767,0,0
SGTB,Sgtb,0,-8,-8,1.165049,0,0
SH2B1,Sh2b1,9,-6,3,12.961165,0,91
SH2B2,Sh2b2,-3,-14,-17,1.417476,0,0
SH2B3,Sh2b3,2,-6,-4,4.252427,0,0
SH2D1A,Sh2d1a,5,-3,2,7.815534,0,0
SH2D2A,Sh2d2a,-1,4,3,5.456311,0,0
SH2D3C,Sh2d3c,-3,-7,-10,1.436893,0,0
SH2D4A,Sh2d4a,-3,-4,-7,26.990291,6,0
SH2D4B,Sh2d4b,0,6,6,0,0,0
SH2D5,Sh2d5,2,3,5,1.407767,0,0
SH2D6,Sh2d6,9,-9,0,2.640777,0,0
SH2D7,Sh2d7,-5,-10,-15,0,0,0
SH3BGR,Sh3bgr,20,3,23,75.61165,0,0
SH3BGRL,Sh3bgrl,9,-6,3,0,0,0
SH3BGRL2,Sh3bgrl2,3,-6,-3,3.106796,0,0
SH3BGRL3,Sh3bgrl3,11,0,11,30.291262,0,0
SH3BP1,Sh3bp1,-4,-5,-9,0,0,0
SH3BP2,Sh3bp2,4,-6,-2,3.893204,0,0
SH3BP4,Sh3bp4,-21,-1,-22,2.737864,0,0
SH3BP5,Sh3bp5,7,-2,5,5.456311,0,0
SH3BP5L,Sh3bp5l,9,-2,7,8.135922,0,0
SH3D19,Sh3d19,5,2,7,2.68932,0,0
SH3D21,Sh3d21,-1,-5,-6,1.038835,0,0
SH3GL1,Sh3gl1,8,1,9,14.048544,0,0
SH3GL2,Sh3gl2,0,2,2,0,0,0
SH3GL3,Sh3gl3,-2,5,3,0.902913,0,0
SH3GLB1,Sh3glb1,3,-1,2,9.223301,0,0
SH3GLB2,Sh3glb2,2,-2,0,2.048544,0,0
SH3KBP1,Sh3kbp1,7,-3,4,70.271845,6.208333,0
SH3PXD2A,Sh3pxd2a,12,-1,11,1.174757,0,0
SH3PXD2B,Sh3pxd2b,5,-3,2,7.262136,0,0
SH3RF1,Sh3rf1,0,2,2,6.242718,0,0
SH3RF2,Sh3rf2,1,-4,-3,8.815534,0,0
SH3RF3,Sh3rf3,7,1,8,8.679612,0,0
SH3TC1,Sh3tc1,-16,-1,-17,2.980583,0,0
SH3TC2,Sh3tc2,-8,-5,-13,14.165049,0,0
SH3YL1,Sh3yl1,7,-8,-1,6.980583,0,0
SHANK1,Shank1,2,5,7,3.621359,0,0
SHANK2,Shank2,0,-1,-1,1.165049,0,0
SHANK3,Shank3,3,4,7,0,0,0
SHARPIN,Sharpin,0,-2,-2,0,0,0
SHB,Shb,8,3,11,1.359223,0,0
SHBG,Shbg,8,6,14,2.582524,0,0
SHC1,Shc1,7,-2,5,102.291262,7.5,0
SHC2,Shc2,5,6,11,0.912621,0,0
SHC3,Shc3,1,-3,-2,0,0,0
SHC4,Shc4,13,-1,12,0,0,0
SHCBP1,Shcbp1,-1,-23,-24,3,0,0
SHCBP1L,Shcbp1l,4,-4,0,2.883495,0,0
SHD,Shd,2,3,5,0,0,0
SHE,She,1,1,2,0,0,0
SHF,Shf,-1,-4,-5,21.970874,0,104
SHFL,Shfl,2,2,4,4.873786,0,0
SHH,Shh,5,2,7,3.417476,0,0
SHISA2,Shisa2,35,0,35,1.31068,0,0
SHISA3,Shisa3,3,-13,-10,0,0,0
SHISA4,Shisa4,29,7,36,0,0,0
SHISA5,Shisa5,3,-2,1,2.650485,0,0
SHISA6,Shisa6,3,-1,2,0,0,0
SHISA7,Shisa7,4,1,5,0,0,0
SHISA8,Shisa8,3,-1,2,0,0,0
SHISA9,Shisa9,0,1,1,1.650485,0,0
SHISAL1,Shisal1,1,-4,-3,0,0,0
SHISAL2A,Shisal2a,2,5,7,0,0,0
SHISAL2B,Shisal2b,11,2,13,1.320388,0,0
SHKBP1,Shkbp1,11,-4,7,11.796117,0,0
SHLD1,Shld1,1,-6,-5,0,0,0
SHLD2,Shld2,6,-3,3,2.15534,0,0
SHLD3,Shld3,0,-9,-9,0,0,0
SHMT1,Shmt1,-2,-1,-3,3.825243,0,0
SHMT2,Shmt2,11,7,18,3.805825,0,0
SHOC1,Shoc1,7,-1,6,71.805825,0,0
SHOC2,Shoc2,6,-5,1,8.524272,0,0
SHOX2,Shox2,4,6,10,8.893204,0,0
SHPK,Shpk,3,2,5,4,0,0
SHPRH,Shprh,1,-5,-4,0.854369,0,0
SHQ1,Shq1,8,6,14,22.660194,0,0
SHROOM1,Shroom1,5,-14,-9,10.553398,0,0
SHROOM2,Shroom2,2,3,5,0,0,0
SHROOM3,Shroom3,2,-3,-1,0,0,0
SHROOM4,Shroom4,-1,-3,-4,0,0,0
SHTN1,Shtn1,5,3,8,6.038835,0,0
SIAE,Siae,11,-6,5,11.087379,0,0
SIAH2,Siah2,15,1,16,42.029126,5.958333,0
SIAH3,Siah3,-1,-6,-7,0,0,0
SIDT1,Sidt1,5,-2,3,8.776699,0,0
SIDT2,Sidt2,13,-11,2,5.058252,0,0
SIGIRR,Sigirr,-1,-10,-11,1.533981,0,0
SIGLEC1,Siglec1,0,6,6,1.31068,0,0
SIGLEC15,Siglec15,1,-7,-6,0,0,0
SIGMAR1,Sigmar1,2,-4,-2,3.058252,0,0
SIK1,Sik1,14,0,14,84.427184,0,0
SIK2,Sik2,4,-4,0,49.417476,0,0
SIK3,Sik3,8,2,10,149.941748,0,0
SIKE1,Sike1,0,-6,-6,5.184466,0,0
SIL1,Sil1,16,-4,12,3.495146,0,0
SIM1,Sim1,8,9,17,0,0,0
SIM2,Sim2,5,2,7,4.970874,0,0
SIMC1,Simc1,0,-3,-3,0.708738,0,0
SIN3A,Sin3a,-14,-2,-16,1.621359,0,0
SIN3B,Sin3b,5,-2,3,7.582524,0,0
SINHCAF,Sinhcaf,3,-1,2,9.194175,0,0
SIPA1,Sipa1,-3,-5,-8,1.135922,0,0
SIPA1L1,Sipa1l1,13,0,13,35.912621,0,0
SIPA1L2,Sipa1l2,10,2,12,4.495146,0,0
SIPA1L3,Sipa1l3,8,-3,5,4.009709,0,0
SIRPA,Sirpa,12,-4,8,25.650485,0,0
SIRT1,Sirt1,5,-2,3,24.097087,0,0
SIRT2,Sirt2,1,-2,-1,2.776699,0,0
SIRT3,Sirt3,8,-3,5,8.533981,0,0
SIRT4,Sirt4,26,-3,23,0,0,0
SIRT5,Sirt5,3,-2,1,10.320388,0,0
SIRT6,Sirt6,11,-11,0,12.485437,0,0
SIRT7,Sirt7,8,-3,5,0.92233,0,0
SIT1,Sit1,10,3,13,3.796117,0,0
SIVA1,Siva1,2,-5,-3,4.776699,0,0
SIX1,Six1,32,-5,27,16.815534,0,0
SIX2,Six2,15,-14,1,13.368932,0,0
SIX3,Six3,1,0,1,0,0,0
SIX4,Six4,13,-4,9,68,4.375,0
SIX5,Six5,4,7,11,29.194175,0,0
SIX6,Six6,2,1,3,0,0,0
SKA1,Ska1,4,-21,-17,0,0,0
SKA2,Ska2,7,-10,-3,0,0,0
SKA3,Ska3,4,-2,2,1.834951,0,0
SKAP1,Skap1,11,-3,8,0,0,0
SKAP2,Skap2,2,-7,-5,3.883495,0,0
SKI,Ski,5,-2,3,7.330097,0,0
SKIDA1,Skida1,8,-10,-2,14.572816,0,0
SKIL,Skil,14,1,15,9.76699,0,0
SKOR1,Skor1,0,1,1,0,0,0
SKOR2,Skor2,1,-2,-1,0,0,0
SKP1,Skp1,12,0,12,8.475728,0,0
SKP2,Skp2,7,-10,-3,10.68932,0,0
SLA,Sla,6,1,7,3.417476,0,0
SLA2,Sla2,2,-7,-5,0,0,0
SLAIN1,Slain1,5,-2,3,3,0,0
SLAIN2,Slain2,2,-2,0,2.961165,0,0
SLAMF1,Slamf1,3,-9,-6,0,0,0
SLAMF6,Slamf6,0,4,4,0,0,0
SLAMF7,Slamf7,6,-10,-4,0,0,0
SLAMF8,Slamf8,5,-7,-2,0.786408,0,0
SLAMF9,Slamf9,-1,-8,-9,0,0,0
SLBP,Slbp,10,-2,8,45.864078,0,0
SLC10A1,Slc10a1,10,5,15,0,0,0
SLC10A2,Slc10a2,3,-5,-2,0,0,0
SLC10A3,Slc10a3,-2,-3,-5,0.796117,0,0
SLC10A4,Slc10a4,4,4,8,0,0,0
SLC10A5,Slc10a5,14,11,25,0,0,0
SLC10A6,Slc10a6,3,11,14,0,0,0
SLC10A7,Slc10a7,3,-5,-2,3.61165,0,0
SLC11A1,Slc11a1,-7,-7,-14,0,0,0
SLC11A2,Slc11a2,9,-1,8,3.708738,0,0
SLC12A1,Slc12a1,1,-1,0,0,0,0
SLC12A2,Slc12a2,2,0,2,8.61165,0,0
SLC12A3,Slc12a3,-6,1,-5,0,0,0
SLC12A4,Slc12a4,7,-6,1,3.223301,0,0
SLC12A5,Slc12a5,2,-11,-9,0,0,0
SLC12A6,Slc12a6,9,-2,7,5.912621,0,0
SLC12A7,Slc12a7,10,-2,8,39.84466,0,0
SLC12A8,Slc12a8,-1,-1,-2,0,0,0
SLC12A9,Slc12a9,0,0,0,6.135922,0,0
SLC13A1,Slc13a1,2,0,2,0,0,0
SLC13A2,Slc13a2,1,4,5,0,0,0
SLC13A3,Slc13a3,16,5,21,9.048544,0,0
SLC13A4,Slc13a4,10,-5,5,0,0,0
SLC13A5,Slc13a5,0,-7,-7,0,0,0
SLC14A1,Slc14a1,-5,-2,-7,0,0,0
SLC14A2,Slc14a2,5,-4,1,3.495146,0,0
SLC15A1,Slc15a1,-1,-7,-8,0,0,0
SLC15A2,Slc15a2,8,8,16,0,0,0
SLC15A3,Slc15a3,-2,-1,-3,0,0,0
SLC15A4,Slc15a4,-6,-6,-12,5.495146,0,0
SLC15A5,Slc15a5,2,3,5,0,0,0
SLC16A1,Slc16a1,7,0,7,8.281553,0,0
SLC16A10,Slc16a10,0,1,1,3.621359,0,0
SLC16A11,Slc16a11,5,3,8,0,0,0
SLC16A12,Slc16a12,-1,-4,-5,0,0,0
SLC16A13,Slc16a13,-11,-1,-12,0,0,0
SLC16A14,Slc16a14,-13,0,-13,0,0,0
SLC16A2,Slc16a2,5,7,12,0,0,0
SLC16A3,Slc16a3,-2,-3,-5,0,0,0
SLC16A4,Slc16a4,11,0,11,0,0,0
SLC16A5,Slc16a5,-12,-7,-19,0,0,0
SLC16A6,Slc16a6,-7,-7,-14,6.980583,0,0
SLC16A7,Slc16a7,4,-5,-1,6.92233,0,0
SLC16A8,Slc16a8,0,-6,-6,5.116505,0,0
SLC16A9,Slc16a9,-2,-10,-12,3.019417,0,0
SLC17A1,Slc17a1,1,-2,-1,0,0,0
SLC17A2,Slc17a2,0,1,1,0,0,0
SLC17A3,Slc17a3,2,-2,0,0,0,0
SLC17A4,Slc17a4,1,6,7,0,0,0
SLC17A5,Slc17a5,3,-2,1,3.718447,0,0
SLC17A6,Slc17a6,0,-8,-8,0,0,0
SLC17A7,Slc17a7,7,-4,3,7.048544,0,0
SLC17A8,Slc17a8,38,-3,35,0,0,0
SLC17A9,Slc17a9,0,-8,-8,22.718447,0,0
SLC18A1,Slc18a1,5,9,14,0,0,0
SLC18A2,Slc18a2,4,-7,-3,0,0,0
SLC18A3,Slc18a3,-3,-1,-4,0.92233,0,0
SLC18B1,Slc18b1,-3,-5,-8,3.291262,0,0
SLC19A1,Slc19a1,4,-4,0,5.058252,0,0
SLC19A2,Slc19a2,3,0,3,4.76699,0,0
SLC19A3,Slc19a3,16,5,21,0,0,0
SLC1A1,Slc1a1,-1,6,5,0.834951,0,0
SLC1A2,Slc1a2,13,-9,4,0,0,0
SLC1A3,Slc1a3,47,-12,35,7.349515,0,0
SLC1A4,Slc1a4,7,6,13,13.621359,0,0
SLC1A5,Slc1a5,4,-2,2,1.631068,0,0
SLC1A6,Slc1a6,3,-10,-7,0,0,0
SLC1A7,Slc1a7,-1,3,2,3.165049,0,0
SLC20A1,Slc20a1,-2,4,2,2.135922,0,0
SLC20A2,Slc20a2,-3,-1,-4,8.601942,0,0
SLC22A1,Slc22a1,1,7,8,0,0,0
SLC22A12,Slc22a12,2,-1,1,0,0,0
SLC22A13,Slc22a13,13,5,18,0,0,0
SLC22A14,Slc22a14,18,6,24,0,0,0
SLC22A15,Slc22a15,0,-10,-10,0,0,0
SLC22A16,Slc22a16,12,-6,6,0,0,0
SLC22A17,Slc22a17,12,4,16,0,0,0
SLC22A18,Slc22a18,-1,-3,-4,8.417476,0,0
SLC22A2,Slc22a2,-2,-1,-3,0,0,0
SLC22A23,Slc22a23,11,-3,8,5.097087,0,0
SLC22A3,Slc22a3,-1,-5,-6,0,0,0
SLC22A4,Slc22a4,0,2,2,5.825243,0,0
SLC22A5,Slc22a5,4,-4,0,10.805825,0,0
SLC22A6,Slc22a6,4,1,5,0,0,0
SLC22A7,Slc22a7,9,0,9,0,0,0
SLC22A8,Slc22a8,3,3,6,0,0,0
SLC23A1,Slc23a1,13,7,20,0,0,0
SLC23A2,Slc23a2,-9,-2,-11,2.417476,0,0
SLC23A3,Slc23a3,20,11,31,0,0,0
SLC24A1,Slc24a1,0,-1,-1,18.631068,0,0
SLC24A2,Slc24a2,-4,4,0,0,0,0
SLC24A3,Slc24a3,4,-1,3,0,0,0
SLC24A4,Slc24a4,0,0,0,0,0,0
SLC24A5,Slc24a5,-8,-1,-9,0,0,0
SLC25A1,Slc25a1,7,-6,1,2.31068,0,0
SLC25A10,Slc25a10,5,-1,4,5.009709,0,0
SLC25A11,Slc25a11,9,-5,4,4.679612,0,0
SLC25A12,Slc25a12,-5,-3,-8,3.019417,0,0
SLC25A13,Slc25a13,-11,-11,-22,5.087379,0,0
SLC25A14,Slc25a14,6,1,7,24.660194,0,0
SLC25A15,Slc25a15,2,-5,-3,2.854369,0,0
SLC25A16,Slc25a16,1,1,2,19.281553,0,0
SLC25A17,Slc25a17,17,-2,15,4.708738,0,0
SLC25A18,Slc25a18,5,-1,4,0,0,0
SLC25A19,Slc25a19,6,-4,2,7.805825,0,0
SLC25A2,Slc25a2,-13,-9,-22,0,0,0
SLC25A20,Slc25a20,5,-1,4,5.980583,0,0
SLC25A21,Slc25a21,1,-2,-1,12.135922,0,0
SLC25A22,Slc25a22,5,-8,-3,2.660194,0,0
SLC25A23,Slc25a23,6,2,8,5.417476,0,0
SLC25A24,Slc25a24,4,-3,1,9.417476,0,0
SLC25A25,Slc25a25,4,2,6,10.932039,0,0
SLC25A26,Slc25a26,5,-5,0,12.097087,0,0
SLC25A27,Slc25a27,2,-6,-4,55.368932,0,0
SLC25A28,Slc25a28,-2,-8,-10,3.601942,0,0
SLC25A29,Slc25a29,8,-2,6,8.184466,0,0
SLC25A3,Slc25a3,8,-2,6,38.475728,0,0
SLC25A30,Slc25a30,-4,-3,-7,0,0,0
SLC25A31,Slc25a31,9,-4,5,0,0,0
SLC25A32,Slc25a32,-6,-1,-7,17.631068,0,0
SLC25A33,Slc25a33,1,-3,-2,6.009709,0,0
SLC25A34,Slc25a34,4,8,12,0,0,0
SLC25A35,Slc25a35,0,-7,-7,0.825243,0,0
SLC25A36,Slc25a36,-3,-1,-4,3.038835,0,0
SLC25A37,Slc25a37,2,2,4,6.621359,0,0
SLC25A38,Slc25a38,2,-3,-1,3.669903,0,0
SLC25A39,Slc25a39,8,-2,6,3.951456,0,0
SLC25A4,Slc25a4,3,-18,-15,5.339806,0,0
SLC25A40,Slc25a40,-1,-4,-5,7.029126,0,0
SLC25A41,Slc25a41,11,-11,0,0,0,0
SLC25A42,Slc25a42,2,-4,-2,6.932039,0,0
SLC25A43,Slc25a43,-3,-7,-10,4.679612,0,0
SLC25A44,Slc25a44,8,-5,3,1.320388,0,0
SLC25A45,Slc25a45,1,6,7,12.815534,0,0
SLC25A46,Slc25a46,5,-3,2,4.970874,0,0
SLC25A47,Slc25a47,11,-1,10,3.660194,0,0
SLC25A48,Slc25a48,4,-4,0,0,0,0
SLC25A5,Slc25a5,7,-1,6,5.524272,0,0
SLC25A51,Slc25a51,5,4,9,12.058252,0,0
SLC25A53,Slc25a53,5,-4,1,3.92233,0,0
SLC26A1,Slc26a1,-3,-3,-6,0,0,0
SLC26A11,Slc26a11,13,2,15,5.669903,0,0
SLC26A2,Slc26a2,1,-3,-2,6.378641,0,0
SLC26A3,Slc26a3,5,7,12,0,0,0
SLC26A4,Slc26a4,2,2,4,0,0,0
SLC26A5,Slc26a5,0,8,8,64.223301,0,0
SLC26A6,Slc26a6,3,-10,-7,3.145631,0,0
SLC26A7,Slc26a7,4,0,4,0,0,0
SLC26A8,Slc26a8,3,-10,-7,19.650485,0,0
SLC26A9,Slc26a9,0,2,2,0,0,0
SLC27A1,Slc27a1,8,-4,4,17.660194,0,0
SLC27A2,Slc27a2,4,2,6,0.805825,0,0
SLC27A3,Slc27a3,-3,4,1,0.854369,0,0
SLC27A4,Slc27a4,6,-7,-1,16.61165,0,0
SLC27A5,Slc27a5,11,5,16,10.864078,0,0
SLC27A6,Slc27a6,1,-1,0,0,0,0
SLC28A1,Slc28a1,8,2,10,0,0,0
SLC28A2,Slc28a2,4,2,6,0,0,0
SLC28A3,Slc28a3,-3,2,-1,0,0,0
SLC29A1,Slc29a1,7,-2,5,5.533981,0,0
SLC29A2,Slc29a2,-4,-7,-11,3.504854,0,0
SLC29A3,Slc29a3,2,-8,-6,2.640777,0,0
SLC29A4,Slc29a4,6,-1,5,0,0,0
SLC2A1,Slc2a1,-7,0,-7,4.757282,0,0
SLC2A10,Slc2a10,-12,1,-11,0,0,0
SLC2A12,Slc2a12,6,-2,4,0,0,0
SLC2A13,Slc2a13,4,-2,2,9.300971,0,0
SLC2A2,Slc2a2,2,5,7,0,0,0
SLC2A3,Slc2a3,3,-6,-3,5.776699,0,0
SLC2A4,Slc2a4,0,-4,-4,1.669903,0,0
SLC2A5,Slc2a5,16,-13,3,8.339806,0,0
SLC2A6,Slc2a6,4,-10,-6,0,0,0
SLC2A7,Slc2a7,0,1,1,0,0,0
SLC2A8,Slc2a8,-2,1,-1,3.145631,0,0
SLC2A9,Slc2a9,9,0,9,14.368932,0,0
SLC30A1,Slc30a1,12,7,19,3.291262,0,0
SLC30A10,Slc30a10,1,5,6,0,0,0
SLC30A2,Slc30a2,2,9,11,0,0,0
SLC30A3,Slc30a3,-2,-5,-7,0,0,0
SLC30A4,Slc30a4,4,0,4,0,0,0
SLC30A5,Slc30a5,6,-4,2,5.834951,0,0
SLC30A6,Slc30a6,5,1,6,9.563107,0,0
SLC30A7,Slc30a7,0,-5,-5,7.038835,0,0
SLC30A8,Slc30a8,3,1,4,0,0,0
SLC30A9,Slc30a9,4,1,5,2.495146,0,0
SLC31A1,Slc31a1,4,-2,2,9.135922,0,0
SLC31A2,Slc31a2,2,-1,1,6.38835,0,0
SLC32A1,Slc32a1,2,-1,1,0,0,0
SLC33A1,Slc33a1,3,-3,0,24.495146,0,0
SLC34A1,Slc34a1,4,-1,3,0,0,0
SLC34A2,Slc34a2,-1,-6,-7,0,0,0
SLC34A3,Slc34a3,10,0,10,0,0,0
SLC35A1,Slc35a1,-3,-6,-9,8.825243,0,0
SLC35A2,Slc35a2,5,0,5,11.621359,0,0
SLC35A3,Slc35a3,3,-9,-6,29.23301,0,0
SLC35A4,Slc35a4,2,-1,1,0,0,0
SLC35A5,Slc35a5,1,-4,-3,13.407767,0,0
SLC35B1,Slc35b1,7,0,7,4.980583,0,0
SLC35B2,Slc35b2,14,3,17,13.834951,0,0
SLC35B3,Slc35b3,8,-4,4,5.067961,0,0
SLC35B4,Slc35b4,1,-6,-5,7.145631,0,0
SLC35C1,Slc35c1,-4,0,-4,6.330097,0,0
SLC35C2,Slc35c2,8,-3,5,5.514563,0,0
SLC35D1,Slc35d1,4,-7,-3,3.601942,0,0
SLC35D2,Slc35d2,0,0,0,2.126214,0,0
SLC35D3,Slc35d3,13,5,18,0,0,0
SLC35E1,Slc35e1,3,3,6,20.92233,0,0
SLC35E3,Slc35e3,6,0,6,0,0,0
SLC35E4,Slc35e4,-7,2,-5,0,0,0
SLC35F1,Slc35f1,10,-4,6,0,0,0
SLC35F2,Slc35f2,-4,-5,-9,13.553398,0,0
SLC35F3,Slc35f3,2,-2,0,11.145631,0,0
SLC35F4,Slc35f4,1,0,1,0,0,0
SLC35F5,Slc35f5,0,-6,-6,18.407767,0,0
SLC35F6,Slc35f6,7,-2,5,18.495146,0,0
SLC35G1,Slc35g1,2,3,5,0,0,0
SLC35G2,Slc35g2,0,-7,-7,0.932039,0,0
SLC35G3,Slc35g3,5,-5,0,0,0,0
SLC36A1,Slc36a1,4,-2,2,8.475728,0,0
SLC36A2,Slc36a2,0,2,2,0,0,0
SLC36A3,Slc36a3,1,-2,-1,0,0,0
SLC36A4,Slc36a4,9,-9,0,2.68932,0,0
SLC37A1,Slc37a1,3,4,7,32.669903,0,0
SLC37A2,Slc37a2,2,-9,-7,1.524272,0,0
SLC37A3,Slc37a3,4,1,5,3.747573,0,0
SLC37A4,Slc37a4,2,-4,-2,3.912621,0,0
SLC38A1,Slc38a1,3,-2,1,3.398058,0,0
SLC38A10,Slc38a10,6,1,7,2.902913,0,0
SLC38A11,Slc38a11,2,3,5,0,0,0
SLC38A2,Slc38a2,-1,1,0,16.708738,0,0
SLC38A3,Slc38a3,8,12,20,0,0,0
SLC38A4,Slc38a4,-13,1,-12,0,0,0
SLC38A5,Slc38a5,-4,-2,-6,5.825243,0,0
SLC38A6,Slc38a6,2,-6,-4,9.815534,0,0
SLC38A7,Slc38a7,2,4,6,3.854369,0,0
SLC38A8,Slc38a8,9,6,15,8.407767,0,0
SLC38A9,Slc38a9,3,-10,-7,1.194175,0,0
SLC39A1,Slc39a1,3,-5,-2,66.893204,0,0
SLC39A10,Slc39a10,11,-1,10,6.427184,0,0
SLC39A11,Slc39a11,0,-9,-9,3.980583,0,0
SLC39A12,Slc39a12,1,-8,-7,0,0,0
SLC39A13,Slc39a13,2,-2,0,36.883495,0,0
SLC39A14,Slc39a14,9,-5,4,4.320388,0,0
SLC39A2,Slc39a2,9,-1,8,0,0,0
SLC39A3,Slc39a3,3,-3,0,17.135922,0,0
SLC39A4,Slc39a4,15,10,25,34.242718,0,0
SLC39A5,Slc39a5,15,1,16,0,0,0
SLC39A6,Slc39a6,5,-2,3,18.92233,0,0
SLC39A7,Slc39a7,4,-3,1,0,0,0
SLC39A8,Slc39a8,3,-1,2,4.174757,0,0
SLC39A9,Slc39a9,4,-3,1,2,0,0
SLC3A1,Slc3a1,9,-5,4,0,0,0
SLC3A2,Slc3a2,15,2,17,84.029126,7.75,0
SLC40A1,Slc40a1,6,3,9,0,0,0
SLC41A1,Slc41a1,9,-2,7,4.61165,0,0
SLC41A2,Slc41a2,0,-7,-7,6.145631,0,0
SLC41A3,Slc41a3,8,-9,-1,0,0,0
SLC43A1,Slc43a1,5,-2,3,0.718447,0,0
SLC43A2,Slc43a2,7,-4,3,0.640777,0,0
SLC43A3,Slc43a3,11,-6,5,5.23301,0,0
SLC44A1,Slc44a1,4,-1,3,39.990291,0,0
SLC44A2,Slc44a2,7,-3,4,2.84466,0,0
SLC44A3,Slc44a3,10,-1,9,2.466019,0,0
SLC44A4,Slc44a4,6,1,7,0,0,0
SLC44A5,Slc44a5,2,-4,-2,0,0,0
SLC45A1,Slc45a1,0,11,11,0,0,0
SLC45A2,Slc45a2,42,0,42,1.223301,0,0
SLC45A3,Slc45a3,-5,0,-5,4.368932,0,0
SLC45A4,Slc45a4,2,-1,1,64.805825,16.5,125
SLC46A1,Slc46a1,1,-6,-5,0,0,0
SLC46A2,Slc46a2,-1,-5,-6,16.854369,0,0
SLC46A3,Slc46a3,1,-3,-2,0,0,0
SLC47A1,Slc47a1,8,1,9,1.990291,0,0
SLC47A2,Slc47a2,-3,-2,-5,0,0,0
SLC48A1,Slc48a1,0,4,4,1.504854,0,0
SLC49A4,Slc49a4,3,3,6,19.145631,0,0
SLC4A1,Slc4a1,2,6,8,0,0,0
SLC4A10,Slc4a10,3,-3,0,0,0,0
SLC4A11,Slc4a11,3,0,3,1.174757,0,0
SLC4A1AP,Slc4a1ap,11,-2,9,1.815534,0,0
SLC4A2,Slc4a2,4,1,5,4.446602,0,0
SLC4A3,Slc4a3,9,-12,-3,0,0,0
SLC4A4,Slc4a4,4,3,7,2.07767,0,0
SLC4A5,Slc4a5,17,-5,12,0,0,0
SLC4A7,Slc4a7,0,0,0,5.902913,0,0
SLC4A8,Slc4a8,-1,-10,-11,40.398058,0,0
SLC4A9,Slc4a9,1,0,1,6.737864,0,0
SLC50A1,Slc50a1,2,-4,-2,2.174757,0,0
SLC51A,Slc51a,10,-9,1,0,0,0
SLC51B,Slc51b,-1,-2,-3,19.417476,0,0
SLC52A2,Slc52a2,-5,-9,-14,42.349515,11.208333,0
SLC52A3,Slc52a3,2,8,10,0,0,0
SLC5A1,Slc5a1,0,1,1,0,0,0
SLC5A10,Slc5a10,2,0,2,0,0,0
SLC5A11,Slc5a11,14,3,17,0,0,0
SLC5A12,Slc5a12,4,-4,0,0,0,0
SLC5A2,Slc5a2,4,4,8,0,0,0
SLC5A3,Slc5a3,58,11,69,355.009709,144.541667,0
SLC5A5,Slc5a5,16,16,32,0,0,0
SLC5A6,Slc5a6,3,-16,-13,6.572816,0,0
SLC5A7,Slc5a7,2,2,4,0,0,0
SLC5A8,Slc5a8,0,4,4,0,0,0
SLC5A9,Slc5a9,0,-4,-4,0,0,0
SLC66A1,Slc66a1,1,-7,-6,6.097087,0,0
SLC66A2,Slc66a2,1,1,2,2.728155,0,0
SLC6A1,Slc6a1,7,-1,6,0,0,0
SLC6A11,Slc6a11,10,-5,5,0,0,0
SLC6A12,Slc6a12,36,-5,31,0,0,0
SLC6A13,Slc6a13,61,-6,55,0,0,0
SLC6A14,Slc6a14,0,-1,-1,0,0,0
SLC6A15,Slc6a15,6,7,13,0,0,0
SLC6A16,Slc6a16,8,-7,1,0,0,0
SLC6A17,Slc6a17,0,-2,-2,0,0,0
SLC6A18,Slc6a18,7,-3,4,0,0,0
SLC6A19,Slc6a19,2,2,4,0,0,0
SLC6A2,Slc6a2,-1,-1,-2,0,0,0
SLC6A3,Slc6a3,12,0,12,5.514563,0,0
SLC6A4,Slc6a4,1,8,9,0,0,0
SLC6A5,Slc6a5,0,3,3,0,0,0
SLC6A6,Slc6a6,-10,-7,-17,9.38835,0,0
SLC6A7,Slc6a7,-1,-7,-8,5.524272,0,0
SLC6A8,Slc6a8,14,12,26,0,0,0
SLC6A9,Slc6a9,6,-6,0,3.475728,0,0
SLC7A1,Slc7a1,1,-3,-2,0,0,0
SLC7A10,Slc7a10,4,-4,0,0,0,0
SLC7A11,Slc7a11,5,-2,3,0.941748,0,0
SLC7A13,Slc7a13,1,-7,-6,0,0,0
SLC7A14,Slc7a14,2,2,4,0,0,0
SLC7A2,Slc7a2,-7,-2,-9,5.359223,0,0
SLC7A3,Slc7a3,-1,4,3,0,0,0
SLC7A4,Slc7a4,1,0,1,0,0,0
SLC7A5,Slc7a5,3,6,9,81.262136,0,0
SLC7A6,Slc7a6,3,-7,-4,5.019417,0,0
SLC7A6OS,Slc7a6os,5,0,5,13.203883,0,0
SLC7A7,Slc7a7,8,-4,4,0,0,0
SLC7A8,Slc7a8,11,-1,10,0,0,0
SLC7A9,Slc7a9,36,2,38,0,0,0
SLC8A1,Slc8a1,2,-3,-1,0,0,0
SLC8A2,Slc8a2,34,4,38,0,0,0
SLC8A3,Slc8a3,-5,2,-3,0,0,0
SLC8B1,Slc8b1,6,-2,4,34.339806,0,0
SLC9A1,Slc9a1,7,-5,2,0,0,0
SLC9A2,Slc9a2,2,4,6,1.174757,0,0
SLC9A3,Slc9a3,-4,-3,-7,2.902913,0,0
SLC9A4,Slc9a4,0,-3,-3,0,0,0
SLC9A5,Slc9a5,6,-11,-5,2.631068,0,0
SLC9A6,Slc9a6,9,-3,6,4.932039,0,0
SLC9A7,Slc9a7,3,4,7,3,0,0
SLC9A8,Slc9a8,3,-4,-1,7.194175,0,0
SLC9A9,Slc9a9,0,-2,-2,0,0,0
SLC9B1,Slc9b1,12,-13,-1,7.262136,0,0
SLC9B2,Slc9b2,2,0,2,4.84466,0,0
SLC9C1,Slc9c1,3,-8,-5,0,0,0
SLCO1C1,Slco1c1,0,-2,-2,0,0,0
SLCO2A1,Slco2a1,-3,2,-1,0,0,0
SLCO2B1,Slco2b1,41,-2,39,0,0,0
SLCO3A1,Slco3a1,1,-1,0,1.456311,0,0
SLCO4A1,Slco4a1,0,0,0,7.699029,0,0
SLCO4C1,Slco4c1,4,2,6,0,0,0
SLCO5A1,Slco5a1,2,-9,-7,0,0,0
SLF1,Slf1,7,-3,4,8.398058,0,0
SLF2,Slf2,2,-5,-3,1.106796,0,0
SLFN14,Slfn14,1,-8,-7,1.349515,0,0
SLFN5,Slfn5,-8,10,2,0,0,0
SLFNL1,Slfnl1,17,0,17,0.601942,0,0
SLIRP,Slirp,6,-2,4,16.572816,0,0
SLIT1,Slit1,5,1,6,10.912621,0,0
SLIT2,Slit2,8,-4,4,2.359223,0,0
SLIT3,Slit3,0,3,3,0,0,0
SLITRK1,Slitrk1,-1,-6,-7,0,0,0
SLITRK2,Slitrk2,1,-4,-3,0,0,0
SLITRK3,Slitrk3,-1,-1,-2,0,0,0
SLITRK4,Slitrk4,0,2,2,0,0,0
SLITRK5,Slitrk5,3,1,4,0.961165,0,0
SLITRK6,Slitrk6,-2,-1,-3,0,0,0
SLK,Slk,1,1,2,1.84466,0,0
SLMAP,Slmap,8,-3,5,2,0,0
SLN,Sln,17,-3,14,0,0,0
SLPI,Slpi,23,0,23,4.805825,0,0
SLTM,Sltm,7,-8,-1,7.592233,0,0
SLU7,Slu7,5,-4,1,2.572816,0,0
SLURP1,Slurp1,15,-6,9,3.718447,0,0
SLURP2,Slurp2,6,4,10,0,0,0
SLX1B,Slx1b,14,6,20,9.669903,0,0
SLX4,Slx4,3,-14,-11,5.038835,0,0
SLX4IP,Slx4ip,6,-7,-1,2.883495,0,0
SMAD1,Smad1,18,-4,14,12.854369,0,0
SMAD2,Smad2,7,-6,1,2.776699,0,0
SMAD3,Smad3,2,1,3,5.291262,0,0
SMAD4,Smad4,9,-2,7,1.029126,0,0
SMAD5,Smad5,8,-4,4,15.475728,0,0
SMAD6,Smad6,7,-5,2,0,0,0
SMAD7,Smad7,18,6,24,1.61165,0,0
SMAD9,Smad9,8,-4,4,0,0,0
SMAGP,Smagp,4,1,5,7.893204,0,0
SMAP1,Smap1,4,-1,3,11.407767,0,0
SMAP2,Smap2,-1,-2,-3,8.087379,0,0
SMARCA1,Smarca1,3,0,3,3.728155,0,0
SMARCA2,Smarca2,9,-10,-1,9.883495,0,0
SMARCA4,Smarca4,5,-1,4,16.15534,0,0
SMARCA5,Smarca5,8,-5,3,3.339806,0,0
SMARCAD1,Smarcad1,4,-9,-5,0,0,0
SMARCAL1,Smarcal1,7,-2,5,4.203883,0,0
SMARCB1,Smarcb1,5,-2,3,1.38835,0,0
SMARCC1,Smarcc1,5,-8,-3,9.951456,0,0
SMARCC2,Smarcc2,8,-7,1,25.300971,0,0
SMARCD1,Smarcd1,1,-8,-7,13.436893,0,0
SMARCD2,Smarcd2,7,-4,3,60.349515,0,0
SMARCD3,Smarcd3,12,-1,11,3.398058,0,0
SMARCE1,Smarce1,8,-5,3,3.058252,0,0
SMC1A,Smc1a,8,-3,5,3.621359,0,0
SMC1B,Smc1b,-2,0,-2,0,0,0
SMC2,Smc2,7,-6,1,4.223301,0,0
SMC3,Smc3,4,-4,0,2.728155,0,0
SMC4,Smc4,7,-3,4,2.203883,0,0
SMC5,Smc5,2,-7,-5,12.087379,0,0
SMC6,Smc6,0,-7,-7,4.281553,0,0
SMCHD1,Smchd1,9,-4,5,4.912621,0,0
SMCO1,Smco1,8,0,8,0,0,0
SMCO2,Smco2,19,-6,13,0,0,0
SMCO3,Smco3,-1,2,1,0,0,0
SMCO4,Smco4,5,-10,-5,4.718447,0,0
SMCP,Smcp,0,-1,-1,0,0,0
SMCR8,Smcr8,5,-3,2,2.203883,0,0
SMDT1,Smdt1,7,-4,3,2.572816,0,0
SMG1,Smg1,10,-2,8,3.553398,0,0
SMG5,Smg5,9,-10,-1,86.902913,0,0
SMG6,Smg6,10,1,11,9.825243,0,0
SMG7,Smg7,6,-1,5,19.135922,0,0
SMG8,Smg8,8,-4,4,35.330097,0,0
SMG9,Smg9,-1,-8,-9,20.271845,0,0
SMIM1,Smim1,1,1,2,2.407767,0,0
SMIM10L1,Smim10l1,4,0,4,6.203883,0,0
SMIM10L2A,Smim10l2a,3,0,3,1.796117,0,0
SMIM12,Smim12,5,-11,-6,6.194175,0,0
SMIM13,Smim13,5,-2,3,7.776699,0,0
SMIM14,Smim14,2,-7,-5,8.019417,0,0
SMIM15,Smim15,4,-4,0,2.84466,0,0
SMIM17,Smim17,1,-16,-15,0,0,0
SMIM18,Smim18,10,-11,-1,0,0,0
SMIM19,Smim19,3,-5,-2,8.601942,0,0
SMIM20,Smim20,7,-8,-1,3.349515,0,0
SMIM22,Smim22,6,-4,2,4.019417,0,0
SMIM23,Smim23,3,1,4,0,0,0
SMIM24,Smim24,40,-1,39,1.048544,0,0
SMIM26,Smim26,1,0,1,1.728155,0,0
SMIM27,Smim27,5,-1,4,2.029126,0,0
SMIM3,Smim3,-3,-1,-4,4.757282,0,0
SMIM31,Smim31,2,-1,1,0,0,0
SMIM38,Smim38,0,-8,-8,0,0,0
SMIM40,Smim40,-5,4,-1,0,0,0
SMIM41,Smim41,5,8,13,0,0,0
SMIM43,Smim43,0,-4,-4,0,0,0
SMIM5,Smim5,-9,10,1,11.038835,0,0
SMIM6,Smim6,-1,-10,-11,3.349515,0,0
SMIM7,Smim7,7,-6,1,3.582524,0,0
SMIM8,Smim8,0,-11,-11,9.951456,0,0
SMIM9,Smim9,2,-2,0,0,0,0
SMLR1,Smlr1,2,-4,-2,0,0,0
SMN1,Smn1,1,-4,-3,13.68932,0,0
SMNDC1,Smndc1,8,3,11,1.067961,0,0
SMO,Smo,10,-1,9,6.223301,0,0
SMOC1,Smoc1,7,1,8,0,0,0
SMOC2,Smoc2,3,-7,-4,0,0,0
SMOX,Smox,1,-2,-1,3.883495,0,0
SMPD1,Smpd1,5,4,9,2.883495,0,0
SMPD2,Smpd2,3,0,3,55.436893,0,0
SMPD3,Smpd3,12,-9,3,6.951456,0,0
SMPD4,Smpd4,7,-7,0,6.631068,0,0
SMPDL3A,Smpdl3a,5,-6,-1,9.097087,0,0
SMPDL3B,Smpdl3b,8,-5,3,0,0,0
SMPX,Smpx,10,0,10,0,0,0
SMR3A,Smr3a,0,6,6,0,0,0
SMS,Sms,4,-3,1,18.893204,0,0
SMTN,Smtn,-4,0,-4,11.679612,0,0
SMTNL1,Smtnl1,-4,-3,-7,0,0,0
SMTNL2,Smtnl2,-2,-1,-3,0,0,0
SMU1,Smu1,9,-1,8,0,0,0
SMUG1,Smug1,5,-5,0,0,0,0
SMURF1,Smurf1,4,-2,2,0.902913,0,0
SMURF2,Smurf2,5,-1,4,19.912621,0,0
SMYD1,Smyd1,5,2,7,6.980583,0,0
SMYD2,Smyd2,1,-6,-5,4.660194,0,0
SMYD3,Smyd3,3,-10,-7,4.825243,0,0
SMYD4,Smyd4,0,-2,-2,3.582524,0,0
SMYD5,Smyd5,-5,-2,-7,3.76699,0,0
SNAI1,Snai1,38,4,42,8.320388,0,0
SNAI2,Snai2,6,-3,3,0,0,0
SNAI3,Snai3,7,3,10,0,0,0
SNAP23,Snap23,23,0,23,98.213592,0,0
SNAP25,Snap25,1,18,19,2.300971,0,0
SNAP29,Snap29,4,2,6,8.669903,0,0
SNAP47,Snap47,5,1,6,42.271845,0,0
SNAP91,Snap91,6,1,7,0,0,0
SNAPC1,Snapc1,6,-8,-2,14.15534,0,0
SNAPC2,Snapc2,0,-4,-4,4.708738,0,0
SNAPC3,Snapc3,5,-3,2,4.291262,0,0
SNAPC4,Snapc4,6,-5,1,43.640777,0,0
SNAPC5,Snapc5,6,-3,3,13.106796,0,0
SNAPIN,Snapin,4,-8,-4,8.834951,0,0
SNCA,Snca,0,-4,-4,1.368932,0,0
SNCAIP,Sncaip,9,-11,-2,0,0,0
SNCB,Sncb,4,1,5,0,0,0
SNCG,Sncg,0,0,0,2.359223,0,0
SND1,Snd1,6,-1,5,2.300971,0,0
SNED1,Sned1,-2,-2,-4,0,0,0
SNF8,Snf8,11,-4,7,6.174757,0,0
SNIP1,Snip1,4,-2,2,1.242718,0,0
SNN,Snn,-14,-10,-24,0,0,0
SNORC,Snorc,17,7,24,0.873786,0,0
SNPH,Snph,5,-3,2,0,0,0
SNRK,Snrk,-3,-7,-10,4.300971,0,0
SNRNP200,Snrnp200,7,1,8,6.475728,0,0
SNRNP25,Snrnp25,4,-2,2,0,0,0
SNRNP27,Snrnp27,9,-7,2,0,0,0
SNRNP35,Snrnp35,5,-5,0,2.825243,0,0
SNRNP40,Snrnp40,6,-2,4,2.339806,0,0
SNRNP48,Snrnp48,7,2,9,3.07767,0,0
SNRNP70,Snrnp70,4,-5,-1,8.058252,0,0
SNRPA,Snrpa,3,-1,2,22.291262,0,0
SNRPA1,Snrpa1,10,-8,2,0,0,0
SNRPB,Snrpb,6,-2,4,9.572816,0,0
SNRPB2,Snrpb2,4,0,4,35.932039,0,0
SNRPC,Snrpc,11,-1,10,7.106796,0,0
SNRPD1,Snrpd1,6,1,7,17.563107,0,0
SNRPD2,Snrpd2,7,0,7,1.038835,0,0
SNRPD3,Snrpd3,3,-2,1,12.203883,0,0
SNRPE,Snrpe,8,-4,4,6.126214,0,0
SNRPF,Snrpf,4,3,7,36.563107,0,0
SNRPG,Snrpg,7,-11,-4,2.116505,0,0
SNRPN,Snrpn,7,-1,6,0,0,0
SNTA1,Snta1,4,-4,0,0,0,0
SNTB1,Sntb1,7,5,12,4.941748,0,0
SNTB2,Sntb2,3,-5,-2,6.213592,0,0
SNTG1,Sntg1,4,-6,-2,0,0,0
SNTG2,Sntg2,-5,2,-3,0,0,0
SNTN,Sntn,5,-5,0,0,0,0
SNU13,Snu13,6,1,7,0.970874,0,0
SNUPN,Snupn,7,-4,3,4.92233,0,0
SNURF,Snurf,-5,-5,-10,0,0,0
SNW1,Snw1,6,-2,4,0.951456,0,0
SNX1,Snx1,10,-7,3,8.893204,0,0
SNX10,Snx10,-1,7,6,2.728155,0,0
SNX11,Snx11,5,-5,0,3.796117,0,0
SNX12,Snx12,5,-4,1,19.679612,0,0
SNX13,Snx13,1,-2,-1,15.291262,0,0
SNX14,Snx14,9,-7,2,22.330097,0,0
SNX15,Snx15,0,-5,-5,3.660194,0,0
SNX16,Snx16,9,0,9,29.300971,0,0
SNX17,Snx17,9,-6,3,24.048544,0,0
SNX18,Snx18,6,4,10,7.058252,0,0
SNX19,Snx19,9,-4,5,16.398058,0,0
SNX2,Snx2,6,-6,0,4.145631,0,0
SNX20,Snx20,-3,3,0,8.15534,0,0
SNX21,Snx21,8,1,9,4.990291,0,0
SNX22,Snx22,5,-15,-10,0,0,0
SNX24,Snx24,-5,-5,-10,7.893204,0,0
SNX25,Snx25,7,-2,5,42.07767,0,0
SNX27,Snx27,6,-2,4,9.271845,0,0
SNX29,Snx29,12,-9,3,5.601942,0,0
SNX3,Snx3,16,-3,13,84.456311,15.583333,0
SNX30,Snx30,4,-2,2,10.553398,0,0
SNX31,Snx31,51,3,54,7.679612,0,0
SNX32,Snx32,5,-6,-1,0,0,0
SNX33,Snx33,-1,-4,-5,16.92233,0,0
SNX4,Snx4,-9,-5,-14,1.543689,0,0
SNX5,Snx5,7,0,7,7.31068,0,0
SNX6,Snx6,8,0,8,2.970874,0,0
SNX7,Snx7,6,-9,-3,5.592233,0,0
SNX8,Snx8,2,-5,-3,9.116505,0,0
SNX9,Snx9,3,-3,0,5.106796,0,0
SOAT1,Soat1,3,-3,0,3.427184,0,0
SOAT2,Soat2,0,9,9,0,0,0
SOBP,Sobp,20,1,21,3.038835,0,0
SOCS1,Socs1,35,-8,27,5.116505,0,0
SOCS2,Socs2,19,1,20,4.271845,0,0
SOCS3,Socs3,47,17,64,5.242718,0,0
SOCS4,Socs4,7,-3,4,24.757282,0,0
SOCS5,Socs5,-1,-2,-3,11.592233,0,0
SOCS6,Socs6,6,-3,3,1.970874,0,0
SOCS7,Socs7,9,1,10,1.563107,0,0
SOD1,Sod1,9,-2,7,152.951456,8.125,0
SOD2,Sod2,5,-5,0,15.728155,0,0
SOD3,Sod3,8,-1,7,0,0,0
SOGA1,Soga1,6,1,7,2.951456,0,0
SOGA3,Soga3,6,4,10,3.951456,0,0
SOHLH1,Sohlh1,18,2,20,0,0,0
SOHLH2,Sohlh2,3,0,3,0,0,0
SON,Son,11,-4,7,0,0,0
SORBS1,Sorbs1,35,-6,29,97.407767,21.75,0
SORBS2,Sorbs2,2,-14,-12,2.456311,0,0
SORBS3,Sorbs3,5,0,5,0.582524,0,0
SORCS1,Sorcs1,5,4,9,2.718447,0,0
SORCS2,Sorcs2,0,4,4,1.805825,0,0
SORCS3,Sorcs3,2,-2,0,0,0,0
SORD,Sord,27,1,28,2.07767,0,0
SORL1,Sorl1,7,1,8,10.466019,0,0
SORT1,Sort1,4,-3,1,15.058252,0,0
SOS1,Sos1,10,-1,9,21.932039,0,0
SOS2,Sos2,7,4,11,6.543689,0,0
SOST,Sost,6,-6,0,0,0,0
SOSTDC1,Sostdc1,1,-5,-4,0,0,0
SOWAHA,Sowaha,2,3,5,0,0,0
SOWAHB,Sowahb,-1,4,3,0,0,0
SOWAHC,Sowahc,5,1,6,4.485437,0,0
SOWAHD,Sowahd,-16,-2,-18,1.07767,0,0
SOX1,Sox1,6,0,6,24.873786,0,0
SOX10,Sox10,10,3,13,0,0,0
SOX11,Sox11,5,-3,2,0,0,0
SOX12,Sox12,2,-1,1,4.436893,0,0
SOX13,Sox13,-5,3,-2,3.825243,0,0
SOX14,Sox14,-1,0,-1,0,0,0
SOX15,Sox15,-1,-5,-6,0,0,0
SOX17,Sox17,0,-4,-4,0,0,0
SOX18,Sox18,-2,-12,-14,0,0,0
SOX2,Sox2,33,-2,31,1.553398,0,0
SOX21,Sox21,5,3,8,0,0,0
SOX3,Sox3,9,-2,7,0,0,0
SOX30,Sox30,11,-3,8,0,0,0
SOX4,Sox4,26,5,31,2.76699,0,0
SOX5,Sox5,6,-11,-5,0,0,0
SOX6,Sox6,14,-6,8,1.165049,0,0
SOX7,Sox7,1,0,1,0.834951,0,0
SOX8,Sox8,19,8,27,0,0,0
SOX9,Sox9,10,7,17,0,0,0
SP1,Sp1,8,-13,-5,10.252427,0,0
SP100,Sp100,-3,-3,-6,0,0,0
SP110,Sp110,0,4,4,46.631068,0,0
SP140,Sp140,3,-12,-9,0,0,0
SP2,Sp2,5,-3,2,10.504854,0,0
SP3,Sp3,6,2,8,6.126214,0,0
SP4,Sp4,4,-14,-10,3.203883,0,0
SP5,Sp5,-2,4,2,1.048544,0,0
SP6,Sp6,-1,-1,-2,3.213592,0,0
SP7,Sp7,6,2,8,17.825243,0,0
SP8,Sp8,7,-5,2,0.84466,0,0
SP9,Sp9,9,-1,8,0,0,0
SPA17,Spa17,2,5,7,11.087379,0,0
SPAAR,Spaar,-7,2,-5,3.699029,0,0
SPACA1,Spaca1,-1,-6,-7,0,0,0
SPACA3,Spaca3,10,-5,5,0.980583,0,0
SPACA4,Spaca4,20,-7,13,0,0,0
SPACA5,Spaca5,5,-3,2,0,0,0
SPACA6,Spaca6,-3,-8,-11,5.883495,0,0
SPACA7,Spaca7,8,0,8,0,0,0
SPACA9,Spaca9,-1,-1,-2,34.048544,0,0
SPAG1,Spag1,-2,-5,-7,13.563107,0,0
SPAG11A,Spag11a,-2,7,5,0,0,0
SPAG11B,Spag11b,-4,0,-4,0,0,0
SPAG16,Spag16,-1,-6,-7,22.300971,0,0
SPAG17,Spag17,0,-4,-4,0,0,0
SPAG4,Spag4,1,-10,-9,5.009709,0,0
SPAG5,Spag5,10,-19,-9,1.262136,0,0
SPAG6,Spag6,-1,-3,-4,2.262136,0,0
SPAG7,Spag7,6,-4,2,3.883495,0,0
SPAG8,Spag8,-11,-20,-31,6.932039,0,0
SPAG9,Spag9,10,-1,9,4.067961,0,0
SPAM1,Spam1,4,-8,-4,0,0,0
SPARC,Sparc,8,5,13,0,0,0
SPARCL1,Sparcl1,13,10,23,0,0,0
SPAST,Spast,8,-1,7,7.446602,0,0
SPATA1,Spata1,0,-2,-2,5.864078,0,0
SPATA13,Spata13,-3,-6,-9,35.68932,0,0
SPATA16,Spata16,2,-4,-2,0,0,0
SPATA17,Spata17,0,-5,-5,1.893204,0,0
SPATA18,Spata18,3,1,4,0,0,0
SPATA19,Spata19,-2,-2,-4,0,0,0
SPATA2,Spata2,10,-2,8,18.058252,0,0
SPATA20,Spata20,4,1,5,4.61165,0,0
SPATA21,Spata21,6,-3,3,0,0,0
SPATA22,Spata22,13,0,13,0,0,0
SPATA24,Spata24,8,-11,-3,36.252427,0,0
SPATA25,Spata25,-3,-10,-13,7.757282,0,0
SPATA2L,Spata2l,-19,-9,-28,72.116505,0,0
SPATA3,Spata3,-2,1,-1,0,0,0
SPATA32,Spata32,10,-1,9,0,0,0
SPATA33,Spata33,2,0,2,45.601942,3.25,0
SPATA4,Spata4,6,-12,-6,53.582524,0,0
SPATA45,Spata45,9,-31,-22,0,0,0
SPATA46,Spata46,6,-12,-6,18.679612,0,0
SPATA48,Spata48,-1,-12,-13,1,0,0
SPATA5,Spata5,4,-2,2,4.84466,0,0
SPATA6,Spata6,3,-6,-3,6.990291,0,0
SPATA6L,Spata6l,6,-6,0,5.456311,0,0
SPATA7,Spata7,-1,-2,-3,42.009709,0,0
SPATA9,Spata9,8,-14,-6,3.961165,0,0
SPATC1,Spatc1,-1,1,0,0,0,0
SPATC1L,Spatc1l,3,3,6,19.271845,7,0
SPATS1,Spats1,7,-21,-14,5.582524,0,0
SPATS2,Spats2,7,-9,-2,10.718447,0,0
SPATS2L,Spats2l,5,8,13,61.15534,7.166667,0
SPC24,Spc24,-4,2,-2,5.640777,0,0
SPC25,Spc25,2,-12,-10,26.126214,0,0
SPCS1,Spcs1,5,-5,0,47.786408,0,0
SPCS2,Spcs2,9,-3,6,2.805825,0,0
SPCS3,Spcs3,3,-7,-4,6.407767,0,0
SPDEF,Spdef,8,-7,1,1.23301,0,0
SPDL1,Spdl1,1,-9,-8,1.912621,0,0
SPDYA,Spdya,59,-14,45,0,0,0
SPECC1,Specc1,8,-1,7,6.601942,0,0
SPECC1L,Specc1l,3,-7,-4,9.951456,0,0
SPEF1,Spef1,21,-5,16,0,0,0
SPEF2,Spef2,-1,-5,-6,19.601942,0,0
SPEG,Speg,5,-4,1,0,0,0
SPEM1,Spem1,7,4,11,0,0,0
SPEM2,Spem2,5,2,7,0,0,0
SPEN,Spen,15,-5,10,14.524272,0,0
SPESP1,Spesp1,0,-8,-8,0,0,0
SPG11,Spg11,10,-4,6,8.427184,0,0
SPG21,Spg21,11,-1,10,63.660194,0,0
SPG7,Spg7,9,-6,3,3.262136,0,0
SPHK1,Sphk1,5,13,18,3.718447,0,0
SPHK2,Sphk2,15,-7,8,112.524272,9,0
SPHKAP,Sphkap,-2,-4,-6,0,0,0
SPI1,Spi1,12,-5,7,0,0,0
SPIB,Spib,7,9,16,0,0,0
SPIC,Spic,9,-2,7,3.970874,0,0
SPICE1,Spice1,-4,-5,-9,59.582524,0,0
SPIDR,Spidr,10,0,10,2.203883,0,0
SPIN1,Spin1,10,-6,4,33.679612,0,0
SPIN4,Spin4,3,-4,-1,13.242718,0,0
SPINDOC,Spindoc,18,1,19,62.271845,10.291667,0
SPINK1,Spink1,9,5,14,0,0,0
SPINK13,Spink13,-8,4,-4,0,0,0
SPINK14,Spink14,3,3,6,0,0,0
SPINK2,Spink2,13,-3,10,0,0,0
SPINK4,Spink4,9,-14,-5,1.009709,0,0
SPINK5,Spink5,0,2,2,0,0,0
SPINK6,Spink6,8,-1,7,0,0,0
SPINK7,Spink7,10,-15,-5,0,0,0
SPINK8,Spink8,5,-4,1,0,0,0
SPINT1,Spint1,-2,4,2,0,0,0
SPINT2,Spint2,-7,2,-5,8.174757,0,0
SPINT3,Spint3,7,3,10,0,0,0
SPINT4,Spint4,-5,0,-5,1.76699,0,0
SPIRE1,Spire1,9,1,10,4.07767,0,0
SPIRE2,Spire2,1,-1,0,2.145631,0,0
SPN,Spn,1,0,1,2.009709,0,0
SPNS1,Spns1,10,0,10,14.174757,0,0
SPNS2,Spns2,-8,-5,-13,0,0,0
SPNS3,Spns3,0,-8,-8,0,0,0
SPO11,Spo11,9,-5,4,69.737864,0,0
SPOCD1,Spocd1,-5,2,-3,1.15534,0,0
SPOCK1,Spock1,22,1,23,3.466019,0,0
SPOCK2,Spock2,51,1,52,0,0,0
SPOCK3,Spock3,-5,-3,-8,0,0,0
SPON1,Spon1,11,3,14,0,0,0
SPON2,Spon2,13,14,27,1.184466,0,0
SPOP,Spop,7,-2,5,5.407767,0,0
SPOPL,Spopl,4,-1,3,22.951456,0,0
SPOUT1,Spout1,-20,-12,-32,2.563107,0,0
SPP1,Spp1,-5,21,16,0,0,0
SPP2,Spp2,1,-3,-2,0,0,0
SPPL2A,Sppl2a,2,-5,-3,6.019417,0,0
SPPL2B,Sppl2b,5,-7,-2,3.427184,0,0
SPPL2C,Sppl2c,0,-1,-1,0,0,0
SPPL3,Sppl3,8,-2,6,6.737864,0,0
SPR,Spr,17,-2,15,181.126214,7.916667,193
SPRED1,Spred1,1,0,1,9.407767,0,0
SPRED2,Spred2,11,-2,9,7.31068,0,0
SPRED3,Spred3,15,-7,8,9.184466,0,0
SPRING1,Spring1,12,-1,11,8.165049,0,0
SPRN,Sprn,-7,-1,-8,0,0,0
SPRR1A,Sprr1a,4,7,11,0,0,0
SPRR1B,Sprr1b,1,-1,0,0,0,0
SPRR2B,Sprr2b,2,3,5,0,0,0
SPRR2D,Sprr2d,5,-1,4,0,0,0
SPRR2E,Sprr2e,6,-1,5,0,0,0
SPRR2F,Sprr2f,5,4,9,0,0,0
SPRR2G,Sprr2g,4,6,10,0,0,0
SPRR3,Sprr3,2,-1,1,0,0,0
SPRR4,Sprr4,3,-5,-2,0,0,0
SPRTN,Sprtn,-7,-8,-15,4.456311,0,0
SPRY1,Spry1,11,9,20,3.592233,0,0
SPRY2,Spry2,11,8,19,3.203883,0,0
SPRY4,Spry4,3,16,19,0,0,0
SPRYD3,Spryd3,-8,-2,-10,5.592233,0,0
SPRYD4,Spryd4,3,-13,-10,12.009709,0,0
SPRYD7,Spryd7,5,-7,-2,3.514563,0,0
SPSB1,Spsb1,-3,7,4,2.84466,0,0
SPSB2,Spsb2,-14,2,-12,9.563107,0,0
SPSB3,Spsb3,2,1,3,0,0,0
SPSB4,Spsb4,1,-5,-4,0,0,0
SPTA1,Spta1,-4,-2,-6,0,0,0
SPTAN1,Sptan1,7,-4,3,9.184466,0,0
SPTB,Sptb,5,-5,0,1.932039,0,0
SPTBN1,Sptbn1,10,-1,9,5.873786,0,0
SPTBN2,Sptbn2,9,-2,7,34.84466,18.583333,0
SPTBN4,Sptbn4,0,-11,-11,28.640777,0,0
SPTBN5,Sptbn5,0,0,0,0,0,0
SPTLC1,Sptlc1,6,-8,-2,10.184466,0,0
SPTLC2,Sptlc2,2,-4,-2,16.359223,0,0
SPTLC3,Sptlc3,-1,-1,-2,0,0,0
SPTSSA,Sptssa,-1,-8,-9,6.300971,0,0
SPTSSB,Sptssb,12,-1,11,5.165049,0,0
SPTY2D1,Spty2d1,4,0,4,1.31068,0,0
SPX,Spx,15,-3,12,7.893204,0,0
SPZ1,Spz1,6,1,7,1.067961,0,0
SQLE,Sqle,-2,-1,-3,20.621359,0,0
SQOR,Sqor,23,-8,15,25.446602,0,0
SQSTM1,Sqstm1,8,2,10,19.252427,0,0
SRA1,Sra1,5,0,5,6.262136,0,0
SRARP,Srarp,3,-8,-5,0,0,0
SRBD1,Srbd1,3,0,3,4.601942,0,0
SRC,Src,7,0,7,9.941748,0,0
SRCAP,Srcap,6,-6,0,6.980583,0,0
SRCIN1,Srcin1,8,-2,6,4.23301,0,0
SRD5A1,Srd5a1,6,-1,5,7.31068,0,0
SRD5A2,Srd5a2,-1,1,0,0,0,0
SRD5A3,Srd5a3,1,-1,0,6.601942,0,0
SREBF1,Srebf1,-2,0,-2,7.718447,0,0
SREBF2,Srebf2,8,-2,6,1.038835,0,0
SREK1,Srek1,4,-4,0,32.456311,0,0
SREK1IP1,Srek1ip1,4,-3,1,0,0,0
SRF,Srf,3,-2,1,22.902913,0,0
SRFBP1,Srfbp1,1,-4,-3,6.475728,0,0
SRGAP1,Srgap1,8,2,10,13.330097,0,0
SRGAP2,Srgap2,11,-5,6,2.135922,0,0
SRGAP3,Srgap3,8,-2,6,0,0,0
SRGN,Srgn,6,5,11,0,0,0
SRI,Sri,6,-2,4,19.912621,0,0
SRL,Srl,4,-7,-3,1.883495,0,0
SRM,Srm,9,0,9,4.864078,0,0
SRMS,Srms,14,-3,11,1.669903,0,0
SRP14,Srp14,14,-4,10,54.718447,5.333333,0
SRP19,Srp19,5,-6,-1,3.339806,0,0
SRP68,Srp68,4,-6,-2,64.359223,17.791667,0
SRP72,Srp72,1,-6,-5,3.330097,0,0
SRP9,Srp9,8,-7,1,6.359223,0,0
SRPK1,Srpk1,2,-8,-6,4.485437,0,0
SRPK2,Srpk2,9,-6,3,1.252427,0,0
SRPK3,Srpk3,9,-16,-7,0,0,0
SRPRB,Srprb,2,-4,-2,1.747573,0,0
SRPX,Srpx,1,0,1,0,0,0
SRPX2,Srpx2,4,-1,3,0,0,0
SRR,Srr,0,-4,-4,4.07767,0,0
SRRD,Srrd,-3,0,-3,8.271845,0,0
SRRM1,Srrm1,5,-8,-3,5.087379,0,0
SRRM2,Srrm2,10,-4,6,9.970874,0,0
SRRM3,Srrm3,33,2,35,18.407767,0,0
SRRM4,Srrm4,-2,1,-1,0,0,0
SRRT,Srrt,9,-1,8,11.23301,0,0
SRSF1,Srsf1,9,-2,7,20.631068,0,0
SRSF10,Srsf10,6,-1,5,10.300971,0,0
SRSF11,Srsf11,8,0,8,13.07767,0,0
SRSF12,Srsf12,8,6,14,0,0,0
SRSF2,Srsf2,0,2,2,17.019417,0,0
SRSF3,Srsf3,10,-5,5,0,0,0
SRSF4,Srsf4,10,-6,4,11.699029,0,0
SRSF5,Srsf5,-2,-2,-4,97.961165,34.125,0
SRSF6,Srsf6,-8,-7,-15,8.650485,0,0
SRSF7,Srsf7,1,-5,-4,5.932039,0,0
SRSF9,Srsf9,15,-2,13,12.019417,0,0
SRXN1,Srxn1,-5,-1,-6,16.135922,0,0
SRY,Sry,4,-5,-1,0,0,0
SS18,Ss18,4,-4,0,3.242718,0,0
SS18L1,Ss18l1,5,0,5,8.834951,0,0
SS18L2,Ss18l2,6,-5,1,34.592233,0,0
SSB,Ssb,8,-3,5,7.601942,0,0
SSBP1,Ssbp1,3,-8,-5,23.320388,0,0
SSBP2,Ssbp2,3,-5,-2,75.339806,0,0
SSBP3,Ssbp3,8,2,10,3.407767,0,0
SSBP4,Ssbp4,10,-7,3,44.912621,0,0
SSC4D,Ssc4d,4,7,11,0,0,0
SSC5D,Ssc5d,-7,0,-7,22.019417,0,0
SSH1,Ssh1,5,3,8,7.76699,0,0
SSH2,Ssh2,5,-6,-1,5.378641,0,0
SSH3,Ssh3,2,-1,1,1.087379,0,0
SSMEM1,Ssmem1,-13,-26,-39,8.339806,0,0
SSNA1,Ssna1,1,-1,0,13.592233,0,0
SSPN,Sspn,-18,-8,-26,0,0,0
SSR1,Ssr1,6,-4,2,0,0,0
SSR2,Ssr2,9,-1,8,1.368932,0,0
SSR3,Ssr3,6,2,8,8.165049,0,0
SSR4,Ssr4,1,0,1,2.174757,0,0
SSRP1,Ssrp1,8,-2,6,20.932039,0,0
SST,Sst,8,-2,6,0,0,0
SSTR1,Sstr1,-5,3,-2,0,0,0
SSTR2,Sstr2,5,3,8,0,0,0
SSTR3,Sstr3,-3,-5,-8,0,0,0
SSTR4,Sstr4,0,1,1,0,0,0
SSTR5,Sstr5,-8,3,-5,7.737864,0,0
SSU72,Ssu72,8,-4,4,8.475728,0,0
SSX2IP,Ssx2ip,-1,-6,-7,28.776699,0,0
ST13,St13,20,6,26,663.883495,409.166667,397
ST14,St14,23,7,30,5.135922,0,0
ST18,St18,-2,2,0,23.281553,0,0
ST3GAL1,St3gal1,-16,-2,-18,4.805825,0,0
ST3GAL2,St3gal2,2,2,4,10.087379,0,0
ST3GAL3,St3gal3,6,4,10,11.106796,0,0
ST3GAL4,St3gal4,3,-1,2,3.349515,0,0
ST3GAL5,St3gal5,-1,2,1,4.417476,0,0
ST3GAL6,St3gal6,16,1,17,16.427184,0,0
ST6GAL1,St6gal1,4,5,9,3.941748,0,0
ST6GAL2,St6gal2,0,-1,-1,3.31068,0,0
ST6GALNAC1,St6galnac1,6,7,13,0,0,0
ST6GALNAC2,St6galnac2,1,-10,-9,5.631068,0,0
ST6GALNAC3,St6galnac3,-1,-2,-3,0,0,0
ST6GALNAC4,St6galnac4,7,-4,3,3.145631,0,0
ST6GALNAC5,St6galnac5,1,-1,0,0,0,0
ST6GALNAC6,St6galnac6,-7,0,-7,4.61165,0,0
ST7,St7,8,-6,2,4.718447,0,0
ST7L,St7l,3,-3,0,4.902913,0,0
ST8SIA1,St8sia1,4,-3,1,0,0,0
ST8SIA2,St8sia2,5,3,8,0,0,0
ST8SIA3,St8sia3,0,-4,-4,0,0,0
ST8SIA4,St8sia4,5,-5,0,0,0,0
ST8SIA5,St8sia5,10,-1,9,0,0,0
ST8SIA6,St8sia6,9,3,12,0,0,0
STAB1,Stab1,0,-8,-8,1.223301,0,0
STAB2,Stab2,-4,-6,-10,0,0,0
STAC,Stac,-1,-3,-4,3.728155,0,0
STAC2,Stac2,0,-1,-1,0,0,0
STAC3,Stac3,7,-3,4,0,0,0
STAG1,Stag1,7,2,9,7.116505,0,0
STAG2,Stag2,10,-7,3,55.223301,0,0
STAG3,Stag3,4,-7,-3,2.815534,0,0
STAM,Stam,5,2,7,0,0,0
STAM2,Stam2,4,-2,2,31.271845,0,0
STAMBP,Stambp,7,-5,2,27.650485,0,0
STAMBPL1,Stambpl1,4,-14,-10,3.883495,0,0
STAP1,Stap1,1,-1,0,0,0,0
STAP2,Stap2,16,-10,6,17.747573,0,0
STAR,Star,8,-5,3,0,0,0
STARD10,Stard10,3,-3,0,4.524272,0,0
STARD13,Stard13,-2,-4,-6,18.961165,0,0
STARD3,Stard3,14,-6,8,3.699029,0,0
STARD3NL,Stard3nl,9,-10,-1,2.252427,0,0
STARD4,Stard4,-6,-6,-12,8.009709,0,0
STARD5,Stard5,9,-3,6,0,0,0
STARD6,Stard6,-33,-7,-40,8.650485,0,0
STARD7,Stard7,7,0,7,7.23301,0,0
STARD8,Stard8,-9,5,-4,1.262136,0,0
STARD9,Stard9,3,-4,-1,3.941748,0,0
STAT1,Stat1,4,-3,1,25.495146,0,0
STAT2,Stat2,6,-1,5,63.718447,0,0
STAT3,Stat3,9,6,15,7.805825,0,0
STAT4,Stat4,-2,3,1,0,0,0
STAT5A,Stat5a,-2,1,-1,4.407767,0,0
STAT5B,Stat5b,7,-5,2,13.126214,0,0
STAT6,Stat6,2,4,6,84.456311,0,0
STAU1,Stau1,7,-5,2,29.961165,0,0
STAU2,Stau2,8,-1,7,9.23301,0,0
STBD1,Stbd1,0,1,1,17.398058,0,0
STC1,Stc1,-2,2,0,0,0,0
STC2,Stc2,13,0,13,5.631068,0,0
STEAP1,Steap1,3,-11,-8,8.941748,0,0
STEAP2,Steap2,-1,-9,-10,8.572816,0,0
STEAP3,Steap3,-3,2,-1,2.631068,0,0
STEAP4,Steap4,-1,-3,-4,0,0,0
STIL,Stil,1,-13,-12,2.058252,0,0
STIM1,Stim1,12,-2,10,3.194175,0,0
STIM2,Stim2,4,0,4,4.223301,0,0
STIMATE,Stimate,7,-3,4,2.990291,0,0
STING1,Sting1,-3,-11,-14,0,0,0
STIP1,Stip1,30,11,41,468.990291,211.166667,278
STK10,Stk10,5,-8,-3,7.271845,0,0
STK11,Stk11,11,0,11,1.029126,0,0
STK11IP,Stk11ip,11,0,11,56.543689,0,0
STK16,Stk16,10,-4,6,6.038835,0,0
STK17B,Stk17b,0,-5,-5,4.699029,0,0
STK19,Stk19,9,-2,7,16.427184,0,0
STK24,Stk24,7,-1,6,2.194175,0,0
STK25,Stk25,8,-3,5,7.339806,0,0
STK26,Stk26,0,-1,-1,2.912621,0,0
STK3,Stk3,4,-6,-2,2.650485,0,0
STK31,Stk31,1,0,1,8.737864,0,0
STK32A,Stk32a,-6,0,-6,7.883495,0,0
STK32B,Stk32b,-4,2,-2,0,0,0
STK32C,Stk32c,-2,-2,-4,44.572816,0,0
STK33,Stk33,8,-5,3,3.165049,0,0
STK35,Stk35,6,-1,5,19.339806,0,0
STK36,Stk36,12,0,12,0,0,0
STK38,Stk38,5,0,5,2,0,0
STK38L,Stk38l,3,-1,2,15.087379,0,0
STK39,Stk39,3,0,3,4.446602,0,0
STK4,Stk4,6,-5,1,12.61165,0,0
STK40,Stk40,6,0,6,50.68932,0,0
STKLD1,Stkld1,5,-2,3,0,0,0
STMN1,Stmn1,11,-7,4,6.126214,0,0
STMN2,Stmn2,5,2,7,0,0,0
STMN3,Stmn3,8,-4,4,26.126214,0,0
STMN4,Stmn4,21,5,26,0,0,0
STMND1,Stmnd1,6,4,10,0,0,0
STN1,Stn1,3,-2,1,0,0,0
STOM,Stom,4,1,5,3.407767,0,0
STOML1,Stoml1,1,-7,-6,15.330097,0,0
STOML2,Stoml2,8,-3,5,12.087379,0,0
STOML3,Stoml3,3,4,7,0,0,0
STON1,Ston1,1,-1,0,0,0,0
STON2,Ston2,5,-7,-2,5.029126,0,0
STOX1,Stox1,12,-6,6,11.165049,0,0
STOX2,Stox2,6,-2,4,0,0,0
STPG1,Stpg1,-1,-5,-6,28.097087,0,0
STPG2,Stpg2,1,-9,-8,2.563107,0,0
STPG3,Stpg3,40,8,48,28.873786,0,0
STPG4,Stpg4,45,-8,37,0,0,0
STRA6,Stra6,3,8,11,9.223301,0,0
STRA8,Stra8,3,2,5,0,0,0
STRADA,Strada,8,-9,-1,6.737864,0,0
STRADB,Stradb,4,-1,3,9.106796,0,0
STRAP,Strap,9,-2,7,69.067961,21.458333,0
STRBP,Strbp,6,-1,5,9.203883,0,0
STRC,Strc,17,1,18,0,0,0
STRIP1,Strip1,-6,-10,-16,7.097087,0,0
STRIP2,Strip2,-1,-2,-3,6.893204,0,0
STRIT1,Strit1,6,-1,5,0,0,0
STRN,Strn,7,-6,1,12.864078,0,0
STRN3,Strn3,9,0,9,5.165049,0,0
STRN4,Strn4,3,-5,-2,1.854369,0,0
STT3A,Stt3a,3,-1,2,3.194175,0,0
STT3B,Stt3b,5,-2,3,6.009709,0,0
STUB1,Stub1,5,0,5,63.407767,0,0
STUM,Stum,-4,6,2,2.805825,0,0
STX11,Stx11,19,-1,18,1.893204,0,0
STX12,Stx12,9,-7,2,10.873786,0,0
STX16,Stx16,4,-10,-6,76.970874,0,0
STX17,Stx17,0,-12,-12,3.679612,0,0
STX18,Stx18,2,4,6,38.339806,0,0
STX19,Stx19,-12,-4,-16,0,0,0
STX1A,Stx1a,12,-5,7,5.970874,0,0
STX1B,Stx1b,3,0,3,0,0,0
STX2,Stx2,3,-5,-2,66.990291,0,0
STX3,Stx3,1,3,4,2.514563,0,0
STX6,Stx6,11,1,12,15.339806,0,0
STX7,Stx7,7,-6,1,6.708738,0,0
STX8,Stx8,11,-3,8,11.582524,0,0
STXBP1,Stxbp1,6,-4,2,4.582524,0,0
STXBP2,Stxbp2,8,0,8,4.495146,0,0
STXBP3,Stxbp3,-3,-8,-11,7.912621,0,0
STXBP4,Stxbp4,0,-11,-11,23.737864,0,0
STXBP5,Stxbp5,5,-2,3,3.805825,0,0
STXBP5L,Stxbp5l,4,5,9,11.242718,0,0
STXBP6,Stxbp6,1,-8,-7,0,0,0
STYK1,Styk1,25,-6,19,0,0,0
STYX,Styx,3,-1,2,2.825243,0,0
STYXL1,Styxl1,9,-13,-4,6.572816,0,0
SUB1,Sub1,7,-5,2,10.213592,0,0
SUCLA2,Sucla2,4,-8,-4,0.902913,0,0
SUCLG1,Suclg1,4,-1,3,2.533981,0,0
SUCLG2,Suclg2,-2,-3,-5,4.76699,0,0
SUCNR1,Sucnr1,2,-9,-7,0,0,0
SUCO,Suco,6,-4,2,32.718447,0,0
SUDS3,Suds3,7,-1,6,4.61165,0,0
SUFU,Sufu,3,-6,-3,2.84466,0,0
SUGCT,Sugct,4,3,7,14.359223,0,0
SUGP1,Sugp1,1,-3,-2,12.291262,0,0
SUGP2,Sugp2,5,-10,-5,12.252427,6.166667,0
SUGT1,Sugt1,12,-1,11,136.990291,0,0
SULF1,Sulf1,4,-10,-6,0,0,0
SULF2,Sulf2,6,-1,5,1.699029,0,0
SULT1A1,Sult1a1,6,-1,5,0,0,0
SULT1B1,Sult1b1,1,5,6,1.038835,0,0
SULT1C2,Sult1c2,6,3,9,0,0,0
SULT1E1,Sult1e1,1,4,5,0,0,0
SULT2A1,Sult2a1,9,4,13,0,0,0
SULT2B1,Sult2b1,9,-8,1,52.466019,0,0
SULT4A1,Sult4a1,11,3,14,0,0,0
SULT6B1,Sult6b1,64,-5,59,2.553398,0,0
SUMF1,Sumf1,7,4,11,9.194175,0,0
SUMF2,Sumf2,5,2,7,3.825243,0,0
SUMO1,Sumo1,10,-5,5,1.165049,0,0
SUMO2,Sumo2,8,1,9,8.466019,0,0
SUMO3,Sumo3,6,0,6,0,0,0
SUN1,Sun1,4,-2,2,19.61165,0,0
SUN2,Sun2,1,0,1,2.23301,0,0
SUN3,Sun3,6,0,6,20.834951,0,0
SUN5,Sun5,4,-8,-4,0,0,0
SUOX,Suox,7,-4,3,0,0,0
SUPT7L,Supt7l,9,-2,7,1.815534,0,0
SUPV3L1,Supv3l1,3,-1,2,12.834951,0,0
SURF1,Surf1,7,-2,5,7.446602,0,0
SURF2,Surf2,6,-3,3,7.446602,0,0
SURF4,Surf4,7,-6,1,16.106796,0,0
SURF6,Surf6,6,-2,4,14.320388,0,0
SUSD1,Susd1,-2,-1,-3,5.097087,0,0
SUSD2,Susd2,13,5,18,0,0,0
SUSD3,Susd3,-9,14,5,1.106796,0,0
SUSD4,Susd4,-6,-4,-10,0,0,0
SUSD5,Susd5,4,-3,1,0,0,0
SUSD6,Susd6,4,-3,1,8.728155,0,0
SUV39H1,Suv39h1,-13,-4,-17,2.116505,0,0
SUV39H2,Suv39h2,3,-4,-1,4.475728,0,0
SUZ12,Suz12,4,-4,0,2.417476,0,0
SV2A,Sv2a,11,3,14,0,0,0
SV2B,Sv2b,-1,-3,-4,0,0,0
SV2C,Sv2c,3,0,3,0,0,0
SVBP,Svbp,6,-12,-6,6.242718,0,0
SVEP1,Svep1,3,2,5,0,0,0
SVIL,Svil,-1,0,-1,2.291262,0,0
SVIP,Svip,1,0,1,5.873786,0,0
SVOP,Svop,2,-3,-1,3.475728,0,0
SVOPL,Svopl,10,-2,8,0,0,0
SWAP70,Swap70,1,-4,-3,2.174757,0,0
SWI5,Swi5,5,2,7,16.864078,0,0
SWSAP1,Swsap1,-7,-10,-17,9.631068,0,0
SWT1,Swt1,9,10,19,0,0,0
SYAP1,Syap1,4,2,6,0,0,0
SYBU,Sybu,15,0,15,16.660194,0,0
SYCE1,Syce1,-4,2,-2,0,0,0
SYCE1L,Syce1l,-15,-6,-21,0,0,0
SYCE2,Syce2,18,-5,13,15.621359,0,0
SYCE3,Syce3,24,9,33,0.796117,0,0
SYCN,Sycn,4,11,15,12.572816,0,0
SYCP1,Sycp1,0,-6,-6,0,0,0
SYCP2,Sycp2,1,-1,0,5.757282,0,0
SYCP2L,Sycp2l,-4,-3,-7,0,0,0
SYCP3,Sycp3,28,-7,21,0,0,0
SYDE1,Syde1,-2,-1,-3,0,0,0
SYDE2,Syde2,5,2,7,4.524272,0,0
SYF2,Syf2,11,2,13,0,0,0
SYK,Syk,4,1,5,4.23301,0,0
SYMPK,Sympk,10,-3,7,0.737864,0,0
SYN1,Syn1,19,3,22,0,0,0
SYN2,Syn2,2,2,4,0,0,0
SYN3,Syn3,3,0,3,0,0,0
SYNC,Sync,-6,2,-4,25.660194,0,0
SYNCRIP,Syncrip,6,-8,-2,7.262136,0,0
SYNDIG1,Syndig1,-14,-3,-17,0,0,0
SYNDIG1L,Syndig1l,3,-5,-2,0,0,0
SYNE1,Syne1,18,-1,17,0,0,0
SYNE2,Syne2,8,1,9,8.330097,0,0
SYNE3,Syne3,4,-4,0,40.757282,0,0
SYNE4,Syne4,34,1,35,9.825243,0,0
SYNGAP1,Syngap1,11,-2,9,1.339806,0,0
SYNGR1,Syngr1,8,1,9,0,0,0
SYNGR2,Syngr2,4,0,4,20.359223,0,0
SYNGR3,Syngr3,4,4,8,0,0,0
SYNGR4,Syngr4,0,-14,-14,1.087379,0,0
SYNJ1,Synj1,8,-7,1,2.339806,0,0
SYNJ2,Synj2,1,-1,0,8.038835,0,0
SYNJ2BP,Synj2bp,3,-4,-1,0,0,0
SYNM,Synm,48,0,48,6.951456,0,0
SYNPO,Synpo,4,-4,0,2.718447,0,0
SYNPO2,Synpo2,2,-1,1,7.262136,0,0
SYNPO2L,Synpo2l,3,-6,-3,2.203883,0,0
SYNPR,Synpr,0,-1,-1,2.669903,0,0
SYNRG,Synrg,3,0,3,9.495146,0,0
SYP,Syp,4,1,5,10.873786,0,0
SYPL2,Sypl2,8,-2,6,0,0,0
SYS1,Sys1,3,-1,2,34.669903,0,0
SYT1,Syt1,6,0,6,0.718447,0,0
SYT10,Syt10,0,-7,-7,0,0,0
SYT11,Syt11,9,-2,7,0,0,0
SYT12,Syt12,-16,6,-10,0,0,0
SYT13,Syt13,1,-1,0,0,0,0
SYT14,Syt14,1,3,4,4.864078,0,0
SYT15,Syt15,11,1,12,0,0,0
SYT16,Syt16,3,-1,2,13.320388,0,0
SYT17,Syt17,4,-5,-1,13.23301,0,0
SYT2,Syt2,0,1,1,0,0,0
SYT3,Syt3,2,-2,0,0,0,0
SYT4,Syt4,5,3,8,0,0,0
SYT5,Syt5,8,0,8,77.067961,0,0
SYT6,Syt6,0,-1,-1,0,0,0
SYT7,Syt7,2,7,9,21.601942,0,0
SYT8,Syt8,11,4,15,60.135922,0,0
SYT9,Syt9,0,0,0,0,0,0
SYTL1,Sytl1,15,12,27,3.194175,0,0
SYTL2,Sytl2,-2,-1,-3,10.427184,0,0
SYTL3,Sytl3,4,-2,2,6.776699,0,0
SYTL4,Sytl4,2,0,2,0,0,0
SYTL5,Sytl5,2,-1,1,0,0,0
SYVN1,Syvn1,7,0,7,16.213592,0,0
SZRD1,Szrd1,7,-4,3,6.84466,0,0
SZT2,Szt2,8,-3,5,3.106796,0,0
TAAR1,Taar1,1,0,1,0,0,0
TAAR2,Taar2,1,1,2,0,0,0
TAAR5,Taar5,0,0,0,0,0,0
TAAR6,Taar6,1,0,1,0,0,0
TAAR9,Taar9,2,0,2,0,0,0
TAB1,Tab1,-16,-7,-23,13.330097,0,0
TAB2,Tab2,8,-6,2,3.92233,0,0
TAB3,Tab3,0,-5,-5,7.543689,0,0
TAC1,Tac1,11,-5,6,0,0,0
TAC4,Tac4,10,-8,2,13.359223,0,0
TACC1,Tacc1,6,1,7,16.834951,0,0
TACC2,Tacc2,-1,7,6,5.650485,0,0
TACC3,Tacc3,8,-5,3,6.650485,0,0
TACO1,Taco1,6,-6,0,27.592233,0,153
TACR1,Tacr1,1,0,1,0,0,0
TACR2,Tacr2,6,-2,4,0,0,0
TACR3,Tacr3,0,1,1,0,0,0
TACSTD2,Tacstd2,0,2,2,0.990291,0,0
TADA1,Tada1,-21,-5,-26,6.427184,0,0
TADA2A,Tada2a,-1,-6,-7,2.708738,0,0
TADA2B,Tada2b,9,-5,4,54.31068,0,0
TADA3,Tada3,6,-4,2,3.126214,0,0
TAF1,Taf1,9,-2,7,0,0,0
TAF10,Taf10,7,0,7,8.601942,0,0
TAF11,Taf11,5,-6,-1,8.281553,0,0
TAF12,Taf12,4,-5,-1,10.563107,0,0
TAF13,Taf13,9,-8,1,5.349515,0,0
TAF15,Taf15,5,-6,-1,2.291262,0,0
TAF1A,Taf1a,7,-2,5,2.61165,0,0
TAF1B,Taf1b,4,-4,0,20.339806,0,0
TAF1C,Taf1c,12,-2,10,5.485437,0,0
TAF1D,Taf1d,5,-11,-6,1.961165,0,0
TAF2,Taf2,5,-5,0,5.970874,0,0
TAF3,Taf3,5,-2,3,5.61165,0,0
TAF4,Taf4,6,-4,2,1.07767,0,0
TAF4B,Taf4b,2,0,2,4.495146,0,0
TAF5,Taf5,-8,-8,-16,3.84466,0,0
TAF5L,Taf5l,5,-4,1,7.349515,0,0
TAF6,Taf6,6,-9,-3,23.92233,0,0
TAF6L,Taf6l,-13,-3,-16,1.271845,0,0
TAF7,Taf7,12,-4,8,125.058252,0,0
TAF7L,Taf7l,10,1,11,0,0,0
TAF8,Taf8,2,-8,-6,1.330097,0,0
TAF9,Taf9,0,-6,-6,12.135922,0,0
TAF9B,Taf9b,4,-6,-2,3.757282,0,0
TAFA1,Tafa1,-4,10,6,0,0,0
TAFA2,Tafa2,1,-2,-1,0,0,0
TAFA3,Tafa3,2,-2,0,3.019417,0,0
TAFA4,Tafa4,5,-12,-7,0,0,0
TAFA5,Tafa5,5,8,13,6.15534,0,0
TAGAP,Tagap,6,-11,-5,10.339806,0,0
TAGLN,Tagln,-3,4,1,4.330097,0,0
TAGLN2,Tagln2,6,-4,2,7.621359,0,0
TAGLN3,Tagln3,20,-2,18,0,0,0
TAL1,Tal1,3,-4,-1,5.883495,0,0
TAL2,Tal2,49,-1,48,17.242718,0,0
TALDO1,Taldo1,8,1,9,3.718447,0,0
TAMALIN,Tamalin,2,0,2,6.135922,0,0
TAMM41,Tamm41,-6,-5,-11,7.359223,0,0
TANC1,Tanc1,3,-2,1,23.533981,0,0
TANC2,Tanc2,8,2,10,8.524272,0,0
TANGO2,Tango2,-1,-6,-7,2.252427,0,0
TANGO6,Tango6,0,-5,-5,10.553398,0,0
TANK,Tank,6,-3,3,6.563107,0,0
TAOK1,Taok1,8,-3,5,2.019417,0,0
TAOK2,Taok2,5,-5,0,16.699029,0,0
TAOK3,Taok3,8,1,9,19.135922,0,0
TAP1,Tap1,11,3,14,3.417476,0,0
TAP2,Tap2,0,-3,-3,5.174757,0,0
TAPBP,Tapbp,5,-5,0,6.737864,0,0
TAPBPL,Tapbpl,-3,1,-2,0,0,0
TAPT1,Tapt1,2,-6,-4,3.990291,0,0
TARBP1,Tarbp1,-1,-3,-4,6.097087,0,0
TARBP2,Tarbp2,4,-4,0,8.504854,0,0
TARDBP,Tardbp,12,-5,7,2.61165,0,0
TARM1,Tarm1,10,5,15,0,0,0
TARS2,Tars2,-3,-3,-6,0,0,0
TAS1R1,Tas1r1,2,-7,-5,11.970874,0,0
TAS1R2,Tas1r2,-1,5,4,0,0,0
TAS1R3,Tas1r3,8,-6,2,0,0,0
TASL,Tasl,0,-3,-3,0,0,0
TASOR,Tasor,7,-5,2,8.592233,0,0
TASOR2,Tasor2,5,-8,-3,0,0,0
TASP1,Tasp1,-1,-2,-3,18.262136,0,0
TAT,Tat,-3,9,6,0.76699,0,0
TATDN1,Tatdn1,0,-10,-10,13.776699,0,127
TATDN2,Tatdn2,8,-1,7,5.378641,0,0
TATDN3,Tatdn3,-8,-11,-19,18.300971,0,0
TAX1BP1,Tax1bp1,5,-2,3,65.174757,0,0
TAX1BP3,Tax1bp3,5,-1,4,3.378641,0,0
TBATA,Tbata,1,-10,-9,0,0,0
TBC1D1,Tbc1d1,7,-3,4,25.825243,0,0
TBC1D10A,Tbc1d10a,-6,-1,-7,2.135922,0,0
TBC1D10B,Tbc1d10b,5,-4,1,1.815534,0,0
TBC1D10C,Tbc1d10c,7,-3,4,9.475728,0,0
TBC1D12,Tbc1d12,8,1,9,6.135922,0,0
TBC1D13,Tbc1d13,4,-7,-3,24.514563,0,0
TBC1D14,Tbc1d14,5,-4,1,15.300971,0,0
TBC1D15,Tbc1d15,6,-1,5,0.640777,0,0
TBC1D16,Tbc1d16,-9,-6,-15,28.572816,0,0
TBC1D17,Tbc1d17,12,-2,10,2.203883,0,0
TBC1D19,Tbc1d19,-1,-8,-9,21.067961,0,0
TBC1D2,Tbc1d2,-5,-11,-16,0,0,0
TBC1D20,Tbc1d20,1,-4,-3,0,0,0
TBC1D21,Tbc1d21,0,2,2,0,0,0
TBC1D22A,Tbc1d22a,5,-1,4,8.679612,0,0
TBC1D22B,Tbc1d22b,5,-4,1,2.786408,0,0
TBC1D23,Tbc1d23,8,0,8,7.834951,0,0
TBC1D24,Tbc1d24,5,1,6,0.941748,0,0
TBC1D25,Tbc1d25,0,-6,-6,2.873786,0,0
TBC1D2B,Tbc1d2b,7,-7,0,1.31068,0,0
TBC1D30,Tbc1d30,10,-2,8,14.631068,0,0
TBC1D31,Tbc1d31,2,2,4,12.349515,0,0
TBC1D32,Tbc1d32,1,-3,-2,43.436893,0,0
TBC1D4,Tbc1d4,7,-4,3,1.912621,0,0
TBC1D5,Tbc1d5,8,-9,-1,11.650485,0,0
TBC1D7,Tbc1d7,4,-7,-3,5.786408,0,0
TBC1D8,Tbc1d8,-3,-9,-12,3.475728,0,0
TBC1D8B,Tbc1d8b,4,-4,0,0,0,0
TBC1D9,Tbc1d9,7,-2,5,1.504854,0,0
TBC1D9B,Tbc1d9b,10,-5,5,1.38835,0,0
TBCA,Tbca,5,-10,-5,3.38835,0,0
TBCB,Tbcb,-1,-9,-10,15.165049,0,0
TBCC,Tbcc,-9,0,-9,0.747573,0,0
TBCCD1,Tbccd1,6,-4,2,12.330097,0,0
TBCD,Tbcd,-9,0,-9,5.194175,0,0
TBCE,Tbce,2,-4,-2,0,0,0
TBCEL,Tbcel,4,-2,2,29.718447,0,0
TBCK,Tbck,1,-2,-1,0,0,0
TBK1,Tbk1,-11,-6,-17,6.116505,0,0
TBKBP1,Tbkbp1,4,5,9,2.436893,0,0
TBL1X,Tbl1x,2,0,2,4.902913,0,0
TBL1XR1,Tbl1xr1,9,0,9,21.359223,0,0
TBL2,Tbl2,2,-8,-6,3.456311,0,0
TBL3,Tbl3,9,-7,2,9.708738,0,0
TBP,Tbp,2,-2,0,2.776699,0,0
TBPL1,Tbpl1,9,-7,2,25.970874,0,0
TBPL2,Tbpl2,17,0,17,0,0,0
TBR1,Tbr1,57,3,60,1.757282,0,0
TBRG1,Tbrg1,2,-4,-2,5.650485,0,0
TBRG4,Tbrg4,-5,-4,-9,5.592233,0,0
TBX1,Tbx1,11,6,17,0,0,0
TBX10,Tbx10,2,-11,-9,17.087379,0,0
TBX15,Tbx15,-3,-7,-10,0.893204,0,0
TBX18,Tbx18,4,-2,2,4.194175,0,0
TBX19,Tbx19,2,-3,-1,0,0,0
TBX2,Tbx2,-1,3,2,7.223301,0,0
TBX20,Tbx20,5,-3,2,3.203883,0,0
TBX21,Tbx21,8,-3,5,0,0,0
TBX22,Tbx22,-2,1,-1,0,0,0
TBX3,Tbx3,43,6,49,19.883495,0,0
TBX4,Tbx4,3,-4,-1,8.262136,0,0
TBX5,Tbx5,-8,-10,-18,0,0,0
TBX6,Tbx6,3,4,7,8.291262,0,0
TBXA2R,Tbxa2r,2,3,5,0,0,0
TBXAS1,Tbxas1,12,-6,6,12.300971,0,0
TC2N,Tc2n,0,1,1,0,0,0
TCAF1,Tcaf1,7,-4,3,9.378641,0,97
TCAF2,Tcaf2,-3,6,3,7.048544,0,0
TCAIM,Tcaim,0,-4,-4,6.359223,0,0
TCAP,Tcap,39,5,44,0,0,0
TCEA1,Tcea1,8,-1,7,0,0,0
TCEA2,Tcea2,2,-18,-16,12.873786,0,0
TCEA3,Tcea3,9,-2,7,0,0,0
TCEAL1,Tceal1,3,-2,1,0,0,0
TCEAL3,Tceal3,9,-1,8,0,0,0
TCEAL5,Tceal5,2,13,15,0,0,0
TCEAL6,Tceal6,5,11,16,0,0,0
TCEAL7,Tceal7,17,1,18,0,0,0
TCEAL8,Tceal8,-1,1,0,3.048544,0,0
TCEAL9,Tceal9,35,2,37,19.116505,0,0
TCEANC,Tceanc,3,-5,-2,6.38835,0,0
TCEANC2,Tceanc2,3,0,3,0,0,0
TCERG1,Tcerg1,2,-2,0,4.504854,0,0
TCERG1L,Tcerg1l,0,-6,-6,0,0,0
TCF12,Tcf12,5,1,6,17.834951,0,0
TCF15,Tcf15,5,0,5,0,0,0
TCF19,Tcf19,-7,-5,-12,1.300971,0,0
TCF20,Tcf20,7,2,9,0,0,0
TCF21,Tcf21,-3,5,2,0,0,0
TCF23,Tcf23,0,8,8,0,0,0
TCF24,Tcf24,4,4,8,0,0,0
TCF25,Tcf25,3,-3,0,39.699029,0,0
TCF3,Tcf3,7,-7,0,3.184466,0,0
TCF4,Tcf4,2,-4,-2,13.932039,0,0
TCF7,Tcf7,3,-1,2,1.951456,0,0
TCF7L1,Tcf7l1,15,-6,9,0,0,0
TCF7L2,Tcf7l2,7,-6,1,10.68932,0,0
TCFL5,Tcfl5,1,1,2,0,0,0
TCHH,Tchh,2,-1,1,0,0,0
TCHHL1,Tchhl1,0,5,5,0,0,0
TCHP,Tchp,1,-9,-8,5.339806,0,0
TCIM,Tcim,3,8,11,0,0,0
TCIRG1,Tcirg1,-13,1,-12,0,0,0
TCN2,Tcn2,4,3,7,0,0,0
TCOF1,Tcof1,8,1,9,9.184466,0,0
TCP1,Tcp1,27,-2,25,439.330097,78.25,1196
TCP11,Tcp11,-1,4,3,0,0,0
TCP11L1,Tcp11l1,6,-5,1,6.300971,0,0
TCP11L2,Tcp11l2,12,1,13,13.737864,0,0
TCP11X2,Tcp11x2,1,-4,-3,0,0,0
TCTA,Tcta,6,-2,4,5.495146,0,0
TCTE1,Tcte1,39,-7,32,1.970874,0,0
TCTN1,Tctn1,9,-3,6,190.601942,42.208333,0
TCTN3,Tctn3,6,-5,1,11.737864,0,0
TDG,Tdg,0,-4,-4,31.650485,0,0
TDGF1,Tdgf1,9,12,21,1.776699,0,0
TDO2,Tdo2,-7,3,-4,0,0,0
TDP1,Tdp1,0,-9,-9,18.359223,0,0
TDP2,Tdp2,4,-3,1,33.757282,0,0
TDRD1,Tdrd1,2,0,2,14.951456,0,0
TDRD12,Tdrd12,1,-4,-3,0,0,0
TDRD3,Tdrd3,7,-2,5,1.262136,0,0
TDRD5,Tdrd5,0,-4,-4,1.543689,0,0
TDRD6,Tdrd6,14,-7,7,0,0,0
TDRD7,Tdrd7,1,-7,-6,21.601942,0,0
TDRD9,Tdrd9,0,1,1,0,0,0
TDRKH,Tdrkh,8,-8,0,1.572816,0,0
TDRP,Tdrp,5,6,11,12.174757,0,0
TEAD1,Tead1,11,4,15,4.582524,0,0
TEAD2,Tead2,3,-16,-13,0,0,0
TEAD3,Tead3,1,-5,-4,0.970874,0,0
TEAD4,Tead4,5,-5,0,8.145631,0,0
TEC,Tec,3,2,5,1.058252,0,0
TECPR1,Tecpr1,2,3,5,2.359223,0,0
TECPR2,Tecpr2,6,-3,3,108.631068,0,0
TECR,Tecr,10,-3,7,36.058252,10.833333,0
TECRL,Tecrl,5,5,10,0,0,0
TECTA,Tecta,1,1,2,0,0,0
TECTB,Tectb,2,-3,-1,0,0,0
TEDC1,Tedc1,-9,-11,-20,65.106796,0,0
TEDC2,Tedc2,3,-2,1,1.203883,0,0
TEF,Tef,11,-7,4,8.76699,0,0
TEFM,Tefm,6,-6,0,7.825243,0,0
TEK,Tek,12,-1,11,0,0,0
TEKT1,Tekt1,-8,-4,-12,1.883495,0,0
TEKT2,Tekt2,21,-7,14,18.31068,0,0
TEKT3,Tekt3,8,-7,1,0,0,0
TEKT4,Tekt4,1,-9,-8,0,0,0
TEKT5,Tekt5,-3,-3,-6,0,0,0
TELO2,Telo2,0,-4,-4,1.262136,0,0
TEN1,Ten1,9,0,9,4.970874,0,0
TENM1,Tenm1,1,1,2,0,0,0
TENM2,Tenm2,0,-2,-2,0.76699,0,0
TENM3,Tenm3,5,-7,-2,0,0,0
TENM4,Tenm4,-5,-11,-16,4.359223,0,0
TENT2,Tent2,3,-2,1,0,0,0
TENT4A,Tent4a,14,-9,5,23.902913,0,0
TENT4B,Tent4b,24,1,25,39.524272,0,0
TENT5A,Tent5a,127,10,137,67.009709,0,0
TENT5B,Tent5b,4,-7,-3,1.116505,0,0
TENT5C,Tent5c,45,5,50,32.834951,0,0
TENT5D,Tent5d,0,-8,-8,7.533981,0,0
TEP1,Tep1,6,-1,5,13.281553,0,0
TEPP,Tepp,-3,11,8,0,0,0
TEPSIN,Tepsin,10,-3,7,0,0,0
TERB1,Terb1,11,-12,-1,0,0,0
TERB2,Terb2,14,4,18,0,0,0
TERF1,Terf1,1,-1,0,3.475728,0,0
TERF2,Terf2,4,-3,1,18.533981,0,0
TERF2IP,Terf2ip,10,0,10,4.582524,0,0
TERT,Tert,-1,-8,-9,3.029126,0,0
TES,Tes,2,-6,-4,8.815534,0,0
TESC,Tesc,1,6,7,1.223301,0,0
TESK1,Tesk1,4,2,6,1.436893,0,0
TESK2,Tesk2,5,-8,-3,1.980583,0,0
TESMIN,Tesmin,-2,-3,-5,1.660194,0,0
TESPA1,Tespa1,2,-2,0,4.660194,0,0
TET1,Tet1,2,-13,-11,2.126214,0,0
TET2,Tet2,4,-4,0,4.31068,0,0
TET3,Tet3,8,0,8,6.708738,0,0
TEX10,Tex10,5,-1,4,13.436893,0,0
TEX101,Tex101,-1,0,-1,0,0,0
TEX11,Tex11,5,1,6,0,0,0
TEX12,Tex12,17,0,17,0,0,0
TEX13A,Tex13a,0,0,0,0,0,0
TEX13B,Tex13b,30,-6,24,0,0,0
TEX14,Tex14,13,-16,-3,12.019417,0,0
TEX15,Tex15,4,2,6,0.815534,0,0
TEX2,Tex2,2,-12,-10,9.320388,0,0
TEX22,Tex22,1,-8,-7,16.359223,0,0
TEX26,Tex26,-3,-6,-9,0,0,0
TEX261,Tex261,8,-9,-1,11.262136,0,0
TEX264,Tex264,4,0,4,31.456311,0,0
TEX28,Tex28,4,0,4,2.097087,0,0
TEX29,Tex29,30,10,40,2.368932,0,0
TEX30,Tex30,-3,-7,-10,8.601942,0,0
TEX33,Tex33,-2,-6,-8,0,0,0
TEX35,Tex35,6,-8,-2,0,0,0
TEX36,Tex36,-6,-4,-10,0,0,0
TEX37,Tex37,5,-1,4,0,0,0
TEX38,Tex38,-15,-18,-33,13.330097,0,0
TEX43,Tex43,119,16,135,0,0,0
TEX44,Tex44,1,0,1,0,0,0
TEX45,Tex45,13,4,17,0.941748,0,0
TEX46,Tex46,25,6,31,33.038835,0,0
TEX47,Tex47,0,-3,-3,0,0,0
TEX48,Tex48,0,-7,-7,0,0,0
TEX49,Tex49,0,-2,-2,5.349515,0,0
TEX50,Tex50,1,5,6,0,0,0
TEX52,Tex52,6,29,35,0,0,0
TEX55,Tex55,-1,0,-1,0,0,0
TEX9,Tex9,4,-11,-7,13.883495,0,0
TFAM,Tfam,10,-7,3,5.932039,0,0
TFAP2A,Tfap2a,6,4,10,0,0,0
TFAP2B,Tfap2b,1,0,1,0,0,0
TFAP2C,Tfap2c,7,0,7,1.660194,0,0
TFAP2D,Tfap2d,0,0,0,0,0,0
TFAP2E,Tfap2e,5,3,8,0,0,0
TFAP4,Tfap4,6,-2,4,3.009709,0,0
TFB1M,Tfb1m,1,-4,-3,4.582524,0,0
TFB2M,Tfb2m,5,-3,2,10.601942,0,0
TFCP2,Tfcp2,9,-6,3,0,0,0
TFCP2L1,Tfcp2l1,2,3,5,0,0,0
TFDP1,Tfdp1,12,-8,4,0,0,0
TFDP2,Tfdp2,6,1,7,0.864078,0,0
TFE3,Tfe3,9,8,17,1.92233,0,0
TFEB,Tfeb,4,-3,1,10.728155,0,0
TFEC,Tfec,-1,-5,-6,0,0,0
TFF1,Tff1,6,7,13,0,0,0
TFF2,Tff2,8,4,12,6.427184,0,0
TFF3,Tff3,0,4,4,13.145631,0,0
TFG,Tfg,5,-3,2,13.805825,0,0
TFIP11,Tfip11,6,0,6,10.087379,0,0
TFPI,Tfpi,7,-6,1,0,0,0
TFPI2,Tfpi2,-3,8,5,4.291262,0,0
TFPT,Tfpt,4,-2,2,17.320388,0,0
TFR2,Tfr2,-3,4,1,1.291262,0,0
TFRC,Tfrc,-2,-10,-12,18.165049,0,0
TG,Tg,33,3,36,16.038835,24.875,0
TGDS,Tgds,-4,-14,-18,4.68932,0,0
TGFA,Tgfa,-1,1,0,5.902913,0,0
TGFB1,Tgfb1,2,1,3,2.07767,0,0
TGFB1I1,Tgfb1i1,11,-11,0,0,0,0
TGFB2,Tgfb2,6,3,9,5.223301,0,0
TGFB3,Tgfb3,2,-4,-2,2.475728,0,0
TGFBI,Tgfbi,-2,1,-1,0,0,0
TGFBR1,Tgfbr1,-6,-6,-12,1.621359,0,0
TGFBR2,Tgfbr2,-5,0,-5,8.31068,0,0
TGFBR3,Tgfbr3,1,-3,-2,7.126214,0,0
TGFBR3L,Tgfbr3l,5,-20,-15,0,0,0
TGFBRAP1,Tgfbrap1,2,-3,-1,2.466019,0,0
TGIF1,Tgif1,-1,3,2,8.563107,0,0
TGIF2,Tgif2,6,-3,3,5.145631,0,0
TGM1,Tgm1,8,-4,4,0,0,0
TGM2,Tgm2,10,7,17,1.087379,0,0
TGM3,Tgm3,2,-3,-1,0,0,0
TGM4,Tgm4,11,-3,8,0,0,0
TGM5,Tgm5,2,2,4,0,0,0
TGM6,Tgm6,7,-1,6,0,0,0
TGM7,Tgm7,10,0,10,0,0,0
TGS1,Tgs1,-5,0,-5,9.213592,0,0
TH,Th,0,-4,-4,1.15534,0,0
THADA,Thada,5,-4,1,5.883495,0,0
THAP1,Thap1,7,-2,5,1.631068,0,0
THAP11,Thap11,9,-1,8,83.029126,0,0
THAP12,Thap12,4,-3,1,11.747573,0,0
THAP2,Thap2,16,-1,15,1.067961,0,0
THAP3,Thap3,10,-2,8,21.631068,0,0
THAP4,Thap4,6,-5,1,6.368932,0,0
THAP7,Thap7,-1,-4,-5,5.699029,0,0
THBD,Thbd,-1,-1,-2,0,0,0
THBS1,Thbs1,12,-5,7,7.194175,0,0
THBS2,Thbs2,-2,1,-1,0,0,0
THBS3,Thbs3,0,-2,-2,37.883495,0,0
THBS4,Thbs4,6,5,11,6.38835,0,0
THEG,Theg,7,0,7,0,0,0
THEGL,Thegl,79,9,88,46.640777,0,0
THEM4,Them4,3,-3,0,3.242718,0,0
THEM5,Them5,-3,7,4,0,0,0
THEM6,Them6,-2,-8,-10,13.038835,0,0
THEMIS,Themis,1,11,12,0,0,0
THEMIS2,Themis2,7,6,13,0,0,0
THG1L,Thg1l,3,-8,-5,21.029126,0,0
THNSL1,Thnsl1,-6,-11,-17,14.854369,0,0
THNSL2,Thnsl2,1,-2,-1,0,0,0
THOC1,Thoc1,2,-4,-2,13.271845,0,0
THOC2,Thoc2,4,0,4,1.893204,0,0
THOC3,Thoc3,-3,-2,-5,17.902913,0,0
THOC5,Thoc5,6,-8,-2,1.524272,0,0
THOC6,Thoc6,17,-5,12,3.669903,0,0
THOC7,Thoc7,4,-6,-2,1.815534,0,0
THOP1,Thop1,3,-11,-8,28.407767,0,0
THPO,Thpo,1,0,1,0,0,0
THRA,Thra,8,-3,5,0,0,0
THRAP3,Thrap3,5,-1,4,6.339806,0,0
THRB,Thrb,-1,2,1,1.76699,0,0
THRSP,Thrsp,2,-11,-9,0,0,0
THSD1,Thsd1,1,-7,-6,0,0,0
THSD4,Thsd4,0,1,1,3.514563,0,0
THSD7A,Thsd7a,1,-4,-3,4.038835,0,0
THSD7B,Thsd7b,1,-13,-12,0,0,0
THTPA,Thtpa,8,-12,-4,65.650485,0,0
THUMPD1,Thumpd1,8,-4,4,5.378641,0,0
THUMPD2,Thumpd2,-4,-6,-10,7.038835,0,0
THUMPD3,Thumpd3,9,-1,8,13.009709,0,0
THY1,Thy1,3,-1,2,0,0,0
THYN1,Thyn1,10,-4,6,5.951456,0,0
TIA1,Tia1,8,-4,4,31.271845,0,0
TIAL1,Tial1,7,-2,5,1.213592,0,0
TIAM1,Tiam1,2,-1,1,17.980583,0,0
TIAM2,Tiam2,14,-1,13,22.427184,7.083333,0
TICAM1,Ticam1,-5,5,0,5.873786,0,0
TICAM2,Ticam2,81,5,86,3.271845,0,0
TICRR,Ticrr,3,2,5,36.165049,0,0
TIE1,Tie1,3,3,6,0,0,0
TIFA,Tifa,-15,-2,-17,5.398058,0,0
TIFAB,Tifab,0,-2,-2,0,0,0
TIGAR,Tigar,1,-8,-7,6.466019,0,0
TIGD2,Tigd2,-4,-2,-6,10.825243,0,0
TIGD3,Tigd3,40,-2,38,11.019417,0,0
TIGD4,Tigd4,-3,0,-3,70.223301,0,0
TIGD5,Tigd5,-15,-13,-28,3.009709,0,0
TIGIT,Tigit,-1,1,0,0,0,0
TIMD4,Timd4,8,-1,7,0,0,0
TIMELESS,Timeless,10,-9,1,8.76699,0,0
TIMM10,Timm10,4,0,4,1.398058,0,0
TIMM10B,Timm10b,1,-4,-3,5.592233,0,0
TIMM13,Timm13,5,-3,2,3.184466,0,0
TIMM17A,Timm17a,3,1,4,0,0,0
TIMM17B,Timm17b,2,2,4,0,0,0
TIMM21,Timm21,7,-8,-1,307.864078,266.708333,229
TIMM22,Timm22,1,-1,0,9.640777,0,0
TIMM23,Timm23,8,-2,6,9.174757,0,0
TIMM29,Timm29,2,1,3,11.029126,0,0
TIMM44,Timm44,7,-3,4,8.533981,0,0
TIMM50,Timm50,3,-5,-2,3.757282,0,0
TIMM8B,Timm8b,3,-1,2,0,0,0
TIMM9,Timm9,3,-1,2,7.621359,0,0
TIMMDC1,Timmdc1,8,-2,6,14.84466,0,0
TIMP1,Timp1,5,12,17,2.747573,0,0
TIMP2,Timp2,11,-2,9,2.368932,0,0
TIMP3,Timp3,7,3,10,0,0,0
TIMP4,Timp4,-3,-4,-7,0,0,0
TINAG,Tinag,1,3,4,0,0,0
TINAGL1,Tinagl1,-1,-2,-3,0,0,0
TINCR,Tincr,4,7,11,0,0,0
TINF2,Tinf2,0,3,3,4.737864,0,0
TIPARP,Tiparp,12,3,15,6.087379,0,0
TIPIN,Tipin,2,-17,-15,3.485437,0,0
TIPRL,Tiprl,5,-5,0,6.407767,0,0
TIRAP,Tirap,-4,-5,-9,5.15534,0,0
TJAP1,Tjap1,10,-4,6,1.242718,0,0
TJP1,Tjp1,6,-2,4,7.466019,0,0
TJP2,Tjp2,9,-4,5,21.349515,0,0
TJP3,Tjp3,6,4,10,10.203883,0,0
TK1,Tk1,-3,-12,-15,5.019417,0,0
TK2,Tk2,1,2,3,3.718447,0,0
TKFC,Tkfc,6,-11,-5,13.009709,0,0
TKT,Tkt,5,-3,2,6.15534,0,0
TKTL1,Tktl1,9,11,20,2.097087,0,0
TKTL2,Tktl2,2,-1,1,0,0,0
TLCD1,Tlcd1,-12,-9,-21,3.864078,0,0
TLCD2,Tlcd2,7,-1,6,0.864078,0,0
TLCD3A,Tlcd3a,0,-10,-10,2.242718,0,0
TLCD3B,Tlcd3b,-7,-1,-8,1.116505,0,0
TLCD4,Tlcd4,3,-1,2,26.07767,4.166667,0
TLCD5,Tlcd5,4,-4,0,5.252427,0,0
TLDC2,Tldc2,-6,6,0,0,0,0
TLE1,Tle1,17,3,20,2.621359,0,0
TLE2,Tle2,11,5,16,0,0,0
TLE3,Tle3,9,0,9,5.466019,0,0
TLE4,Tle4,17,5,22,25.61165,0,0
TLE5,Tle5,7,7,14,0,0,0
TLE6,Tle6,3,6,9,0,0,0
TLE7,Tle7,3,1,4,0,0,0
TLK1,Tlk1,5,-3,2,4.621359,0,0
TLK2,Tlk2,6,1,7,5.815534,0,0
TLL1,Tll1,5,-2,3,14.15534,0,0
TLL2,Tll2,4,-2,2,1.543689,0,0
TLN1,Tln1,9,-8,1,13.184466,0,0
TLN2,Tln2,8,-8,0,0,0,0
TLNRD1,Tlnrd1,2,2,4,3.640777,0,0
TLR1,Tlr1,-10,-8,-18,0,0,0
TLR2,Tlr2,6,-10,-4,1.941748,0,0
TLR3,Tlr3,-11,-4,-15,0,0,0
TLR4,Tlr4,16,3,19,2.61165,0,0
TLR5,Tlr5,-1,-4,-5,1.834951,0,0
TLR6,Tlr6,-8,-2,-10,0,0,0
TLR7,Tlr7,4,-5,-1,0,0,0
TLR8,Tlr8,3,3,6,0,0,0
TLR9,Tlr9,37,3,40,0,0,0
TLX1,Tlx1,-6,2,-4,0,0,0
TLX2,Tlx2,9,2,11,0,0,0
TLX3,Tlx3,4,7,11,0,0,0
TM2D1,Tm2d1,11,-11,0,4.126214,0,0
TM2D2,Tm2d2,4,-5,-1,8.815534,0,0
TM2D3,Tm2d3,8,-9,-1,81.825243,0,0
TM4SF1,Tm4sf1,-4,-2,-6,0,0,0
TM4SF19,Tm4sf19,-2,0,-2,0,0,0
TM4SF20,Tm4sf20,11,-4,7,0,0,0
TM4SF4,Tm4sf4,2,2,4,4.902913,0,0
TM4SF5,Tm4sf5,2,-1,1,0,0,0
TM6SF1,Tm6sf1,4,-2,2,0,0,0
TM6SF2,Tm6sf2,24,3,27,3.747573,0,0
TM7SF2,Tm7sf2,14,-4,10,1.126214,0,0
TM7SF3,Tm7sf3,10,-7,3,26.514563,4.333333,0
TM9SF1,Tm9sf1,1,-6,-5,19.572816,0,0
TM9SF2,Tm9sf2,8,-4,4,1.242718,0,0
TM9SF3,Tm9sf3,7,-1,6,4.291262,0,0
TM9SF4,Tm9sf4,5,-2,3,3.019417,0,0
TMA16,Tma16,-1,-5,-6,13.699029,0,0
TMA7,Tma7,8,-2,6,0.796117,0,0
TMBIM1,Tmbim1,7,1,8,5.990291,0,0
TMBIM4,Tmbim4,-1,-5,-6,11.631068,0,0
TMBIM6,Tmbim6,10,-1,9,0,0,0
TMC1,Tmc1,2,-7,-5,2.194175,0,0
TMC2,Tmc2,1,0,1,0,0,0
TMC3,Tmc3,-3,-10,-13,0,0,0
TMC4,Tmc4,52,10,62,0,0,0
TMC5,Tmc5,2,-14,-12,10.970874,0,0
TMC6,Tmc6,4,6,10,0.932039,0,0
TMC7,Tmc7,2,-5,-3,7.747573,0,0
TMC8,Tmc8,11,6,17,0.932039,0,0
TMCC1,Tmcc1,-11,-2,-13,12.805825,0,0
TMCC2,Tmcc2,10,-4,6,2.495146,0,0
TMCC3,Tmcc3,2,-2,0,4.427184,0,0
TMCO1,Tmco1,11,1,12,0,0,0
TMCO2,Tmco2,21,1,22,0,0,0
TMCO3,Tmco3,7,0,7,10.737864,0,0
TMCO4,Tmco4,1,2,3,3.805825,0,0
TMCO6,Tmco6,-3,-7,-10,3.106796,0,0
TMDD1,Tmdd1,1,-8,-7,0,0,0
TMED1,Tmed1,-5,-2,-7,3.07767,0,0
TMED10,Tmed10,5,-4,1,12.271845,0,0
TMED2,Tmed2,7,-1,6,8.543689,0,0
TMED3,Tmed3,9,-4,5,3.873786,0,0
TMED4,Tmed4,3,-4,-1,3.757282,0,0
TMED5,Tmed5,8,-1,7,54.252427,19,0
TMED6,Tmed6,37,-7,30,0,0,0
TMED7,Tmed7,4,1,5,3.019417,0,0
TMED8,Tmed8,3,1,4,7.660194,0,0
TMED9,Tmed9,6,-6,0,10.708738,0,0
TMEFF1,Tmeff1,15,-9,6,0,0,0
TMEFF2,Tmeff2,13,-9,4,0.805825,0,0
TMEM100,Tmem100,45,-1,44,0,0,0
TMEM101,Tmem101,13,-2,11,14.825243,0,0
TMEM102,Tmem102,0,-6,-6,9.359223,0,0
TMEM104,Tmem104,1,-8,-7,21.495146,0,0
TMEM106A,Tmem106a,3,-3,0,0,0,0
TMEM106B,Tmem106b,-3,-1,-4,9.592233,0,0
TMEM106C,Tmem106c,8,-9,-1,3.475728,0,0
TMEM107,Tmem107,-1,-9,-10,32.563107,0,107
TMEM108,Tmem108,9,-3,6,0,0,0
TMEM109,Tmem109,3,-5,-2,7.048544,0,0
TMEM11,Tmem11,6,0,6,0,0,0
TMEM114,Tmem114,-3,1,-2,0,0,0
TMEM115,Tmem115,-4,-5,-9,3.23301,0,0
TMEM116,Tmem116,6,-9,-3,3.679612,0,0
TMEM117,Tmem117,3,5,8,4.281553,0,0
TMEM119,Tmem119,32,3,35,0,0,0
TMEM120A,Tmem120a,10,-4,6,4.485437,0,0
TMEM120B,Tmem120b,4,-3,1,5.320388,0,0
TMEM121,Tmem121,-3,-12,-15,10.68932,0,0
TMEM121B,Tmem121b,-1,7,6,0,0,0
TMEM123,Tmem123,10,-5,5,8.174757,0,0
TMEM125,Tmem125,-4,3,-1,2.582524,0,0
TMEM126A,Tmem126a,3,-4,-1,1.563107,0,0
TMEM126B,Tmem126b,8,-6,2,2.533981,0,0
TMEM127,Tmem127,10,-4,6,6.563107,0,0
TMEM128,Tmem128,0,-9,-9,4.621359,0,0
TMEM129,Tmem129,4,-3,1,6.650485,0,0
TMEM130,Tmem130,8,-11,-3,8.679612,0,0
TMEM131,Tmem131,8,2,10,16.135922,0,0
TMEM131L,Tmem131l,-13,-2,-15,2.106796,0,0
TMEM132A,Tmem132a,14,-6,8,25.737864,0,0
TMEM132B,Tmem132b,2,6,8,0,0,0
TMEM132C,Tmem132c,-2,3,1,0,0,0
TMEM132D,Tmem132d,-4,2,-2,0,0,0
TMEM132E,Tmem132e,5,-1,4,0,0,0
TMEM134,Tmem134,5,-2,3,0,0,0
TMEM135,Tmem135,-1,7,6,0,0,0
TMEM138,Tmem138,-1,1,0,6.029126,0,0
TMEM139,Tmem139,-4,-2,-6,5.31068,0,0
TMEM140,Tmem140,-2,7,5,0,0,0
TMEM141,Tmem141,5,9,14,2.514563,0,0
TMEM143,Tmem143,4,-6,-2,0,0,0
TMEM144,Tmem144,-5,-11,-16,1.485437,0,0
TMEM145,Tmem145,13,1,14,0,0,0
TMEM147,Tmem147,4,-11,-7,6.76699,0,0
TMEM14A,Tmem14a,9,-3,6,7.592233,0,0
TMEM14C,Tmem14c,5,-2,3,7.514563,0,0
TMEM150A,Tmem150a,12,-4,8,4.970874,0,0
TMEM150B,Tmem150b,11,-11,0,1.699029,0,0
TMEM150C,Tmem150c,1,-2,-1,0,0,0
TMEM151A,Tmem151a,3,-12,-9,15.271845,0,0
TMEM151B,Tmem151b,11,7,18,4.747573,0,0
TMEM154,Tmem154,2,-2,0,0,0,0
TMEM156,Tmem156,13,-2,11,0,0,0
TMEM158,Tmem158,-11,4,-7,1.932039,0,0
TMEM160,Tmem160,3,4,7,0,0,0
TMEM161A,Tmem161a,2,-10,-8,15.621359,0,0
TMEM161B,Tmem161b,3,-7,-4,6.31068,0,0
TMEM163,Tmem163,29,-7,22,1.475728,0,0
TMEM164,Tmem164,0,-6,-6,2.427184,0,0
TMEM165,Tmem165,-1,-4,-5,0,0,0
TMEM167B,Tmem167b,3,-5,-2,10.019417,0,0
TMEM168,Tmem168,7,-6,1,3.941748,0,0
TMEM169,Tmem169,3,-9,-6,4.165049,0,312
TMEM17,Tmem17,-3,-6,-9,31.485437,0,0
TMEM170B,Tmem170b,5,5,10,3.087379,0,0
TMEM171,Tmem171,3,3,6,1.427184,0,0
TMEM174,Tmem174,6,-1,5,0,0,0
TMEM175,Tmem175,1,-4,-3,8.572816,0,0
TMEM176A,Tmem176a,3,-2,1,0,0,0
TMEM176B,Tmem176b,0,0,0,4.436893,0,0
TMEM177,Tmem177,-21,-2,-23,3.747573,0,0
TMEM179,Tmem179,8,-14,-6,0,0,0
TMEM179B,Tmem179b,1,0,1,4.339806,0,0
TMEM18,Tmem18,-15,-10,-25,1.466019,0,0
TMEM182,Tmem182,0,-1,-1,1.592233,0,0
TMEM183A,Tmem183a,7,-10,-3,6.436893,0,0
TMEM184A,Tmem184a,8,6,14,6.718447,0,0
TMEM184B,Tmem184b,6,3,9,0.84466,0,0
TMEM184C,Tmem184c,7,-6,1,18.145631,0,0
TMEM185A,Tmem185a,1,-6,-5,2.271845,0,0
TMEM185B,Tmem185b,-2,0,-2,11.106796,0,0
TMEM186,Tmem186,1,-14,-13,22.864078,0,0
TMEM19,Tmem19,1,-3,-2,4.92233,0,0
TMEM190,Tmem190,19,-8,11,0,0,0
TMEM192,Tmem192,2,-5,-3,2.087379,0,0
TMEM196,Tmem196,0,4,4,0,0,0
TMEM198,Tmem198,14,1,15,1.116505,0,0
TMEM199,Tmem199,4,0,4,8.087379,0,0
TMEM200A,Tmem200a,-3,-5,-8,1.38835,0,0
TMEM200B,Tmem200b,0,12,12,0,0,0
TMEM200C,Tmem200c,10,-4,6,10.660194,0,0
TMEM201,Tmem201,1,-3,-2,3.398058,0,0
TMEM202,Tmem202,15,-3,12,0,0,0
TMEM203,Tmem203,0,-1,-1,5.650485,0,97
TMEM204,Tmem204,2,3,5,0,0,0
TMEM205,Tmem205,7,-4,3,5.417476,0,0
TMEM207,Tmem207,2,-1,1,0,0,0
TMEM208,Tmem208,5,0,5,6.61165,0,0
TMEM209,Tmem209,2,-10,-8,8.339806,0,0
TMEM210,Tmem210,34,7,41,0,0,0
TMEM212,Tmem212,3,-3,0,0,0,0
TMEM213,Tmem213,3,8,11,0,0,0
TMEM214,Tmem214,8,-5,3,9.902913,0,0
TMEM215,Tmem215,1,-1,0,0,0,0
TMEM216,Tmem216,51,-9,42,7.825243,0,0
TMEM217,Tmem217,18,-15,3,2.786408,0,0
TMEM218,Tmem218,0,-10,-10,2.621359,0,0
TMEM219,Tmem219,9,-15,-6,5.631068,0,0
TMEM220,Tmem220,-11,-8,-19,0,0,0
TMEM221,Tmem221,8,8,16,3.543689,0,0
TMEM222,Tmem222,6,1,7,28.398058,0,0
TMEM223,Tmem223,11,5,16,3.543689,0,0
TMEM225,Tmem225,2,-7,-5,0,0,0
TMEM229A,Tmem229a,0,0,0,1.805825,0,0
TMEM229B,Tmem229b,-2,3,1,6.126214,0,0
TMEM230,Tmem230,7,-1,6,6.514563,0,0
TMEM231,Tmem231,8,-1,7,60.15534,0,0
TMEM232,Tmem232,14,-3,11,13.300971,0,0
TMEM233,Tmem233,0,6,6,0,0,0
TMEM234,Tmem234,12,1,13,14.621359,0,0
TMEM235,Tmem235,28,-6,22,0,0,0
TMEM236,Tmem236,3,-1,2,0,0,0
TMEM237,Tmem237,5,-12,-7,10.019417,0,0
TMEM238,Tmem238,37,2,39,14,0,0
TMEM238L,Tmem238l,6,2,8,0,0,0
TMEM239,Tmem239,-1,4,3,0,0,0
TMEM240,Tmem240,35,-3,32,0,0,0
TMEM241,Tmem241,3,-6,-3,1.427184,0,0
TMEM242,Tmem242,1,-5,-4,28.805825,0,0
TMEM243,Tmem243,0,-10,-10,5.873786,0,0
TMEM245,Tmem245,6,-2,4,7.368932,0,0
TMEM247,Tmem247,3,-1,2,0,0,0
TMEM248,Tmem248,5,-6,-1,16.31068,0,0
TMEM249,Tmem249,13,-19,-6,42.349515,11.208333,0
TMEM25,Tmem25,13,0,13,0.893204,0,0
TMEM252,Tmem252,-4,16,12,0,0,0
TMEM253,Tmem253,10,-8,2,22.359223,0,0
TMEM255A,Tmem255a,4,-6,-2,0,0,0
TMEM255B,Tmem255b,3,-3,0,0,0,0
TMEM256,Tmem256,1,-3,-2,0,0,0
TMEM258,Tmem258,6,-9,-3,4.961165,0,0
TMEM259,Tmem259,9,-4,5,101.126214,0,0
TMEM26,Tmem26,-5,-3,-8,0,0,0
TMEM260,Tmem260,11,-6,5,6.932039,0,0
TMEM262,Tmem262,41,-13,28,18.902913,0,0
TMEM263,Tmem263,5,-4,1,17.07767,0,0
TMEM265,Tmem265,-5,-6,-11,0,0,0
TMEM266,Tmem266,13,-1,12,0,0,0
TMEM267,Tmem267,4,-7,-3,21.679612,0,0
TMEM268,Tmem268,4,-3,1,5.640777,0,0
TMEM269,Tmem269,11,6,17,0,0,0
TMEM270,Tmem270,5,6,11,0,0,0
TMEM273,Tmem273,3,0,3,0,0,0
TMEM30A,Tmem30a,5,-3,2,4.805825,0,0
TMEM30B,Tmem30b,-2,5,3,5.650485,0,0
TMEM33,Tmem33,9,8,17,4.757282,0,0
TMEM35A,Tmem35a,0,9,9,0,0,0
TMEM35B,Tmem35b,0,-4,-4,2.300971,0,0
TMEM37,Tmem37,30,-2,28,24.320388,0,0
TMEM38A,Tmem38a,3,-2,1,3.582524,0,0
TMEM38B,Tmem38b,5,-1,4,3.368932,0,0
TMEM39A,Tmem39a,5,1,6,0,0,0
TMEM39B,Tmem39b,6,-14,-8,11.067961,0,0
TMEM40,Tmem40,2,-5,-3,1.029126,0,0
TMEM41A,Tmem41a,4,-11,-7,38.660194,0,0
TMEM41B,Tmem41b,0,6,6,0,0,0
TMEM42,Tmem42,5,-9,-4,2.165049,0,0
TMEM43,Tmem43,0,0,0,8.708738,0,0
TMEM44,Tmem44,6,-2,4,5.893204,0,0
TMEM45A,Tmem45a,7,-11,-4,13,0,0
TMEM45B,Tmem45b,4,0,4,0,0,0
TMEM47,Tmem47,18,0,18,3.291262,0,0
TMEM50A,Tmem50a,5,3,8,3.38835,0,0
TMEM50B,Tmem50b,6,-9,-3,1.834951,0,0
TMEM51,Tmem51,8,2,10,5.796117,0,0
TMEM52,Tmem52,-7,-1,-8,0,0,0
TMEM52B,Tmem52b,2,1,3,0,0,0
TMEM53,Tmem53,3,-3,0,14.815534,0,0
TMEM54,Tmem54,1,-2,-1,2.145631,0,0
TMEM59,Tmem59,8,2,10,2.893204,0,0
TMEM59L,Tmem59l,15,-2,13,0,0,0
TMEM60,Tmem60,-2,-4,-6,7.048544,0,0
TMEM61,Tmem61,-3,-2,-5,0,0,0
TMEM62,Tmem62,-4,0,-4,6.417476,0,0
TMEM63A,Tmem63a,1,-9,-8,2.38835,0,0
TMEM63B,Tmem63b,9,1,10,10.349515,0,0
TMEM63C,Tmem63c,0,-5,-5,0,0,0
TMEM64,Tmem64,2,-1,1,6.951456,0,0
TMEM65,Tmem65,0,1,1,12.116505,0,0
TMEM67,Tmem67,6,-4,2,36.07767,0,0
TMEM68,Tmem68,2,-4,-2,9.213592,0,0
TMEM69,Tmem69,1,1,2,3.718447,0,0
TMEM70,Tmem70,6,0,6,9.145631,5.166667,0
TMEM71,Tmem71,-8,2,-6,17.524272,0,0
TMEM72,Tmem72,1,-5,-4,0,0,0
TMEM74,Tmem74,0,0,0,10.485437,0,0
TMEM74B,Tmem74b,1,1,2,0,0,0
TMEM79,Tmem79,17,-7,10,86.902913,0,0
TMEM80,Tmem80,6,5,11,2.067961,0,0
TMEM81,Tmem81,20,-14,6,0,0,0
TMEM82,Tmem82,4,2,6,0,0,0
TMEM86A,Tmem86a,-16,4,-12,0.873786,0,0
TMEM86B,Tmem86b,-7,-5,-12,0,0,0
TMEM87A,Tmem87a,1,-6,-5,3.339806,0,0
TMEM87B,Tmem87b,0,-2,-2,7.631068,0,0
TMEM88,Tmem88,15,-2,13,4.514563,0,0
TMEM88B,Tmem88b,8,-6,2,57.223301,0,0
TMEM89,Tmem89,-17,-31,-48,2.15534,0,0
TMEM8B,Tmem8b,10,-6,4,4.631068,0,0
TMEM9,Tmem9,5,-4,1,90.747573,3.166667,0
TMEM91,Tmem91,7,-8,-1,32.320388,0,0
TMEM92,Tmem92,14,-1,13,14.970874,0,0
TMEM94,Tmem94,6,-7,-1,22.776699,0,0
TMEM95,Tmem95,99,-3,96,142.961165,0,0
TMEM97,Tmem97,5,-2,3,24.436893,0,0
TMEM98,Tmem98,10,1,11,0,0,0
TMEM9B,Tmem9b,3,-1,2,5.543689,0,0
TMF1,Tmf1,3,-1,2,4.990291,0,0
TMIE,Tmie,42,3,45,28.456311,0,0
TMIGD1,Tmigd1,-1,11,10,0,0,0
TMIGD3,Tmigd3,9,-9,0,0,0,0
TMOD1,Tmod1,-1,1,0,0,0,0
TMOD2,Tmod2,5,-4,1,2.126214,0,0
TMOD3,Tmod3,5,0,5,3.407767,0,0
TMOD4,Tmod4,-7,-4,-11,0,0,0
TMPO,Tmpo,6,-2,4,23.097087,0,0
TMPPE,Tmppe,13,-9,4,4.087379,0,0
TMPRSS11A,Tmprss11a,2,-2,0,0,0,0
TMPRSS11B,Tmprss11b,10,-5,5,0,0,0
TMPRSS11D,Tmprss11d,1,-3,-2,0,0,0
TMPRSS11E,Tmprss11e,2,0,2,0,0,0
TMPRSS11F,Tmprss11f,0,-3,-3,0,0,0
TMPRSS12,Tmprss12,5,1,6,0,0,0
TMPRSS13,Tmprss13,23,5,28,0,0,0
TMPRSS15,Tmprss15,-5,-5,-10,0,0,0
TMPRSS2,Tmprss2,0,4,4,0,0,0
TMPRSS3,Tmprss3,2,6,8,0,0,0
TMPRSS4,Tmprss4,4,2,6,35.291262,0,0
TMPRSS5,Tmprss5,0,5,5,0,0,0
TMPRSS6,Tmprss6,14,-7,7,0,0,0
TMPRSS7,Tmprss7,-2,-2,-4,0,0,0
TMPRSS9,Tmprss9,72,7,79,0,0,0
TMSB10,Tmsb10,7,-3,4,8.368932,0,0
TMSB15A,Tmsb15a,8,-7,1,0,0,0
TMSB4X,Tmsb4x,13,-5,8,6.533981,0,0
TMTC1,Tmtc1,5,2,7,7.747573,0,0
TMTC2,Tmtc2,10,-1,9,2.524272,0,0
TMTC3,Tmtc3,4,-6,-2,12.786408,0,0
TMTC4,Tmtc4,-8,-5,-13,4.300971,0,0
TMUB1,Tmub1,6,-2,4,2.223301,0,0
TMUB2,Tmub2,3,-3,0,0,0,0
TMX1,Tmx1,7,-2,5,5.912621,0,0
TMX2,Tmx2,7,-4,3,3.815534,0,0
TMX3,Tmx3,5,-4,1,9.116505,0,0
TMX4,Tmx4,4,-2,2,48.252427,0,0
TNC,Tnc,8,-7,1,0,0,0
TNF,Tnf,68,4,72,0,0,0
TNFAIP1,Tnfaip1,14,-4,10,10.92233,0,0
TNFAIP2,Tnfaip2,-1,-4,-5,1.359223,0,0
TNFAIP3,Tnfaip3,30,0,30,3.223301,0,0
TNFAIP6,Tnfaip6,2,-3,-1,0,0,0
TNFAIP8,Tnfaip8,-3,-8,-11,6.640777,0,0
TNFAIP8L1,Tnfaip8l1,1,-9,-8,3.718447,0,0
TNFAIP8L2,Tnfaip8l2,3,-3,0,2.320388,0,0
TNFAIP8L3,Tnfaip8l3,1,2,3,0,0,0
TNFRSF10B,Tnfrsf10b,3,-1,2,0,0,0
TNFRSF11A,Tnfrsf11a,11,-3,8,1.339806,0,0
TNFRSF11B,Tnfrsf11b,0,-3,-3,4.194175,0,0
TNFRSF12A,Tnfrsf12a,0,14,14,3.669903,0,0
TNFRSF13B,Tnfrsf13b,2,-5,-3,0,0,0
TNFRSF13C,Tnfrsf13c,2,9,11,0,0,0
TNFRSF14,Tnfrsf14,12,-3,9,6.815534,0,0
TNFRSF17,Tnfrsf17,12,-9,3,0,0,0
TNFRSF18,Tnfrsf18,33,-2,31,0,0,0
TNFRSF19,Tnfrsf19,3,2,5,4.165049,0,0
TNFRSF1A,Tnfrsf1a,7,2,9,0.61165,0,0
TNFRSF1B,Tnfrsf1b,-3,-3,-6,1.038835,0,0
TNFRSF21,Tnfrsf21,-1,-3,-4,2.116505,0,0
TNFRSF25,Tnfrsf25,1,11,12,0,0,0
TNFRSF4,Tnfrsf4,33,-8,25,22.805825,0,0
TNFRSF8,Tnfrsf8,0,-2,-2,0,0,0
TNFRSF9,Tnfrsf9,2,-14,-12,0,0,0
TNFSF10,Tnfsf10,0,-1,-1,0,0,0
TNFSF11,Tnfsf11,4,1,5,0,0,0
TNFSF12,Tnfsf12,4,-2,2,0,0,0
TNFSF13,Tnfsf13,-5,-7,-12,44.679612,0,0
TNFSF13B,Tnfsf13b,8,-8,0,0,0,0
TNFSF14,Tnfsf14,31,2,33,11.485437,0,0
TNFSF15,Tnfsf15,4,-2,2,0,0,0
TNFSF18,Tnfsf18,2,11,13,0,0,0
TNFSF4,Tnfsf4,2,7,9,0,0,0
TNFSF8,Tnfsf8,-1,0,-1,4.524272,0,0
TNFSF9,Tnfsf9,5,13,18,10.864078,0,0
TNIK,Tnik,10,3,13,1.970874,0,0
TNIP1,Tnip1,15,1,16,7.68932,0,0
TNIP2,Tnip2,3,-1,2,12.699029,0,0
TNIP3,Tnip3,3,2,5,0,0,0
TNK1,Tnk1,9,-2,7,0,0,0
TNK2,Tnk2,6,-5,1,3.281553,0,0
TNKS,Tnks,5,-3,2,5.203883,0,0
TNKS1BP1,Tnks1bp1,2,-4,-2,3.485437,0,0
TNKS2,Tnks2,5,-2,3,5.038835,0,0
TNMD,Tnmd,0,2,2,0,0,0
TNN,Tnn,32,3,35,0,0,0
TNNC1,Tnnc1,13,5,18,3.84466,0,0
TNNC2,Tnnc2,30,2,32,15.067961,0,0
TNNI1,Tnni1,1,5,6,0,0,0
TNNI2,Tnni2,18,-2,16,60.135922,0,0
TNNI3,Tnni3,10,-16,-6,9.106796,0,0
TNNI3K,Tnni3k,5,-1,4,0,0,0
TNNT1,Tnnt1,5,10,15,2.38835,0,0
TNNT2,Tnnt2,8,0,8,0,0,0
TNNT3,Tnnt3,4,1,5,0,0,0
TNP1,Tnp1,-2,-1,-3,0,0,0
TNP2,Tnp2,-3,-5,-8,0,0,0
TNPO1,Tnpo1,4,-2,2,63.660194,0,0
TNPO2,Tnpo2,5,-1,4,2.718447,0,0
TNPO3,Tnpo3,7,-2,5,6.601942,0,0
TNR,Tnr,0,-3,-3,0,0,0
TNRC18,Tnrc18,4,-3,1,18.223301,0,0
TNRC6A,Tnrc6a,6,-10,-4,21.281553,0,0
TNRC6B,Tnrc6b,9,-7,2,1,0,0
TNRC6C,Tnrc6c,8,-2,6,0,0,0
TNS1,Tns1,-7,-4,-11,0,0,0
TNS2,Tns2,6,1,7,3.660194,0,0
TNS3,Tns3,2,4,6,2.747573,0,0
TNS4,Tns4,-18,-6,-24,5.815534,0,0
TNXB,Tnxb,8,0,8,5.184466,0,0
TOB1,Tob1,7,-6,1,18.456311,0,0
TOB2,Tob2,14,1,15,16.553398,0,0
TOE1,Toe1,-14,-4,-18,8.932039,0,0
TOGARAM1,Togaram1,9,-1,8,4.194175,0,0
TOGARAM2,Togaram2,7,-3,4,11.271845,0,0
TOLLIP,Tollip,3,-5,-2,1.106796,0,0
TOM1,Tom1,2,-3,-1,0.796117,0,0
TOM1L1,Tom1l1,2,0,2,21.543689,0,0
TOM1L2,Tom1l2,-5,0,-5,15.174757,0,0
TOMM20,Tomm20,7,-5,2,2.466019,0,0
TOMM20L,Tomm20l,9,-3,6,19.485437,0,0
TOMM22,Tomm22,5,0,5,17.485437,0,0
TOMM34,Tomm34,3,-4,-1,24.912621,0,0
TOMM40,Tomm40,6,-4,2,3.116505,0,0
TOMM40L,Tomm40l,-5,-7,-12,2.951456,0,0
TOMM5,Tomm5,5,-6,-1,5.135922,0,0
TOMM6,Tomm6,10,-7,3,7.990291,0,0
TOMM7,Tomm7,4,-4,0,8.941748,0,0
TONSL,Tonsl,1,-6,-5,5.271845,0,0
TOP1,Top1,9,1,10,7.854369,0,0
TOP1MT,Top1mt,9,-3,6,1.941748,0,0
TOP2A,Top2a,1,-13,-12,1.203883,0,0
TOP2B,Top2b,6,4,10,3.601942,0,0
TOP3A,Top3a,3,-1,2,2.203883,0,0
TOP3B,Top3b,5,-6,-1,21.514563,0,0
TOPAZ1,Topaz1,0,0,0,0,0,0
TOPBP1,Topbp1,2,0,2,4.058252,0,0
TOPORS,Topors,3,1,4,2.029126,0,0
TOR1A,Tor1a,-1,-2,-3,11.038835,0,0
TOR1AIP1,Tor1aip1,4,0,4,17.184466,0,0
TOR1AIP2,Tor1aip2,5,-1,4,17.184466,0,0
TOR1B,Tor1b,6,-4,2,6.417476,0,0
TOR2A,Tor2a,-1,-1,-2,62.601942,0,0
TOR3A,Tor3a,2,6,8,46.038835,0,0
TOR4A,Tor4a,2,-3,-1,2.893204,0,0
TOX,Tox,0,-8,-8,3.456311,0,0
TOX2,Tox2,4,4,8,0.893204,0,0
TOX3,Tox3,5,0,5,0,0,0
TOX4,Tox4,7,-5,2,14.84466,0,0
TPBG,Tpbg,3,-2,1,25.660194,0,0
TPBGL,Tpbgl,0,3,3,9.776699,0,0
TPCN1,Tpcn1,0,-3,-3,5.436893,0,0
TPCN2,Tpcn2,4,-3,1,1.407767,0,0
TPD52,Tpd52,-1,4,3,51.029126,12.875,0
TPD52L1,Tpd52l1,5,6,11,9.893204,0,0
TPD52L2,Tpd52l2,10,-4,6,140.76699,23.416667,0
TPGS1,Tpgs1,-8,-5,-13,19.533981,0,0
TPGS2,Tpgs2,7,-2,5,3.271845,0,0
TPH1,Tph1,-1,3,2,0,0,0
TPH2,Tph2,29,0,29,1.31068,0,0
TPI1,Tpi1,8,-1,7,0.84466,0,0
TPK1,Tpk1,-5,-3,-8,17.145631,0,0
TPM1,Tpm1,6,4,10,35.475728,0,0
TPM2,Tpm2,10,-4,6,0.951456,0,0
TPM3,Tpm3,9,-4,5,11.805825,0,0
TPM4,Tpm4,1,2,3,38.883495,0,0
TPMT,Tpmt,3,-5,-2,4.165049,0,0
TPO,Tpo,-1,-6,-7,0,0,0
TPP1,Tpp1,16,5,21,26.378641,0,0
TPP2,Tpp2,7,-2,5,1.320388,0,0
TPPP,Tppp,3,-13,-10,0,0,0
TPPP2,Tppp2,10,5,15,0,0,0
TPPP3,Tppp3,24,0,24,0,0,0
TPR,Tpr,4,-3,1,2.912621,0,0
TPRA1,Tpra1,7,-4,3,4.330097,0,0
TPRKB,Tprkb,7,1,8,12.650485,0,0
TPRN,Tprn,1,-7,-6,7.553398,0,97
TPSAB1,Tpsab1,3,-2,1,0,0,0
TPSB2,Tpsb2,14,4,18,0,0,0
TPSG1,Tpsg1,-2,5,3,0,0,0
TPST1,Tpst1,2,-11,-9,25.048544,0,0
TPST2,Tpst2,8,1,9,30.796117,0,0
TPT1,Tpt1,13,4,17,145.203883,35.791667,0
TPTE,Tpte,-4,-12,-16,0,0,0
TPX2,Tpx2,2,-8,-6,2.61165,0,0
TRA2A,Tra2a,7,1,8,3.038835,0,0
TRA2B,Tra2b,11,0,11,362.15534,151.666667,165
TRABD,Trabd,1,-4,-3,4.980583,0,0
TRABD2B,Trabd2b,0,-2,-2,0,0,0
TRAC,Trac,-3,10,7,0,0,0
TRADD,Tradd,-7,-2,-9,4.106796,0,0
TRAF1,Traf1,-6,-8,-14,4.262136,0,0
TRAF2,Traf2,9,-4,5,70.601942,6.041667,0
TRAF3,Traf3,0,1,1,50.029126,18.25,0
TRAF3IP1,Traf3ip1,4,-12,-8,54.427184,0,0
TRAF3IP2,Traf3ip2,-1,-1,-2,1.300971,0,0
TRAF3IP3,Traf3ip3,57,-7,50,0.854369,0,0
TRAF4,Traf4,8,-10,-2,6.320388,0,0
TRAF5,Traf5,-2,-2,-4,2.427184,0,0
TRAF6,Traf6,4,-1,3,19.194175,0,0
TRAF7,Traf7,5,-4,1,3.359223,0,0
TRAFD1,Trafd1,6,-16,-10,1.84466,0,0
TRAIP,Traip,1,-3,-2,1.07767,0,0
TRAJ11,Traj11,-1,0,-1,0,0,0
TRAJ12,Traj12,2,0,2,0,0,0
TRAJ13,Traj13,3,0,3,0,0,0
TRAJ16,Traj16,-3,0,-3,0,0,0
TRAJ17,Traj17,-3,1,-2,0,0,0
TRAJ18,Traj18,0,2,2,0,0,0
TRAJ19,Traj19,0,-8,-8,0,0,0
TRAJ2,Traj2,0,-2,-2,0,0,0
TRAJ20,Traj20,2,1,3,0,0,0
TRAJ21,Traj21,0,-9,-9,0,0,0
TRAJ22,Traj22,1,0,1,0,0,0
TRAJ23,Traj23,2,1,3,0,0,0
TRAJ24,Traj24,0,-3,-3,0,0,0
TRAJ25,Traj25,-1,-1,-2,0,0,0
TRAJ26,Traj26,-2,-3,-5,0,0,0
TRAJ27,Traj27,-1,0,-1,0,0,0
TRAJ28,Traj28,-1,2,1,0,0,0
TRAJ29,Traj29,-1,1,0,0,0,0
TRAJ3,Traj3,0,0,0,0,0,0
TRAJ30,Traj30,1,-3,-2,0,0,0
TRAJ31,Traj31,2,-5,-3,0,0,0
TRAJ32,Traj32,-1,0,-1,0,0,0
TRAJ33,Traj33,-5,-12,-17,0,0,0
TRAJ34,Traj34,0,7,7,0,0,0
TRAJ35,Traj35,1,2,3,0,0,0
TRAJ37,Traj37,2,0,2,0,0,0
TRAJ38,Traj38,-1,1,0,0,0,0
TRAJ39,Traj39,1,0,1,0,0,0
TRAJ4,Traj4,-1,0,-1,0,0,0
TRAJ40,Traj40,1,0,1,0,0,0
TRAJ41,Traj41,1,3,4,0,0,0
TRAJ42,Traj42,0,1,1,0,0,0
TRAJ43,Traj43,-1,0,-1,0,0,0
TRAJ44,Traj44,0,0,0,0,0,0
TRAJ45,Traj45,0,1,1,0,0,0
TRAJ46,Traj46,-2,-1,-3,0,0,0
TRAJ47,Traj47,0,0,0,0,0,0
TRAJ48,Traj48,-2,0,-2,0,0,0
TRAJ49,Traj49,-1,1,0,0,0,0
TRAJ5,Traj5,0,0,0,0,0,0
TRAJ50,Traj50,0,-3,-3,0,0,0
TRAJ52,Traj52,0,-2,-2,0,0,0
TRAJ53,Traj53,-1,3,2,0,0,0
TRAJ56,Traj56,0,0,0,0,0,0
TRAJ57,Traj57,0,-1,-1,0,0,0
TRAJ59,Traj59,0,1,1,0,0,0
TRAJ6,Traj6,-3,2,-1,0,0,0
TRAJ7,Traj7,-4,1,-3,0,0,0
TRAJ9,Traj9,-1,-3,-4,0,0,0
TRAK1,Trak1,6,-1,5,0,0,0
TRAK2,Trak2,0,-6,-6,9.106796,0,0
TRAM1,Tram1,7,-2,5,25.116505,0,0
TRAM1L1,Tram1l1,-12,-11,-23,0,0,0
TRAM2,Tram2,4,-7,-3,11.174757,0,0
TRANK1,Trank1,-2,4,2,0,0,0
TRAP1,Trap1,8,-1,7,8.038835,0,0
TRAPPC1,Trappc1,8,-3,5,0,0,0
TRAPPC10,Trappc10,-1,-9,-10,4.640777,0,0
TRAPPC11,Trappc11,1,-4,-3,2.815534,0,0
TRAPPC12,Trappc12,7,-2,5,6.116505,0,0
TRAPPC13,Trappc13,4,0,4,0,0,0
TRAPPC2,Trappc2,2,-11,-9,3.31068,0,0
TRAPPC2L,Trappc2l,6,-4,2,79.601942,0,0
TRAPPC3,Trappc3,9,-7,2,11.339806,0,0
TRAPPC3L,Trappc3l,4,-3,1,0,0,0
TRAPPC4,Trappc4,12,-1,11,0,0,0
TRAPPC5,Trappc5,5,-1,4,13.757282,0,0
TRAPPC6A,Trappc6a,-4,0,-4,0,0,0
TRAPPC6B,Trappc6b,6,2,8,24.407767,0,142
TRAPPC8,Trappc8,4,-1,3,3.553398,0,0
TRAPPC9,Trappc9,-1,-4,-5,17.07767,0,0
TRARG1,Trarg1,6,-7,-1,0,0,0
TRAT1,Trat1,2,-1,1,0,0,0
TRAV10,Trav10,2,0,2,0,0,0
TRAV12-1,Trav12-1,0,6,6,0,0,0
TRAV12-2,Trav12-2,-1,5,4,0,0,0
TRAV12-3,Trav12-3,0,1,1,0,0,0
TRAV13-1,Trav13-1,0,1,1,0,0,0
TRAV13-2,Trav13-2,-5,-23,-28,0,0,0
TRAV16,Trav16,0,0,0,0,0,0
TRAV17,Trav17,-1,4,3,0,0,0
TRAV18,Trav18,-19,0,-19,0,0,0
TRAV19,Trav19,-3,-2,-5,0,0,0
TRAV2,Trav2,0,-13,-13,0,0,0
TRAV8-1,Trav8-1,3,2,5,0,0,0
TRAV9-1,Trav9-1,-2,0,-2,0,0,0
TRAV9-2,Trav9-2,-5,1,-4,0,0,0
TRBC1,Trbc1,-1,1,0,0,0,0
TRBC2,Trbc2,-4,-21,-25,0,0,0
TRBD1,Trbd1,0,0,0,0,0,0
TRBJ1-1,Trbj1-1,5,3,8,0,0,0
TRBJ1-2,Trbj1-2,-1,1,0,0,0,0
TRBJ1-3,Trbj1-3,1,-1,0,0,0,0
TRBJ1-4,Trbj1-4,1,-1,0,0,0,0
TRBJ1-5,Trbj1-5,1,0,1,0,0,0
TRBJ1-6,Trbj1-6,0,1,1,0,0,0
TRBJ2-1,Trbj2-1,-1,1,0,0,0,0
TRBJ2-2,Trbj2-2,-1,0,-1,0,0,0
TRBJ2-3,Trbj2-3,4,0,4,0,0,0
TRBJ2-4,Trbj2-4,-3,0,-3,0,0,0
TRBJ2-5,Trbj2-5,0,0,0,0,0,0
TRBJ2-7,Trbj2-7,0,-1,-1,0,0,0
TRBV14,Trbv14,-13,11,-2,0,0,0
TRBV15,Trbv15,3,-1,2,0,0,0
TRBV16,Trbv16,0,5,5,0,0,0
TRBV17,Trbv17,0,2,2,0,0,0
TRBV19,Trbv19,2,3,5,0,0,0
TRBV2,Trbv2,0,-3,-3,0,0,0
TRBV30,Trbv30,3,2,5,0,0,0
TRDC,Trdc,11,3,14,0,0,0
TRDD1,Trdd1,0,0,0,0,0,0
TRDD2,Trdd2,0,0,0,0,0,0
TRDJ1,Trdj1,0,3,3,0,0,0
TRDJ2,Trdj2,-1,-3,-4,0,0,0
TRDMT1,Trdmt1,4,-10,-6,19.601942,0,0
TRDN,Trdn,2,3,5,0,0,0
TRDV1,Trdv1,2,-4,-2,0,0,0
TREH,Treh,3,-1,2,0,0,0
TREM1,Trem1,2,-6,-4,1.349515,0,0
TREM2,Trem2,1,0,1,0,0,0
TREML1,Treml1,10,4,14,0,0,0
TREML2,Treml2,1,2,3,0,0,0
TREML4,Treml4,-1,-1,-2,1.252427,0,0
TRERF1,Trerf1,2,-5,-3,14.902913,0,0
TREX1,Trex1,-28,0,-28,1.184466,0,0
TREX2,Trex2,-26,3,-23,0,0,0
TRGC1,Trgc1,1,-3,-2,0,0,0
TRGC2,Trgc2,1,4,5,0,0,0
TRGJ2,Trgj2,-1,-1,-2,0,0,0
TRGV1,Trgv1,1,-3,-2,0,0,0
TRGV2,Trgv2,-12,4,-8,0,0,0
TRGV3,Trgv3,0,1,1,0,0,0
TRGV5,Trgv5,-6,7,1,0,0,0
TRH,Trh,0,-11,-11,1.184466,0,0
TRHDE,Trhde,2,-9,-7,1.067961,0,0
TRHR,Trhr,2,0,2,0,0,0
TRIAP1,Triap1,5,-2,3,18.339806,0,0
TRIB1,Trib1,31,2,33,14.456311,0,0
TRIB2,Trib2,9,13,22,12.009709,0,0
TRIB3,Trib3,-14,20,6,6.776699,0,0
TRIL,Tril,2,1,3,0,0,0
TRIM10,Trim10,9,8,17,3.757282,0,0
TRIM11,Trim11,6,-4,2,3.07767,0,0
TRIM13,Trim13,-6,-6,-12,2.834951,0,0
TRIM14,Trim14,0,-9,-9,4.495146,0,0
TRIM15,Trim15,34,-5,29,3.757282,0,0
TRIM16,Trim16,17,-5,12,0,0,0
TRIM17,Trim17,11,2,13,0,0,0
TRIM2,Trim2,7,9,16,0.961165,0,0
TRIM21,Trim21,-15,3,-12,0,0,0
TRIM23,Trim23,8,-3,5,0,0,0
TRIM24,Trim24,-3,-2,-5,4.087379,0,0
TRIM25,Trim25,11,1,12,17.61165,0,0
TRIM26,Trim26,29,-6,23,41.368932,0,0
TRIM27,Trim27,2,-7,-5,5.980583,0,0
TRIM28,Trim28,8,-1,7,8.524272,0,0
TRIM29,Trim29,-6,2,-4,0,0,0
TRIM3,Trim3,7,0,7,13.417476,0,0
TRIM31,Trim31,6,0,6,0,0,0
TRIM32,Trim32,-8,-2,-10,3,0,0
TRIM33,Trim33,7,0,7,14.834951,0,0
TRIM35,Trim35,-5,2,-3,3.446602,0,0
TRIM36,Trim36,10,-10,0,87.262136,0,0
TRIM37,Trim37,3,-5,-2,18.339806,0,0
TRIM38,Trim38,-5,0,-5,0,0,0
TRIM39,Trim39,10,-6,4,17.359223,0,0
TRIM40,Trim40,17,7,24,0,0,0
TRIM41,Trim41,1,-3,-2,0,0,0
TRIM42,Trim42,0,-4,-4,0,0,0
TRIM43B,Trim43b,8,11,19,0,0,0
TRIM44,Trim44,4,-3,1,8.68932,0,0
TRIM45,Trim45,5,-8,-3,2.23301,0,0
TRIM46,Trim46,12,-7,5,4.533981,0,0
TRIM47,Trim47,4,7,11,2.864078,0,0
TRIM5,Trim5,1,-9,-8,0,0,0
TRIM50,Trim50,-1,3,2,1.349515,0,113
TRIM52,Trim52,3,-1,2,4.271845,0,0
TRIM54,Trim54,-1,-1,-2,7.058252,0,0
TRIM55,Trim55,-1,-7,-8,0,0,0
TRIM56,Trim56,5,-3,2,20.970874,0,0
TRIM58,Trim58,2,0,2,17.058252,2.916667,0
TRIM59,Trim59,-1,-1,-2,4.533981,0,0
TRIM6,Trim6,-3,-4,-7,0,0,0
TRIM60,Trim60,1,1,2,0,0,0
TRIM61,Trim61,-1,0,-1,0,0,0
TRIM62,Trim62,-8,-2,-10,3.825243,0,0
TRIM63,Trim63,-4,-9,-13,0,0,0
TRIM65,Trim65,1,6,7,6.058252,0,0
TRIM66,Trim66,3,-3,0,0,0,0
TRIM67,Trim67,2,1,3,0,0,0
TRIM68,Trim68,6,-10,-4,2.281553,0,0
TRIM69,Trim69,28,4,32,0,0,0
TRIM7,Trim7,2,-3,-1,31.912621,0,0
TRIM71,Trim71,7,0,7,0,0,0
TRIM72,Trim72,2,13,15,0,0,0
TRIM8,Trim8,10,-1,9,0.941748,0,0
TRIM9,Trim9,4,1,5,8.126214,0,0
TRIML1,Triml1,4,-7,-3,0,0,0
TRIML2,Triml2,63,1,64,31.669903,0,0
TRIO,Trio,8,3,11,0,0,0
TRIOBP,Triobp,7,-6,1,1.533981,0,0
TRIP10,Trip10,6,-4,2,10.106796,0,0
TRIP11,Trip11,3,-1,2,16.873786,0,0
TRIP12,Trip12,7,-2,5,12.058252,0,0
TRIP13,Trip13,2,-10,-8,15.300971,0,0
TRIP4,Trip4,5,-4,1,22.68932,0,0
TRIP6,Trip6,0,8,8,4.669903,0,0
TRIQK,Triqk,-4,-5,-9,10.883495,0,0
TRIR,Trir,3,-2,1,0,0,0
TRIT1,Trit1,2,-1,1,49.883495,0,0
TRMO,Trmo,2,0,2,11.883495,0,0
TRMT1,Trmt1,5,1,6,17.427184,0,0
TRMT10A,Trmt10a,15,4,19,0,0,0
TRMT10B,Trmt10b,5,-7,-2,2.359223,0,0
TRMT10C,Trmt10c,-1,-4,-5,4.067961,0,0
TRMT11,Trmt11,-4,-8,-12,10.699029,0,0
TRMT112,Trmt112,10,-6,4,103.174757,11.583333,0
TRMT12,Trmt12,-2,-10,-12,1.368932,0,0
TRMT13,Trmt13,3,-5,-2,0,0,0
TRMT1L,Trmt1l,3,-4,-1,0,0,0
TRMT2A,Trmt2a,6,-6,0,14.436893,0,0
TRMT2B,Trmt2b,0,-3,-3,0,0,0
TRMT44,Trmt44,1,-3,-2,6.912621,0,0
TRMT5,Trmt5,-9,-18,-27,9.815534,0,0
TRMT6,Trmt6,0,-3,-3,13.262136,0,0
TRMT9B,Trmt9b,4,2,6,0,0,0
TRMU,Trmu,5,-9,-4,11.378641,0,0
TRNAU1AP,Trnau1ap,8,-4,4,21.563107,0,0
TRNP1,Trnp1,8,-2,6,6.407767,0,0
TRNT1,Trnt1,5,-3,2,5.553398,0,0
TRO,Tro,15,-10,5,0,0,0
TROAP,Troap,0,-20,-20,3.456311,0,0
TRPA1,Trpa1,-1,3,2,3.252427,0,0
TRPC1,Trpc1,0,-7,-7,4.300971,0,0
TRPC3,Trpc3,11,-1,10,0.708738,0,0
TRPC4,Trpc4,-2,1,-1,0,0,0
TRPC4AP,Trpc4ap,7,-4,3,23.514563,0,0
TRPC5,Trpc5,4,-1,3,1.456311,0,0
TRPC5OS,Trpc5os,3,-1,2,0,0,0
TRPC6,Trpc6,-5,2,-3,0,0,0
TRPC7,Trpc7,5,1,6,0,0,0
TRPM1,Trpm1,0,-13,-13,0,0,0
TRPM2,Trpm2,4,-2,2,6.466019,0,0
TRPM3,Trpm3,-1,2,1,0,0,0
TRPM4,Trpm4,7,-7,0,17.495146,0,0
TRPM5,Trpm5,-3,-6,-9,0,0,0
TRPM6,Trpm6,4,-8,-4,0.84466,0,0
TRPM7,Trpm7,4,1,5,5.718447,0,0
TRPM8,Trpm8,2,-3,-1,0,0,0
TRPS1,Trps1,8,-2,6,0,0,0
TRPT1,Trpt1,8,0,8,6.980583,0,0
TRPV1,Trpv1,10,-10,0,0,0,0
TRPV2,Trpv2,2,-1,1,0,0,0
TRPV3,Trpv3,10,-1,9,1.067961,0,0
TRPV4,Trpv4,6,-4,2,0,0,0
TRPV5,Trpv5,2,2,4,0,0,0
TRPV6,Trpv6,12,4,16,0,0,0
TRRAP,Trrap,10,-11,-1,2.776699,0,0
TRUB1,Trub1,2,4,6,1.174757,0,0
TRUB2,Trub2,2,-2,0,30.427184,0,0
TSACC,Tsacc,8,-7,1,196.699029,24.75,146
TSC1,Tsc1,9,-6,3,13.708738,0,0
TSC2,Tsc2,9,-7,2,7.116505,0,0
TSC22D1,Tsc22d1,7,3,10,2.116505,0,0
TSC22D2,Tsc22d2,9,0,9,8.504854,0,0
TSC22D3,Tsc22d3,11,12,23,5.320388,0,0
TSEN15,Tsen15,7,-7,0,75.980583,0,0
TSEN2,Tsen2,1,-7,-6,52.601942,0,0
TSEN34,Tsen34,14,-4,10,188.417476,29.75,0
TSEN54,Tsen54,1,-7,-6,9.048544,0,0
TSFM,Tsfm,6,-4,2,17.359223,0,0
TSG101,Tsg101,4,-5,-1,9.883495,0,0
TSGA10,Tsga10,14,-13,1,10.271845,0,0
TSGA10IP,Tsga10ip,14,-12,2,0,0,0
TSGA13,Tsga13,2,-16,-14,0,0,0
TSHB,Tshb,2,-5,-3,0,0,0
TSHR,Tshr,1,-3,-2,16.446602,0,0
TSHZ1,Tshz1,34,1,35,54.980583,0,0
TSHZ2,Tshz2,1,5,6,3.475728,0,0
TSHZ3,Tshz3,3,-5,-2,2.15534,0,0
TSKS,Tsks,12,-3,9,16.009709,0,0
TSKU,Tsku,-10,-14,-24,5.621359,0,0
TSLP,Tslp,2,-14,-12,0,0,0
TSN,Tsn,0,-2,-2,9.912621,0,0
TSNAX,Tsnax,5,-4,1,5.757282,0,0
TSNAXIP1,Tsnaxip1,-1,-16,-17,88.213592,0,0
TSPAN1,Tspan1,-5,0,-5,1.68932,0,0
TSPAN10,Tspan10,-1,-2,-3,24.213592,0,0
TSPAN11,Tspan11,2,-3,-1,0,0,0
TSPAN12,Tspan12,15,-3,12,4.475728,0,0
TSPAN13,Tspan13,10,4,14,7.708738,0,0
TSPAN14,Tspan14,3,-3,0,0,0,0
TSPAN15,Tspan15,4,-14,-10,8.203883,0,0
TSPAN17,Tspan17,8,2,10,1.165049,0,0
TSPAN18,Tspan18,-3,0,-3,1.786408,0,0
TSPAN2,Tspan2,7,-11,-4,0,0,0
TSPAN3,Tspan3,10,-8,2,17.524272,0,0
TSPAN31,Tspan31,4,3,7,0,0,0
TSPAN32,Tspan32,3,-14,-11,0,0,0
TSPAN33,Tspan33,3,2,5,0,0,0
TSPAN4,Tspan4,-2,3,1,2.592233,0,0
TSPAN5,Tspan5,9,1,10,3.757282,0,0
TSPAN6,Tspan6,2,-2,0,0,0,0
TSPAN7,Tspan7,8,5,13,3.174757,0,0
TSPAN8,Tspan8,8,4,12,0,0,0
TSPAN9,Tspan9,13,1,14,0.990291,0,0
TSPEAR,Tspear,9,2,11,0,0,0
TSPO,Tspo,4,3,7,0,0,0
TSPO2,Tspo2,7,2,9,0,0,0
TSPOAP1,Tspoap1,22,-1,21,0,0,0
TSPYL1,Tspyl1,3,2,5,25.631068,8.416667,0
TSPYL2,Tspyl2,51,-1,50,48.368932,0,0
TSPYL4,Tspyl4,13,-3,10,49.048544,5,0
TSPYL5,Tspyl5,-5,-2,-7,0,0,0
TSR1,Tsr1,1,-4,-3,25.368932,0,0
TSR2,Tsr2,3,1,4,3.048544,0,0
TSR3,Tsr3,2,-3,-1,9.339806,0,0
TSSC4,Tssc4,9,0,9,6.592233,0,0
TSSK2,Tssk2,12,-9,3,0,0,0
TSSK3,Tssk3,-43,1,-42,0,0,0
TSSK4,Tssk4,55,-8,47,0,0,0
TSSK6,Tssk6,6,7,13,3.902913,0,0
TST,Tst,-1,-6,-7,2.543689,0,0
TSTD1,Tstd1,5,1,6,1.621359,0,0
TSTD2,Tstd2,1,0,1,10.563107,0,0
TSTD3,Tstd3,2,-3,-1,4.893204,0,0
TTBK1,Ttbk1,7,-2,5,0,0,0
TTBK2,Ttbk2,9,-4,5,4.485437,0,0
TTC1,Ttc1,5,-4,1,0,0,0
TTC12,Ttc12,-1,1,0,8.184466,0,0
TTC13,Ttc13,4,-10,-6,7.359223,0,0
TTC14,Ttc14,3,-6,-3,5.330097,0,0
TTC16,Ttc16,-1,-6,-7,6.61165,0,0
TTC17,Ttc17,10,-9,1,10.728155,0,0
TTC19,Ttc19,6,-1,5,11.339806,0,0
TTC21A,Ttc21a,6,-2,4,12.203883,0,0
TTC21B,Ttc21b,-1,-5,-6,6.699029,0,0
TTC22,Ttc22,1,-4,-3,0,0,0
TTC23,Ttc23,2,-10,-8,7.223301,0,0
TTC23L,Ttc23l,26,3,29,129.271845,0,0
TTC24,Ttc24,7,0,7,0,0,0
TTC26,Ttc26,3,-1,2,34.650485,0,0
TTC27,Ttc27,3,0,3,0,0,0
TTC28,Ttc28,5,-4,1,2.291262,0,0
TTC29,Ttc29,6,-2,4,6.504854,0,0
TTC3,Ttc3,10,1,11,9.728155,0,0
TTC30B,Ttc30b,-26,-12,-38,7.699029,0,0
TTC32,Ttc32,-3,-3,-6,11.368932,0,0
TTC33,Ttc33,9,-1,8,16.485437,0,0
TTC34,Ttc34,-2,-9,-11,0,0,0
TTC36,Ttc36,12,10,22,0.893204,0,0
TTC38,Ttc38,2,0,2,1.737864,0,0
TTC39A,Ttc39a,9,-17,-8,6.271845,0,0
TTC39B,Ttc39b,-4,-4,-8,0,0,0
TTC39C,Ttc39c,5,-3,2,3.864078,0,0
TTC4,Ttc4,-4,-6,-10,25.854369,0,0
TTC5,Ttc5,3,-9,-6,1.135922,0,0
TTC6,Ttc6,1,-5,-4,3.737864,0,0
TTC7B,Ttc7b,11,6,17,1.650485,0,0
TTC8,Ttc8,4,-6,-2,15.23301,0,0
TTC9,Ttc9,3,-2,1,0,0,0
TTC9B,Ttc9b,15,-5,10,1.029126,0,0
TTC9C,Ttc9c,6,-5,1,7.262136,0,0
TTF1,Ttf1,0,2,2,22.378641,0,0
TTF2,Ttf2,-1,-5,-6,3.631068,0,0
TTI1,Tti1,-1,-5,-6,6.019417,0,0
TTI2,Tti2,8,-4,4,0,0,0
TTK,Ttk,-7,-14,-21,0,0,0
TTL,Ttl,5,-1,4,2.592233,0,0
TTLL1,Ttll1,3,-7,-4,59.446602,0,0
TTLL10,Ttll10,11,-4,7,1.970874,0,0
TTLL11,Ttll11,-3,-2,-5,4.825243,0,0
TTLL12,Ttll12,4,-2,2,10.456311,0,0
TTLL2,Ttll2,0,0,0,10.815534,0,0
TTLL3,Ttll3,4,-8,-4,1.718447,0,0
TTLL4,Ttll4,1,1,2,27.980583,0,0
TTLL5,Ttll5,9,-7,2,25.378641,0,0
TTLL6,Ttll6,-8,-7,-15,21.184466,0,0
TTLL7,Ttll7,-1,-11,-12,2.223301,0,0
TTLL8,Ttll8,0,-4,-4,0,0,0
TTLL9,Ttll9,10,-4,6,0,0,0
TTN,Ttn,3,-4,-1,0,0,0
TTPA,Ttpa,1,4,5,1.174757,0,0
TTPAL,Ttpal,3,1,4,9.951456,0,0
TTR,Ttr,12,3,15,0,0,0
TTYH1,Ttyh1,10,-5,5,0,0,0
TTYH2,Ttyh2,43,6,49,5.417476,0,0
TTYH3,Ttyh3,4,5,9,0,0,0
TUB,Tub,1,-5,-4,0,0,0
TUBA1A,Tuba1a,9,-6,3,1.349515,0,0
TUBA1B,Tuba1b,10,-5,5,7.504854,0,0
TUBA1C,Tuba1c,7,-3,4,3.728155,0,0
TUBA4A,Tuba4a,12,1,13,1.524272,0,0
TUBA8,Tuba8,10,-5,5,0,0,0
TUBAL3,Tubal3,-3,-6,-9,0,0,0
TUBB1,Tubb1,10,8,18,20.281553,0,0
TUBB2A,Tubb2a,3,-1,2,4.708738,0,0
TUBB2B,Tubb2b,3,-2,1,0,0,0
TUBB3,Tubb3,18,7,25,26.699029,0,0
TUBB4A,Tubb4a,19,8,27,0.990291,0,0
TUBB4B,Tubb4b,4,-2,2,10.038835,0,0
TUBB6,Tubb6,1,-6,-5,3.708738,0,0
TUBD1,Tubd1,9,-12,-3,14.339806,0,0
TUBE1,Tube1,4,-12,-8,22.61165,0,0
TUBG1,Tubg1,3,-6,-3,0,0,0
TUBG2,Tubg2,8,-3,5,4.912621,0,0
TUBGCP2,Tubgcp2,1,-7,-6,5.019417,0,0
TUBGCP3,Tubgcp3,5,-4,1,41.349515,0,0
TUBGCP4,Tubgcp4,7,0,7,2.524272,0,0
TUBGCP5,Tubgcp5,-24,-10,-34,10.368932,0,0
TUBGCP6,Tubgcp6,-1,-5,-6,2.330097,0,0
TUFM,Tufm,10,-4,6,11.941748,0,0
TUFT1,Tuft1,0,-6,-6,2.262136,0,0
TUG1,Tug1,9,0,9,0,0,0
TULP1,Tulp1,-5,9,4,0,0,0
TULP2,Tulp2,108,3,111,98.699029,0,0
TULP3,Tulp3,8,0,8,14.427184,0,0
TULP4,Tulp4,8,-2,6,0,0,0
TUNAR,Tunar,1,-3,-2,0,0,0
TUSC1,Tusc1,2,-4,-2,3.436893,0,0
TUSC2,Tusc2,8,4,12,6.572816,0,0
TUT1,Tut1,3,0,3,4.524272,0,0
TUT4,Tut4,6,-2,4,2.84466,0,0
TUT7,Tut7,6,-1,5,13.359223,0,0
TVP23A,Tvp23a,1,-4,-3,0,0,0
TVP23B,Tvp23b,3,-9,-6,11.514563,0,0
TWF1,Twf1,8,-8,0,0,0,0
TWF2,Twf2,11,-4,7,4.669903,0,0
TWIST1,Twist1,1,-1,0,5.932039,0,0
TWIST2,Twist2,2,3,5,0,0,0
TWNK,Twnk,4,-3,1,0.980583,0,0
TWSG1,Twsg1,7,-6,1,3.902913,0,0
TXK,Txk,15,-2,13,0,0,0
TXLNA,Txlna,8,-5,3,16.592233,0,0
TXLNB,Txlnb,11,3,14,4.621359,0,0
TXLNG,Txlng,3,-4,-1,2.019417,0,0
TXN2,Txn2,4,2,6,2.495146,0,0
TXNDC11,Txndc11,-1,-1,-2,3.883495,0,0
TXNDC12,Txndc12,4,-6,-2,3.398058,0,0
TXNDC15,Txndc15,-3,-4,-7,7.417476,0,0
TXNDC16,Txndc16,11,2,13,3.61165,0,0
TXNDC17,Txndc17,3,0,3,41.970874,0,0
TXNDC2,Txndc2,2,7,9,0,0,0
TXNDC5,Txndc5,10,-2,8,3.009709,0,0
TXNDC8,Txndc8,-2,0,-2,0,0,0
TXNDC9,Txndc9,2,-2,0,25.572816,0,0
TXNIP,Txnip,8,6,14,3.660194,0,0
TXNL1,Txnl1,5,-4,1,10.563107,0,0
TXNL4A,Txnl4a,8,-3,5,8.174757,0,0
TXNL4B,Txnl4b,10,-2,8,1.951456,0,0
TXNRD1,Txnrd1,7,0,7,3.786408,0,0
TXNRD2,Txnrd2,4,5,9,4.970874,0,0
TXNRD3,Txnrd3,-1,-11,-12,2.097087,0,0
TYK2,Tyk2,7,-2,5,6.76699,0,0
TYMP,Tymp,-2,-7,-9,1,0,0
TYMS,Tyms,2,-2,0,7.679612,0,0
TYR,Tyr,-1,1,0,0,0,0
TYRO3,Tyro3,6,-2,4,3.543689,0,0
TYROBP,Tyrobp,0,-4,-4,10.194175,0,0
TYRP1,Tyrp1,2,0,2,0,0,0
TYSND1,Tysnd1,8,-1,7,14.718447,0,0
TYW1,Tyw1,4,-3,1,2.339806,0,0
TYW3,Tyw3,12,-24,-12,149.475728,0,167
TYW5,Tyw5,5,-3,2,0,0,0
U2AF1,U2af1,13,-6,7,4.38835,0,0
U2AF1L4,U2af1l4,5,-2,3,0,0,0
U2AF2,U2af2,9,0,9,59.92233,0,0
U2SURP,U2surp,4,-7,-3,8.912621,0,0
UACA,Uaca,5,2,7,3.466019,0,0
UAP1,Uap1,1,-6,-5,10.067961,0,0
UAP1L1,Uap1l1,7,7,14,2.252427,0,0
UBA1,Uba1,8,-1,7,0.834951,0,0
UBA2,Uba2,2,-4,-2,3.291262,0,0
UBA3,Uba3,9,-4,5,0.873786,0,0
UBA5,Uba5,3,-2,1,5.417476,0,0
UBA52,Uba52,5,-2,3,19.980583,0,0
UBA6,Uba6,3,-3,0,8.339806,0,0
UBA7,Uba7,18,3,21,0,0,0
UBAC1,Ubac1,5,-7,-2,8.84466,0,0
UBAC2,Ubac2,5,-3,2,0,0,0
UBALD1,Ubald1,-4,-3,-7,2.61165,0,0
UBALD2,Ubald2,2,0,2,2.572816,0,0
UBAP1,Ubap1,12,-7,5,1.631068,0,0
UBAP1L,Ubap1l,19,-1,18,0,0,0
UBAP2,Ubap2,2,-2,0,2.009709,0,0
UBAP2L,Ubap2l,6,-2,4,10.883495,0,0
UBASH3A,Ubash3a,2,9,11,2.650485,0,0
UBASH3B,Ubash3b,-7,4,-3,2.902913,0,0
UBB,Ubb,55,3,58,452.718447,141.708333,249
UBC,Ubc,49,18,67,205.281553,15.416667,0
UBD,Ubd,-4,-13,-17,0,0,0
UBE2A,Ube2a,-2,-4,-6,9.213592,0,0
UBE2B,Ube2b,17,-3,14,97.650485,0,0
UBE2C,Ube2c,10,-3,7,16.84466,0,0
UBE2D1,Ube2d1,11,0,11,6.737864,0,0
UBE2D3,Ube2d3,12,2,14,185.203883,17.208333,0
UBE2E1,Ube2e1,9,-3,6,1.621359,0,0
UBE2E2,Ube2e2,5,-9,-4,14.902913,0,0
UBE2E3,Ube2e3,6,-2,4,3.708738,0,0
UBE2F,Ube2f,4,-3,1,20.116505,0,0
UBE2G1,Ube2g1,6,-3,3,3.242718,0,0
UBE2G2,Ube2g2,3,-2,1,4.553398,0,0
UBE2H,Ube2h,17,-1,16,61.76699,0,0
UBE2I,Ube2i,7,-4,3,3.009709,0,0
UBE2J1,Ube2j1,5,-5,0,7.708738,0,0
UBE2J2,Ube2j2,1,-6,-5,16.126214,0,0
UBE2K,Ube2k,6,2,8,5.427184,0,0
UBE2L3,Ube2l3,7,-4,3,4.776699,0,0
UBE2L6,Ube2l6,11,-5,6,0,0,0
UBE2M,Ube2m,7,-1,6,5.737864,0,0
UBE2N,Ube2n,5,-2,3,7.699029,0,0
UBE2O,Ube2o,11,-1,10,110.446602,0,0
UBE2Q1,Ube2q1,5,-4,1,12.174757,0,0
UBE2Q2,Ube2q2,7,-4,3,4.854369,0,0
UBE2QL1,Ube2ql1,1,4,5,17.067961,0,0
UBE2R2,Ube2r2,7,-5,2,2.951456,0,0
UBE2S,Ube2s,6,-5,1,12.747573,0,0
UBE2T,Ube2t,7,-4,3,0,0,0
UBE2U,Ube2u,-1,-2,-3,0,0,0
UBE2V1,Ube2v1,9,-2,7,10.815534,0,0
UBE2V2,Ube2v2,7,-5,2,4.135922,0,0
UBE2W,Ube2w,8,2,10,0,0,0
UBE2Z,Ube2z,9,0,9,30.883495,0,0
UBE3A,Ube3a,5,0,5,4.796117,7.208333,0
UBE3B,Ube3b,9,-1,8,6.553398,0,0
UBE3C,Ube3c,4,0,4,4.854369,0,0
UBE4A,Ube4a,6,-7,-1,1.563107,0,0
UBE4B,Ube4b,6,-1,5,95.126214,0,0
UBFD1,Ubfd1,14,-2,12,144.23301,22.166667,0
UBIAD1,Ubiad1,3,-4,-1,8.61165,0,0
UBL3,Ubl3,10,-2,8,10.747573,0,0
UBL4A,Ubl4a,4,-7,-3,0.796117,0,0
UBL4B,Ubl4b,2,1,3,0,0,0
UBL5,Ubl5,8,-5,3,2.601942,0,0
UBL7,Ubl7,9,-6,3,8.728155,0,0
UBLCP1,Ublcp1,0,-6,-6,3.223301,0,0
UBN1,Ubn1,7,1,8,3.825243,0,0
UBN2,Ubn2,7,-4,3,11.31068,0,0
UBOX5,Ubox5,-4,-9,-13,7.242718,0,246
UBP1,Ubp1,5,-1,4,11.786408,0,0
UBQLN1,Ubqln1,9,-2,7,287.271845,180.25,199
UBQLN2,Ubqln2,2,3,5,1.699029,0,0
UBQLN3,Ubqln3,1,0,1,0,0,0
UBQLN4,Ubqln4,7,-6,1,8.533981,0,0
UBQLNL,Ubqlnl,1,0,1,0,0,0
UBR1,Ubr1,13,-2,11,13.631068,0,0
UBR2,Ubr2,9,-1,8,75.873786,9.375,0
UBR3,Ubr3,3,-6,-3,7.31068,0,0
UBR4,Ubr4,9,-2,7,10.970874,0,0
UBR5,Ubr5,3,-4,-1,12.436893,0,0
UBR7,Ubr7,9,0,9,44.990291,0,0
UBTD1,Ubtd1,0,2,2,1.281553,0,0
UBTD2,Ubtd2,7,-6,1,3.553398,0,0
UBTF,Ubtf,12,3,15,5.466019,0,0
UBTFL1,Ubtfl1,21,1,22,0,0,0
UBXN1,Ubxn1,4,-5,-1,3.854369,0,0
UBXN10,Ubxn10,-6,-8,-14,1.834951,0,0
UBXN11,Ubxn11,5,-5,0,29.048544,10.166667,0
UBXN2A,Ubxn2a,3,6,9,6.281553,0,0
UBXN2B,Ubxn2b,1,-8,-7,8.281553,0,0
UBXN4,Ubxn4,11,1,12,4.834951,0,0
UBXN6,Ubxn6,0,-2,-2,42.873786,0,0
UBXN7,Ubxn7,8,-1,7,2.805825,0,0
UBXN8,Ubxn8,14,-2,12,0,0,0
UCHL1,Uchl1,14,-3,11,19.407767,0,0
UCHL3,Uchl3,8,-4,4,2.582524,0,0
UCHL5,Uchl5,3,-8,-5,6.495146,0,0
UCK1,Uck1,8,0,8,5.650485,0,0
UCK2,Uck2,2,-4,-2,8.466019,0,0
UCKL1,Uckl1,8,-3,5,62.407767,0,0
UCMA,Ucma,23,6,29,0,0,0
UCN,Ucn,14,-1,13,0,0,0
UCN2,Ucn2,2,3,5,0,0,0
UCN3,Ucn3,1,-1,0,0,0,0
UCP1,Ucp1,4,-5,-1,0,0,0
UCP2,Ucp2,5,3,8,7.097087,0,0
UCP3,Ucp3,65,0,65,0,0,0
UEVLD,Uevld,2,-1,1,9.640777,0,0
UFC1,Ufc1,9,-2,7,1.23301,0,0
UFD1,Ufd1,5,-5,0,2.737864,0,0
UFL1,Ufl1,5,-8,-3,32.252427,0,0
UFM1,Ufm1,6,-10,-4,0,0,0
UFSP1,Ufsp1,-22,0,-22,3.106796,0,0
UFSP2,Ufsp2,8,-10,-2,13.213592,0,0
UGCG,Ugcg,-1,1,0,10.097087,0,0
UGDH,Ugdh,5,-3,2,4.184466,0,0
UGGT1,Uggt1,13,4,17,8.184466,0,0
UGGT2,Uggt2,7,-6,1,1.504854,0,0
UGP2,Ugp2,5,1,6,6.533981,0,0
UGT1A1,Ugt1a1,3,11,14,1.76699,0,0
UGT1A10,Ugt1a10,-2,14,12,0,0,0
UGT1A5,Ugt1a5,0,2,2,0,0,0
UGT1A8,Ugt1a8,5,0,5,0,0,0
UGT1A9,Ugt1a9,0,-1,-1,0,0,0
UGT2A1,Ugt2a1,-1,0,-1,0,0,0
UGT2A2,Ugt2a2,2,1,3,0,0,0
UGT2A3,Ugt2a3,-2,0,-2,0,0,0
UGT3A1,Ugt3a1,4,-12,-8,0,0,0
UGT3A2,Ugt3a2,7,2,9,0,0,0
UHMK1,Uhmk1,5,-2,3,6.970874,0,0
UHRF1,Uhrf1,7,-6,1,33.31068,0,0
UHRF2,Uhrf2,6,-5,1,3.291262,0,0
UIMC1,Uimc1,-1,-6,-7,8.951456,0,0
ULBP1,Ulbp1,29,-3,26,5.902913,0,0
ULK1,Ulk1,4,-2,2,1.029126,0,0
ULK2,Ulk2,9,-3,6,0,0,0
ULK3,Ulk3,5,2,7,0,0,0
ULK4,Ulk4,2,-4,-2,28.466019,0,0
UMAD1,Umad1,3,-3,0,5.106796,0,0
UMOD,Umod,-3,5,2,0,0,0
UMODL1,Umodl1,7,-2,5,0,0,0
UMPS,Umps,-6,-1,-7,1.339806,0,0
UNC119,Unc119,5,-1,4,26.553398,0,0
UNC119B,Unc119b,3,-4,-1,9.533981,0,0
UNC13A,Unc13a,6,-7,-1,1.553398,0,0
UNC13B,Unc13b,7,-1,6,2.194175,0,0
UNC13C,Unc13c,3,0,3,0,0,0
UNC13D,Unc13d,20,0,20,6.330097,0,0
UNC45A,Unc45a,8,2,10,2.553398,0,0
UNC45B,Unc45b,14,6,20,1.252427,0,0
UNC50,Unc50,0,-10,-10,9.776699,0,0
UNC5A,Unc5a,0,2,2,0,0,0
UNC5B,Unc5b,-2,-4,-6,1.427184,0,0
UNC5C,Unc5c,5,-9,-4,1.378641,0,0
UNC5CL,Unc5cl,-7,0,-7,0,0,0
UNC5D,Unc5d,4,0,4,2.330097,0,0
UNC79,Unc79,1,3,4,13.038835,0,0
UNC80,Unc80,1,-5,-4,0.990291,0,0
UNC93A,Unc93a,5,11,16,0,0,0
UNC93B1,Unc93b1,3,-2,1,2.407767,0,0
UNCX,Uncx,10,6,16,0,0,0
UNG,Ung,-6,-7,-13,6.825243,0,0
UNK,Unk,5,-7,-2,14.106796,0,0
UNKL,Unkl,2,-3,-1,2.174757,0,0
UPB1,Upb1,1,-11,-10,0,0,0
UPF1,Upf1,8,-1,7,12.38835,0,0
UPF2,Upf2,5,-4,1,6.262136,0,0
UPF3A,Upf3a,5,-2,3,1.07767,0,0
UPF3B,Upf3b,0,-2,-2,0.660194,0,0
UPK1A,Upk1a,54,5,59,0,0,0
UPK1B,Upk1b,3,0,3,0,0,0
UPK2,Upk2,1,1,2,0,0,0
UPK3A,Upk3a,2,2,4,0,0,0
UPK3B,Upk3b,9,0,9,0,0,0
UPP1,Upp1,7,-4,3,10.68932,0,0
UPP2,Upp2,0,-6,-6,9.76699,0,0
UPRT,Uprt,2,-2,0,8.048544,0,0
UQCC1,Uqcc1,4,-14,-10,7.07767,0,0
UQCC2,Uqcc2,6,-2,4,5.776699,0,0
UQCC3,Uqcc3,6,-3,3,8.466019,0,0
UQCR10,Uqcr10,1,-1,0,0,0,0
UQCR11,Uqcr11,8,-8,0,0.825243,0,0
UQCRB,Uqcrb,7,-9,-2,3.708738,0,0
UQCRC1,Uqcrc1,6,1,7,5.223301,0,0
UQCRC2,Uqcrc2,5,-3,2,1.669903,0,0
UQCRFS1,Uqcrfs1,3,-3,0,4.262136,0,0
UQCRH,Uqcrh,6,-1,5,2.737864,0,0
UQCRQ,Uqcrq,6,0,6,5.951456,0,0
URAD,Urad,2,0,2,0,0,0
URB1,Urb1,2,-2,0,3.718447,0,0
URB2,Urb2,-5,-6,-11,7.349515,0,0
URGCP,Urgcp,3,-2,1,9.378641,0,0
URI1,Uri1,2,-3,-1,6.660194,0,0
URM1,Urm1,4,-1,3,4.718447,0,0
UROC1,Uroc1,0,9,9,2.417476,0,0
UROD,Urod,8,-2,6,3.533981,0,0
UROS,Uros,4,-5,-1,2.776699,0,0
USB1,Usb1,6,-2,4,3.990291,0,0
USE1,Use1,7,-2,5,5.68932,0,0
USF1,Usf1,6,-2,4,1.368932,0,0
USF2,Usf2,8,1,9,0,0,0
USF3,Usf3,9,-4,5,6.23301,0,0
USH1C,Ush1c,3,0,3,0,0,0
USH1G,Ush1g,6,-4,2,1.223301,0,0
USH2A,Ush2a,-4,0,-4,0,0,0
USHBP1,Ushbp1,8,-1,7,10.873786,0,0
USO1,Uso1,4,-9,-5,5.572816,0,0
USP1,Usp1,5,-5,0,7.23301,0,0
USP10,Usp10,5,-5,0,2.834951,0,0
USP11,Usp11,7,-2,5,14.213592,0,0
USP12,Usp12,-3,-3,-6,1.029126,0,0
USP13,Usp13,-11,0,-11,17.592233,0,0
USP14,Usp14,4,-2,2,6.631068,0,0
USP15,Usp15,5,-2,3,20.262136,0,0
USP16,Usp16,1,-5,-4,1.087379,0,0
USP18,Usp18,5,0,5,3.242718,0,0
USP19,Usp19,10,-2,8,4.106796,0,0
USP2,Usp2,3,-7,-4,13.475728,0,0
USP20,Usp20,7,-3,4,28.776699,0,0
USP21,Usp21,11,-7,4,22.514563,0,0
USP22,Usp22,8,-4,4,12.650485,0,0
USP24,Usp24,7,-1,6,8.427184,0,0
USP25,Usp25,2,-3,-1,6.601942,0,0
USP26,Usp26,-1,4,3,0,0,0
USP27X,Usp27x,-12,-6,-18,0.776699,0,0
USP28,Usp28,2,-10,-8,4.398058,0,0
USP29,Usp29,-3,-14,-17,0,0,0
USP3,Usp3,6,-1,5,32.524272,0,0
USP30,Usp30,12,-2,10,59.203883,0,0
USP31,Usp31,6,1,7,6.893204,0,0
USP32,Usp32,5,-1,4,24.728155,0,0
USP33,Usp33,8,-9,-1,11.184466,0,0
USP34,Usp34,13,-4,9,9.320388,0,0
USP35,Usp35,1,-7,-6,30.281553,0,0
USP36,Usp36,8,-3,5,8.854369,0,0
USP37,Usp37,6,0,6,1.699029,0,0
USP38,Usp38,6,0,6,7.009709,0,0
USP39,Usp39,4,-1,3,7.300971,0,0
USP4,Usp4,12,-6,6,13.398058,0,0
USP40,Usp40,8,-6,2,4.601942,0,0
USP42,Usp42,7,-5,2,8.019417,0,0
USP43,Usp43,-6,-2,-8,0,0,0
USP44,Usp44,14,-5,9,0,0,0
USP45,Usp45,1,-7,-6,12.941748,0,0
USP46,Usp46,2,-6,-4,1.650485,0,0
USP47,Usp47,7,-4,3,10.728155,0,0
USP48,Usp48,2,-8,-6,10.76699,0,0
USP49,Usp49,4,-2,2,1.126214,0,0
USP5,Usp5,9,-5,4,0,0,0
USP50,Usp50,37,3,40,0,0,0
USP51,Usp51,4,-3,1,42.475728,0,0
USP53,Usp53,7,-3,4,14.582524,0,0
USP54,Usp54,2,-1,1,111.378641,0,0
USP6NL,Usp6nl,4,-2,2,12.126214,0,0
USP7,Usp7,6,1,7,5.436893,0,0
USP8,Usp8,4,-10,-6,5.514563,0,0
USP9X,Usp9x,5,-2,3,3.747573,0,0
USP9Y,Usp9y,2,1,3,0,0,0
USPL1,Uspl1,89,10,99,808.38835,308.458333,933
UST,Ust,2,1,3,1.854369,0,0
UTF1,Utf1,2,3,5,0,0,0
UTP11,Utp11,5,-1,4,5.980583,0,0
UTP14A,Utp14a,3,-2,1,0,0,0
UTP15,Utp15,0,-6,-6,0,0,0
UTP18,Utp18,2,-1,1,9.786408,0,0
UTP20,Utp20,2,-1,1,2.961165,0,0
UTP23,Utp23,4,-3,1,8.116505,0,0
UTP25,Utp25,3,-8,-5,2.15534,0,0
UTP3,Utp3,1,-4,-3,18.951456,0,0
UTP4,Utp4,7,-3,4,10.563107,0,0
UTP6,Utp6,2,-1,1,0,0,0
UTRN,Utrn,6,-4,2,0.941748,0,0
UTS2,Uts2,4,-12,-8,4.165049,0,0
UTS2B,Uts2b,0,-4,-4,11.990291,0,0
UTS2R,Uts2r,10,0,10,0,0,0
UTY,Uty,-2,-1,-3,0,0,0
UVRAG,Uvrag,4,-2,2,19.708738,0,0
UVSSA,Uvssa,3,-8,-5,17.116505,0,0
UXS1,Uxs1,0,-8,-8,1.543689,0,0
UXT,Uxt,4,-5,-1,0,0,0
VAC14,Vac14,4,-1,3,4.514563,0,0
VAMP1,Vamp1,6,-3,3,14.902913,0,0
VAMP2,Vamp2,6,-6,0,1.475728,0,0
VAMP3,Vamp3,3,-5,-2,4.242718,0,0
VAMP4,Vamp4,-3,0,-3,60.941748,20.708333,0
VAMP5,Vamp5,6,-3,3,0,0,0
VAMP8,Vamp8,27,-5,22,0,0,0
VANGL1,Vangl1,-1,-3,-4,5.320388,0,0
VANGL2,Vangl2,10,-4,6,0,0,0
VAPA,Vapa,6,-2,4,13.524272,0,0
VAPB,Vapb,9,-6,3,7.368932,0,0
VARS2,Vars2,7,0,7,9.330097,0,0
VASH1,Vash1,6,-8,-2,0,0,0
VASH2,Vash2,2,-5,-3,0.970874,0,0
VASN,Vasn,2,-4,-2,0,0,0
VASP,Vasp,6,-3,3,2.019417,0,0
VAT1,Vat1,10,-3,7,1.980583,0,0
VAT1L,Vat1l,6,-2,4,0,0,0
VAV1,Vav1,0,0,0,0,0,0
VAV2,Vav2,7,-3,4,0,0,0
VAV3,Vav3,12,-3,9,0.786408,0,0
VAX1,Vax1,3,-2,1,0,0,0
VAX2,Vax2,-1,-5,-6,0,0,0
VBP1,Vbp1,6,-10,-4,1.84466,0,0
VCAM1,Vcam1,-1,-3,-4,0,0,0
VCAN,Vcan,6,-5,1,10.68932,0,0
VCL,Vcl,1,6,7,27.883495,16.083333,0
VCP,Vcp,7,-4,3,1.669903,0,0
VCPIP1,Vcpip1,8,-2,6,2.466019,0,0
VCPKMT,Vcpkmt,-7,0,-7,13.84466,0,0
VDAC1,Vdac1,10,1,11,25.524272,0,0
VDAC2,Vdac2,8,-2,6,31.533981,8.166667,0
VDAC3,Vdac3,6,-9,-3,7.718447,0,0
VDR,Vdr,-8,2,-6,4.359223,0,0
VEGFA,Vegfa,9,7,16,0,0,0
VEGFB,Vegfb,4,-5,-1,0,0,0
VEGFC,Vegfc,1,8,9,2.262136,0,0
VEGFD,Vegfd,12,-3,9,0,0,0
VEPH1,Veph1,-2,-5,-7,0,0,0
VEZF1,Vezf1,10,-2,8,8.524272,0,0
VEZT,Vezt,3,-4,-1,4.281553,0,0
VGF,Vgf,16,4,20,4.300971,0,0
VGLL1,Vgll1,2,3,5,0,0,0
VGLL2,Vgll2,8,-3,5,0,0,0
VGLL3,Vgll3,7,1,8,3.135922,0,0
VGLL4,Vgll4,7,0,7,12.174757,0,0
VHL,Vhl,2,-5,-3,5.067961,0,0
VIL1,Vil1,6,-1,5,5.116505,0,0
VILL,Vill,2,-7,-5,0,0,0
VIM,Vim,12,-3,9,1.116505,0,0
VIP,Vip,11,1,12,7.514563,0,0
VIPAS39,Vipas39,23,-3,20,340.038835,184.5,0
VIPR1,Vipr1,-5,4,-1,4.747573,0,0
VIPR2,Vipr2,-3,4,1,0,0,0
VIRMA,Virma,10,-1,9,18.359223,0,0
VIT,Vit,1,-2,-1,0,0,0
VKORC1,Vkorc1,7,-4,3,3.165049,0,0
VKORC1L1,Vkorc1l1,3,-6,-3,1.281553,0,0
VLDLR,Vldlr,1,4,5,0,0,0
VMA21,Vma21,7,3,10,7.019417,0,0
VMAC,Vmac,0,-1,-1,24.23301,0,0
VMO1,Vmo1,22,0,22,6.116505,0,0
VMP1,Vmp1,4,-2,2,2.320388,0,0
VNN1,Vnn1,-3,7,4,0,0,0
VNN3,Vnn3,0,-3,-3,0,0,0
VOPP1,Vopp1,7,-2,5,1.737864,0,0
VPREB3,Vpreb3,30,3,33,4.660194,0,0
VPS11,Vps11,9,-2,7,4.446602,0,0
VPS13A,Vps13a,6,-4,2,18.048544,0,0
VPS13B,Vps13b,4,2,6,4.941748,0,0
VPS13C,Vps13c,5,-1,4,25.087379,0,0
VPS13D,Vps13d,5,0,5,16.456311,0,0
VPS16,Vps16,7,-3,4,4.514563,0,0
VPS18,Vps18,-9,-2,-11,4.805825,0,0
VPS25,Vps25,10,-4,6,10.203883,0,0
VPS26A,Vps26a,5,0,5,18.116505,0,0
VPS26B,Vps26b,7,1,8,12.601942,0,0
VPS26C,Vps26c,1,-1,0,4.339806,0,0
VPS28,Vps28,6,-2,4,43.776699,0,0
VPS29,Vps29,4,-4,0,15.262136,0,0
VPS33A,Vps33a,1,-2,-1,5.436893,0,0
VPS33B,Vps33b,-20,-6,-26,0,0,0
VPS35,Vps35,8,-1,7,5.300971,0,0
VPS35L,Vps35l,9,-5,4,1.038835,0,0
VPS36,Vps36,7,-8,-1,4.427184,0,0
VPS37A,Vps37a,3,-2,1,4.456311,0,0
VPS37B,Vps37b,7,1,8,5.019417,0,0
VPS37C,Vps37c,6,-3,3,13.563107,0,0
VPS37D,Vps37d,6,6,12,8.203883,0,0
VPS39,Vps39,7,-2,5,2.271845,0,0
VPS41,Vps41,6,0,6,2.330097,0,0
VPS45,Vps45,7,0,7,9.941748,0,0
VPS4A,Vps4a,8,-2,6,14.106796,0,0
VPS4B,Vps4b,5,-3,2,8.436893,0,0
VPS50,Vps50,5,-2,3,2.262136,0,0
VPS51,Vps51,9,-2,7,0,0,0
VPS52,Vps52,5,-4,1,7.980583,0,0
VPS53,Vps53,5,-1,4,39.970874,0,0
VPS54,Vps54,1,-2,-1,3.456311,0,0
VPS72,Vps72,8,-2,6,6.980583,0,0
VPS8,Vps8,2,-5,-3,4.669903,0,0
VPS9D1,Vps9d1,2,0,2,13.68932,0,0
VRK1,Vrk1,3,-3,0,12.980583,0,0
VRK2,Vrk2,1,-14,-13,7.660194,0,0
VRK3,Vrk3,7,-6,1,262.747573,98.083333,142
VRTN,Vrtn,8,-2,6,0,0,0
VSIG1,Vsig1,0,-5,-5,0,0,0
VSIG10,Vsig10,4,-1,3,3.524272,0,0
VSIG10L,Vsig10l,3,-2,1,6.893204,0,0
VSIG2,Vsig2,37,0,37,0,0,0
VSIG4,Vsig4,-3,12,9,0,0,0
VSIG8,Vsig8,1,-4,-3,0,0,0
VSIR,Vsir,1,3,4,1.252427,0,0
VSNL1,Vsnl1,4,0,4,0,0,0
VSTM2A,Vstm2a,-1,-9,-10,0,0,0
VSTM2B,Vstm2b,1,-1,0,0,0,0
VSTM2L,Vstm2l,-2,-3,-5,3.009709,0,0
VSTM4,Vstm4,7,-4,3,0,0,0
VSTM5,Vstm5,-13,-4,-17,3.300971,0,0
VSX1,Vsx1,1,1,2,0,0,0
VSX2,Vsx2,0,2,2,0,0,0
VTA1,Vta1,3,-6,-3,23.194175,0,0
VTCN1,Vtcn1,2,1,3,2.058252,0,0
VTI1A,Vti1a,2,-5,-3,0,0,0
VTI1B,Vti1b,7,1,8,14.174757,0,0
VTN,Vtn,8,3,11,0,0,0
VWA1,Vwa1,10,-2,8,0,0,0
VWA2,Vwa2,4,2,6,0,0,0
VWA3A,Vwa3a,23,-4,19,0,0,0
VWA3B,Vwa3b,0,-5,-5,8.058252,0,0
VWA5A,Vwa5a,-4,-5,-9,0,0,0
VWA5B1,Vwa5b1,-1,-4,-5,0,0,0
VWA5B2,Vwa5b2,18,-4,14,17.961165,0,0
VWA7,Vwa7,28,1,29,0,0,0
VWA8,Vwa8,2,-2,0,6.058252,0,0
VWC2,Vwc2,0,-2,-2,0,0,0
VWC2L,Vwc2l,1,1,2,0,0,0
VWCE,Vwce,10,7,17,0,0,0
VWDE,Vwde,-2,0,-2,7.417476,0,0
VWF,Vwf,0,-3,-3,0,0,0
VXN,Vxn,0,-2,-2,0,0,0
WAC,Wac,7,-3,4,6.097087,0,0
WAPL,Wapl,7,0,7,4.31068,0,0
WARS2,Wars2,-1,-2,-3,12.368932,0,0
WAS,Was,14,4,18,0,0,0
WASF1,Wasf1,5,-8,-3,1.76699,0,0
WASF2,Wasf2,8,-4,4,4.582524,0,0
WASF3,Wasf3,4,4,8,0,0,0
WASHC1,Washc1,2,2,4,6.873786,0,0
WASHC3,Washc3,2,-5,-3,2.378641,0,0
WASHC4,Washc4,4,-1,3,25.07767,0,0
WASHC5,Washc5,4,-1,3,20.320388,0,0
WASL,Wasl,8,1,9,20.699029,0,0
WBP1,Wbp1,9,-6,3,4.718447,0,0
WBP11,Wbp11,2,-13,-11,0,0,0
WBP1L,Wbp1l,5,-3,2,1.281553,0,0
WBP2,Wbp2,10,-2,8,52.23301,0,0
WBP2NL,Wbp2nl,0,3,3,4.145631,0,0
WBP4,Wbp4,4,-6,-2,12.640777,0,0
WDCP,Wdcp,9,1,10,0.893204,0,0
WDFY1,Wdfy1,6,0,6,12.194175,0,0
WDFY2,Wdfy2,3,-2,1,2.07767,0,0
WDFY3,Wdfy3,5,-7,-2,1.106796,0,0
WDFY4,Wdfy4,-2,-9,-11,0,0,0
WDHD1,Wdhd1,-4,-2,-6,24.757282,0,0
WDPCP,Wdpcp,9,-10,-1,5.747573,0,0
WDR1,Wdr1,4,0,4,9.621359,0,0
WDR11,Wdr11,6,-6,0,19.31068,0,64
WDR12,Wdr12,2,-4,-2,4.165049,0,0
WDR13,Wdr13,9,-1,8,23.873786,0,0
WDR17,Wdr17,2,-8,-6,4.563107,0,0
WDR18,Wdr18,7,-4,3,0.834951,0,0
WDR19,Wdr19,1,-8,-7,13.15534,0,0
WDR20,Wdr20,7,-6,1,9.058252,0,0
WDR24,Wdr24,3,-5,-2,5.029126,0,0
WDR25,Wdr25,-4,-8,-12,27.776699,3.791667,0
WDR26,Wdr26,9,0,9,4.427184,0,0
WDR27,Wdr27,2,-5,-3,12.640777,0,0
WDR3,Wdr3,4,-3,1,4.68932,0,0
WDR31,Wdr31,4,-17,-13,0,0,0
WDR33,Wdr33,7,-6,1,5.932039,0,0
WDR35,Wdr35,4,-5,-1,94.407767,0,0
WDR36,Wdr36,0,-5,-5,12.970874,0,0
WDR37,Wdr37,12,-2,10,1.339806,0,0
WDR38,Wdr38,28,-7,21,53.339806,0,0
WDR4,Wdr4,0,-6,-6,3.31068,0,0
WDR41,Wdr41,3,-5,-2,3.68932,0,0
WDR43,Wdr43,-7,-4,-11,12.38835,0,0
WDR44,Wdr44,-3,-5,-8,2.087379,0,0
WDR45,Wdr45,1,-3,-2,2.145631,0,0
WDR45B,Wdr45b,6,-2,4,4.601942,0,0
WDR46,Wdr46,5,0,5,4.84466,0,0
WDR47,Wdr47,16,-10,6,7.902913,0,0
WDR48,Wdr48,4,-2,2,2.543689,0,0
WDR49,Wdr49,59,-8,51,0,0,0
WDR5,Wdr5,3,-7,-4,23.126214,0,0
WDR53,Wdr53,6,0,6,15.951456,0,0
WDR54,Wdr54,8,-15,-7,175.339806,0,0
WDR55,Wdr55,6,-1,5,9.320388,0,0
WDR59,Wdr59,5,-3,2,2.92233,0,0
WDR5B,Wdr5b,6,1,7,0,0,0
WDR6,Wdr6,-6,-9,-15,3.660194,0,0
WDR62,Wdr62,3,-7,-4,1.135922,0,0
WDR64,Wdr64,2,0,2,0,0,0
WDR7,Wdr7,-1,0,-1,4.436893,0,0
WDR70,Wdr70,8,-8,0,16.23301,0,0
WDR72,Wdr72,0,4,4,0,0,0
WDR73,Wdr73,1,-7,-6,14.320388,0,0
WDR74,Wdr74,-13,-2,-15,10.485437,0,177
WDR75,Wdr75,-8,-7,-15,0,0,0
WDR76,Wdr76,5,-3,2,7.757282,0,0
WDR77,Wdr77,4,-12,-8,2.029126,0,0
WDR81,Wdr81,-8,0,-8,6.067961,0,0
WDR82,Wdr82,4,-1,3,17.902913,0,0
WDR83,Wdr83,-1,-3,-4,11.796117,0,0
WDR83OS,Wdr83os,2,0,2,11.796117,0,0
WDR86,Wdr86,2,-9,-7,9.708738,0,0
WDR88,Wdr88,34,-8,26,0,0,0
WDR89,Wdr89,-2,-6,-8,18.203883,4.958333,0
WDR90,Wdr90,-2,-1,-3,22.466019,0,0
WDR91,Wdr91,-3,-4,-7,1.485437,0,0
WDR93,Wdr93,-1,-4,-5,21.640777,0,0
WDSUB1,Wdsub1,-1,-3,-4,3.291262,0,0
WDTC1,Wdtc1,10,0,10,39.427184,0,0
WEE1,Wee1,10,-3,7,9.912621,0,0
WEE2,Wee2,-1,6,5,0,0,0
WFDC1,Wfdc1,0,-5,-5,11.184466,0,0
WFDC11,Wfdc11,9,6,15,0,0,0
WFDC12,Wfdc12,4,-5,-1,0,0,0
WFDC13,Wfdc13,4,6,10,0,0,0
WFDC2,Wfdc2,34,3,37,0,0,0
WFDC3,Wfdc3,3,-16,-13,43.640777,0,0
WFDC5,Wfdc5,3,-1,2,0,0,0
WFDC8,Wfdc8,2,2,4,0,0,0
WFDC9,Wfdc9,2,5,7,0,0,0
WFIKKN1,Wfikkn1,6,-11,-5,0,0,0
WFIKKN2,Wfikkn2,22,1,23,0,0,0
WFS1,Wfs1,1,3,4,1.718447,0,0
WHAMM,Whamm,7,0,7,3.61165,0,0
WHRN,Whrn,42,0,42,74.456311,9.041667,0
WIF1,Wif1,8,4,12,0,0,0
WIPF1,Wipf1,-1,-2,-3,1.504854,0,0
WIPF2,Wipf2,7,0,7,1.067961,0,0
WIPF3,Wipf3,3,4,7,4.485437,0,0
WIPI1,Wipi1,-5,-10,-15,0.708738,0,0
WIPI2,Wipi2,5,-3,2,2.737864,0,0
WIZ,Wiz,3,-3,0,20.932039,0,0
WLS,Wls,5,2,7,1.747573,0,0
WNK1,Wnk1,13,-6,7,34.184466,0,0
WNK2,Wnk2,7,1,8,0,0,0
WNK3,Wnk3,4,2,6,0,0,0
WNK4,Wnk4,13,4,17,1.203883,0,0
WNT1,Wnt1,5,10,15,0,0,0
WNT10A,Wnt10a,-3,3,0,0,0,0
WNT10B,Wnt10b,2,-4,-2,1.019417,0,0
WNT11,Wnt11,24,-2,22,0,0,0
WNT16,Wnt16,4,-16,-12,13.485437,0,0
WNT2,Wnt2,4,-3,1,0,0,0
WNT2B,Wnt2b,4,-2,2,3.699029,0,0
WNT3,Wnt3,6,-4,2,3.504854,0,0
WNT3A,Wnt3a,4,-6,-2,0,0,0
WNT4,Wnt4,-5,7,2,0,0,0
WNT5A,Wnt5a,4,-2,2,2.864078,0,0
WNT5B,Wnt5b,-17,-1,-18,5.194175,0,0
WNT6,Wnt6,8,5,13,1.485437,0,0
WNT7A,Wnt7a,-2,-5,-7,0,0,0
WNT7B,Wnt7b,3,2,5,0,0,0
WNT8A,Wnt8a,3,1,4,0,0,0
WNT8B,Wnt8b,11,2,13,0,0,0
WNT9A,Wnt9a,-12,-4,-16,1.446602,0,0
WNT9B,Wnt9b,3,0,3,0,0,0
WRAP53,Wrap53,-2,-1,-3,1.349515,0,0
WRAP73,Wrap73,7,-4,3,1.514563,0,0
WRN,Wrn,-5,-5,-10,0,0,0
WRNIP1,Wrnip1,8,2,10,11.873786,0,0
WSB1,Wsb1,-1,1,0,2.912621,0,0
WSB2,Wsb2,6,-3,3,3.145631,0,0
WSCD1,Wscd1,20,-1,19,0,0,0
WSCD2,Wscd2,-2,-11,-13,0,0,0
WT1,Wt1,1,7,8,1.990291,0,0
WTAP,Wtap,9,-6,3,15.640777,0,0
WTIP,Wtip,5,-3,2,0,0,0
WWC1,Wwc1,9,0,9,8.349515,0,0
WWC2,Wwc2,4,-2,2,2.543689,0,0
WWOX,Wwox,0,-6,-6,29.07767,0,0
WWP1,Wwp1,2,-3,-1,10.84466,0,0
WWP2,Wwp2,3,-3,0,3.135922,0,0
WWTR1,Wwtr1,10,2,12,2.660194,0,0
XAB2,Xab2,6,-4,2,0,0,0
XAF1,Xaf1,2,5,7,0,0,0
XBP1,Xbp1,0,2,2,3.194175,0,0
XCL1,Xcl1,5,-14,-9,0,0,0
XCR1,Xcr1,-4,1,-3,0,0,0
XDH,Xdh,-3,3,0,2.92233,0,0
XIAP,Xiap,7,2,9,5.970874,0,0
XIRP1,Xirp1,67,33,100,1.718447,0,0
XIRP2,Xirp2,1,0,1,0,0,0
XK,Xk,2,-1,1,5.23301,0,0
XKR4,Xkr4,0,4,4,0,0,0
XKR5,Xkr5,2,-13,-11,0,0,0
XKR6,Xkr6,3,-1,2,3.174757,0,0
XKR7,Xkr7,-2,-1,-3,4.174757,0,0
XKR8,Xkr8,15,-5,10,4.68932,0,0
XKR9,Xkr9,6,-3,3,14.864078,0,0
XKRX,Xkrx,-7,-2,-9,0,0,0
XPA,Xpa,-6,0,-6,7,0,0
XPC,Xpc,2,-8,-6,6.019417,0,0
XPNPEP1,Xpnpep1,3,-3,0,4.582524,0,0
XPNPEP2,Xpnpep2,0,-2,-2,0,0,0
XPNPEP3,Xpnpep3,13,-1,12,663.883495,409.166667,397
XPO1,Xpo1,9,0,9,69.84466,0,0
XPO4,Xpo4,3,-3,0,0.902913,0,0
XPO5,Xpo5,5,-5,0,8.203883,0,0
XPO6,Xpo6,4,2,6,11.330097,0,0
XPO7,Xpo7,4,0,4,2.135922,0,0
XPOT,Xpot,5,6,11,9.359223,0,0
XPR1,Xpr1,3,-8,-5,5.116505,0,0
XRCC1,Xrcc1,7,-3,4,5.349515,0,0
XRCC2,Xrcc2,-2,-10,-12,10.76699,0,0
XRCC3,Xrcc3,-9,-4,-13,5.533981,0,0
XRCC4,Xrcc4,5,-13,-8,1.097087,0,0
XRCC5,Xrcc5,6,-6,0,7.145631,0,0
XRCC6,Xrcc6,8,-1,7,0,0,0
XRN1,Xrn1,3,-1,2,7.990291,0,0
XRN2,Xrn2,3,-2,1,11.223301,0,0
XRRA1,Xrra1,4,-2,2,2.805825,0,0
XXYLT1,Xxylt1,-5,-3,-8,8.165049,0,0
XYLB,Xylb,5,3,8,9.262136,0,0
XYLT1,Xylt1,2,3,5,1.106796,0,0
XYLT2,Xylt2,-4,-7,-11,0,0,0
YAF2,Yaf2,10,0,10,5.067961,0,0
YAP1,Yap1,3,1,4,15.368932,0,0
YARS2,Yars2,4,-5,-1,7.495146,0,0
YBEY,Ybey,-2,-3,-5,12.485437,0,0
YBX1,Ybx1,8,-5,3,28.796117,0,0
YBX2,Ybx2,-6,7,1,3.961165,0,0
YBX3,Ybx3,5,-6,-1,5.165049,0,0
YDJC,Ydjc,-7,-5,-12,0,0,0
YEATS2,Yeats2,9,-4,5,9.883495,0,0
YEATS4,Yeats4,-6,-9,-15,4.038835,0,0
YES1,Yes1,5,-5,0,10.864078,0,0
YIF1A,Yif1a,4,-5,-1,0.932039,0,0
YIF1B,Yif1b,8,-8,0,1.15534,0,0
YIPF1,Yipf1,16,-6,10,0,0,0
YIPF2,Yipf2,8,-3,5,11.029126,0,0
YIPF3,Yipf3,8,-3,5,13.679612,0,0
YIPF4,Yipf4,9,-6,3,1.184466,0,0
YIPF5,Yipf5,4,-3,1,0.990291,0,0
YIPF6,Yipf6,4,-19,-15,6.067961,0,0
YIPF7,Yipf7,29,-10,19,0,0,0
YJEFN3,Yjefn3,9,1,10,0,0,0
YJU2,Yju2,-2,-4,-6,1.970874,0,0
YKT6,Ykt6,9,-3,6,5.699029,0,0
YLPM1,Ylpm1,11,-3,8,20.718447,0,0
YME1L1,Yme1l1,7,-2,5,2.213592,0,0
YOD1,Yod1,1,-8,-7,17.951456,0,0
YPEL1,Ypel1,0,0,0,2.524272,0,0
YPEL2,Ypel2,22,6,28,6.514563,0,0
YPEL3,Ypel3,14,-3,11,6.84466,0,0
YPEL4,Ypel4,4,-18,-14,0,0,0
YPEL5,Ypel5,4,-5,-1,2.543689,0,0
YRDC,Yrdc,4,-4,0,4.533981,0,0
YTHDC1,Ythdc1,13,-1,12,9.407767,0,0
YTHDC2,Ythdc2,3,-8,-5,2.961165,0,0
YTHDF1,Ythdf1,6,-1,5,7.961165,0,0
YTHDF2,Ythdf2,0,-1,-1,18.029126,0,0
YTHDF3,Ythdf3,9,-2,7,7.213592,0,0
YWHAB,Ywhab,8,-2,6,8.76699,0,0
YWHAE,Ywhae,12,1,13,76.61165,0,0
YWHAG,Ywhag,14,5,19,22.92233,2.583333,0
YWHAH,Ywhah,8,3,11,4.621359,0,0
YWHAQ,Ywhaq,11,-1,10,53.097087,0,0
YWHAZ,Ywhaz,6,2,8,58.834951,0,0
YY1,Yy1,7,-2,5,69.757282,23.625,0
YY2,Yy2,5,-12,-7,0,0,0
ZAN,Zan,0,-7,-7,0,0,0
ZAP70,Zap70,5,1,6,0,0,0
ZAR1,Zar1,8,4,12,0,0,0
ZAR1L,Zar1l,7,-1,6,0.893204,0,0
ZBBX,Zbbx,-1,-3,-4,52.834951,0,0
ZBED3,Zbed3,0,-4,-4,1.058252,0,0
ZBED4,Zbed4,1,-5,-4,0,0,0
ZBED5,Zbed5,-24,0,-24,1.951456,0,0
ZBP1,Zbp1,17,3,20,0,0,0
ZBTB1,Zbtb1,10,-1,9,4.92233,0,0
ZBTB10,Zbtb10,12,1,13,5.07767,0,0
ZBTB11,Zbtb11,5,0,5,12.466019,0,0
ZBTB12,Zbtb12,10,-9,1,7.097087,0,0
ZBTB14,Zbtb14,-1,-2,-3,3.116505,0,0
ZBTB16,Zbtb16,7,12,19,0,0,0
ZBTB17,Zbtb17,0,-5,-5,5.417476,0,0
ZBTB18,Zbtb18,9,2,11,0,0,0
ZBTB2,Zbtb2,1,2,3,9.262136,0,0
ZBTB20,Zbtb20,8,1,9,29.854369,0,0
ZBTB21,Zbtb21,5,-2,3,5.68932,0,0
ZBTB22,Zbtb22,4,-10,-6,6.737864,0,0
ZBTB24,Zbtb24,-15,-3,-18,8.466019,0,0
ZBTB25,Zbtb25,-1,-3,-4,4.92233,0,0
ZBTB26,Zbtb26,-11,-5,-16,6.873786,0,0
ZBTB3,Zbtb3,2,-19,-17,0,0,0
ZBTB32,Zbtb32,7,6,13,0,0,0
ZBTB33,Zbtb33,-5,2,-3,4.776699,0,0
ZBTB34,Zbtb34,5,-9,-4,17.262136,0,0
ZBTB37,Zbtb37,0,-2,-2,9.126214,0,0
ZBTB38,Zbtb38,8,3,11,48,14.041667,0
ZBTB39,Zbtb39,-6,-7,-13,5.902913,0,0
ZBTB4,Zbtb4,11,-8,3,12.970874,0,0
ZBTB40,Zbtb40,8,-1,7,22.378641,0,0
ZBTB41,Zbtb41,-5,-6,-11,0,0,0
ZBTB42,Zbtb42,-8,-6,-14,0,0,0
ZBTB43,Zbtb43,9,-6,3,4.087379,0,0
ZBTB44,Zbtb44,6,-3,3,4.407767,0,0
ZBTB45,Zbtb45,-16,-3,-19,32.524272,0,0
ZBTB46,Zbtb46,3,-4,-1,24.854369,0,0
ZBTB48,Zbtb48,4,-3,1,11.009709,0,0
ZBTB49,Zbtb49,2,-5,-3,4.533981,0,0
ZBTB5,Zbtb5,12,-9,3,0,0,0
ZBTB6,Zbtb6,8,0,8,0,0,0
ZBTB7A,Zbtb7a,-4,1,-3,3.815534,0,0
ZBTB7B,Zbtb7b,6,-1,5,2.941748,0,0
ZBTB7C,Zbtb7c,3,-3,0,0,0,0
ZBTB8A,Zbtb8a,0,-7,-7,4.126214,0,0
ZBTB8B,Zbtb8b,3,2,5,33.699029,0,0
ZBTB8OS,Zbtb8os,-6,-6,-12,8.990291,0,0
ZBTB9,Zbtb9,4,-15,-11,7.757282,0,0
ZC2HC1A,Zc2hc1a,-7,0,-7,0,0,0
ZC2HC1B,Zc2hc1b,-3,1,-2,0,0,0
ZC2HC1C,Zc2hc1c,7,-5,2,3.747573,0,107
ZC3H10,Zc3h10,6,-8,-2,23.029126,0,0
ZC3H11A,Zc3h11a,10,-5,5,18.087379,0,0
ZC3H12A,Zc3h12a,45,2,47,60.660194,0,0
ZC3H12B,Zc3h12b,-1,-4,-5,0,0,0
ZC3H12C,Zc3h12c,3,-2,1,6.699029,0,0
ZC3H12D,Zc3h12d,1,0,1,1.514563,0,0
ZC3H13,Zc3h13,9,-1,8,1.048544,0,0
ZC3H14,Zc3h14,0,-2,-2,11.145631,5.166667,0
ZC3H15,Zc3h15,6,-3,3,10.252427,0,0
ZC3H18,Zc3h18,2,-2,0,9.718447,0,0
ZC3H3,Zc3h3,-11,-5,-16,65.145631,0,0
ZC3H4,Zc3h4,6,-5,1,1.912621,0,0
ZC3H6,Zc3h6,-1,-12,-13,14.368932,0,0
ZC3H7A,Zc3h7a,5,-9,-4,4.825243,0,0
ZC3H7B,Zc3h7b,10,-7,3,3.15534,0,0
ZC3H8,Zc3h8,1,-5,-4,12.941748,0,0
ZC3HAV1,Zc3hav1,9,1,10,144.747573,17.208333,0
ZC3HAV1L,Zc3hav1l,3,-6,-3,4.087379,0,0
ZC3HC1,Zc3hc1,-1,-4,-5,2.194175,0,0
ZC4H2,Zc4h2,5,-3,2,1.485437,0,0
ZCCHC10,Zcchc10,8,-4,4,5.815534,0,0
ZCCHC12,Zcchc12,26,0,26,0,0,0
ZCCHC13,Zcchc13,1,2,3,0,0,0
ZCCHC14,Zcchc14,10,-1,9,5.019417,0,0
ZCCHC17,Zcchc17,1,0,1,2.339806,0,0
ZCCHC18,Zcchc18,5,-8,-3,1.300971,0,0
ZCCHC2,Zcchc2,6,-4,2,0,0,0
ZCCHC24,Zcchc24,-10,-5,-15,22.038835,0,0
ZCCHC3,Zcchc3,-1,-6,-7,17.543689,0,0
ZCCHC4,Zcchc4,-2,-2,-4,25.669903,0,0
ZCCHC7,Zcchc7,1,-10,-9,3.446602,0,0
ZCCHC8,Zcchc8,1,-7,-6,12.271845,0,0
ZCCHC9,Zcchc9,3,-1,2,4.019417,0,0
ZCRB1,Zcrb1,8,-5,3,5.300971,0,0
ZCWPW1,Zcwpw1,4,-9,-5,3.504854,0,0
ZCWPW2,Zcwpw2,7,8,15,43.23301,4.5,0
ZDBF2,Zdbf2,16,0,16,1.262136,0,0
ZDHHC1,Zdhhc1,5,-5,0,17.135922,0,0
ZDHHC11,Zdhhc11,28,-7,21,0,0,0
ZDHHC12,Zdhhc12,2,-9,-7,1.271845,0,0
ZDHHC13,Zdhhc13,1,-13,-12,2.349515,0,0
ZDHHC14,Zdhhc14,1,0,1,4.427184,0,0
ZDHHC15,Zdhhc15,0,-8,-8,0,0,0
ZDHHC16,Zdhhc16,-1,-10,-11,2.398058,0,0
ZDHHC17,Zdhhc17,5,-4,1,20.213592,0,0
ZDHHC18,Zdhhc18,7,-1,6,13.757282,0,0
ZDHHC19,Zdhhc19,12,0,12,0,0,0
ZDHHC2,Zdhhc2,5,-6,-1,3.097087,0,0
ZDHHC20,Zdhhc20,4,-1,3,5.466019,0,0
ZDHHC21,Zdhhc21,4,-7,-3,3.242718,0,0
ZDHHC22,Zdhhc22,2,3,5,0,0,0
ZDHHC23,Zdhhc23,7,0,7,22.84466,0,0
ZDHHC24,Zdhhc24,3,0,3,4.126214,0,0
ZDHHC3,Zdhhc3,10,-2,8,9.776699,0,0
ZDHHC4,Zdhhc4,2,-9,-7,1.873786,0,0
ZDHHC5,Zdhhc5,8,-5,3,8.68932,0,0
ZDHHC6,Zdhhc6,5,-4,1,0,0,0
ZDHHC7,Zdhhc7,3,-6,-3,7.262136,0,0
ZDHHC8,Zdhhc8,6,0,6,0,0,0
ZDHHC9,Zdhhc9,6,-1,5,2.048544,0,0
ZEB1,Zeb1,7,-7,0,0,0,0
ZEB2,Zeb2,3,-1,2,0,0,0
ZER1,Zer1,4,-5,-1,39.757282,0,0
ZFAND1,Zfand1,-3,-12,-15,9.106796,0,0
ZFAND2A,Zfand2a,165,12,177,383.621359,205.083333,198
ZFAND2B,Zfand2b,4,-4,0,6.708738,0,0
ZFAND3,Zfand3,7,-1,6,5.786408,0,0
ZFAND4,Zfand4,-3,-6,-9,1.135922,0,0
ZFAND5,Zfand5,12,2,14,12.669903,3.375,0
ZFAND6,Zfand6,9,-9,0,11.883495,0,0
ZFAT,Zfat,8,-1,7,0,0,0
ZFC3H1,Zfc3h1,5,0,5,1.067961,0,0
ZFHX2,Zfhx2,11,-4,7,65.650485,0,0
ZFHX3,Zfhx3,10,-1,9,25.009709,0,0
ZFHX4,Zfhx4,10,-3,7,3.76699,0,0
ZFP1,Zfp1,3,-1,2,9.543689,0,0
ZFP14,Zfp14,3,-5,-2,1.631068,0,0
ZFP2,Zfp2,22,2,24,0,0,0
ZFP28,Zfp28,-2,-17,-19,0,0,0
ZFP3,Zfp3,15,-3,12,0,0,0
ZFP30,Zfp30,8,-2,6,0,0,0
ZFP36,Zfp36,32,8,40,9.980583,0,0
ZFP36L1,Zfp36l1,8,7,15,4.912621,0,0
ZFP36L2,Zfp36l2,-2,4,2,46.68932,0,0
ZFP37,Zfp37,3,-15,-12,0,0,0
ZFP41,Zfp41,5,-16,-11,3.281553,0,0
ZFP42,Zfp42,8,0,8,0,0,0
ZFP57,Zfp57,3,-11,-8,0,0,0
ZFP62,Zfp62,-4,-7,-11,16.165049,0,0
ZFP64,Zfp64,4,0,4,8.223301,0,0
ZFP69,Zfp69,-6,-6,-12,0,0,0
ZFP82,Zfp82,5,-16,-11,0,0,0
ZFP90,Zfp90,1,-7,-6,1.038835,0,0
ZFP91,Zfp91,8,-4,4,3.514563,0,0
ZFP92,Zfp92,3,0,3,0,0,0
ZFPL1,Zfpl1,19,-5,14,19.902913,0,0
ZFPM1,Zfpm1,-11,2,-9,0,0,0
ZFPM2,Zfpm2,2,-6,-4,4.31068,0,0
ZFR,Zfr,9,0,9,13.543689,0,0
ZFR2,Zfr2,13,-3,10,0,0,0
ZFX,Zfx,8,-3,5,5.718447,0,0
ZFYVE1,Zfyve1,5,-3,2,2.572816,0,0
ZFYVE16,Zfyve16,4,-10,-6,1.291262,0,0
ZFYVE19,Zfyve19,8,-2,6,3.359223,0,0
ZFYVE21,Zfyve21,18,-1,17,5.533981,0,0
ZFYVE26,Zfyve26,6,1,7,0,0,0
ZFYVE27,Zfyve27,4,-3,1,2.135922,0,0
ZFYVE28,Zfyve28,1,0,1,26.728155,0,0
ZFYVE9,Zfyve9,8,-5,3,34.495146,0,0
ZG16,Zg16,1,-4,-3,2.912621,0,0
ZGLP1,Zglp1,9,2,11,0,0,0
ZGPAT,Zgpat,4,-1,3,14.951456,0,0
ZGRF1,Zgrf1,-3,-4,-7,0,0,0
ZHX1,Zhx1,6,-1,5,48.524272,6.083333,160
ZHX2,Zhx2,-23,7,-16,67.84466,78.208333,0
ZHX3,Zhx3,11,-2,9,7.475728,0,0
ZIC1,Zic1,3,3,6,1.456311,0,0
ZIC2,Zic2,10,-1,9,1.601942,0,0
ZIC3,Zic3,6,2,8,0,0,0
ZIC4,Zic4,-3,1,-2,0,0,0
ZIC5,Zic5,8,-6,2,0.68932,0,0
ZIK1,Zik1,0,-3,-3,0,0,0
ZKSCAN1,Zkscan1,3,-4,-1,4.893204,0,0
ZKSCAN2,Zkscan2,-6,-7,-13,6.621359,0,0
ZKSCAN3,Zkscan3,6,-1,5,0,0,0
ZKSCAN4,Zkscan4,7,-14,-7,3.650485,0,0
ZKSCAN5,Zkscan5,8,2,10,16.165049,0,0
ZKSCAN7,Zkscan7,1,-8,-7,0,0,0
ZKSCAN8,Zkscan8,6,-2,4,3.776699,0,0
ZMAT1,Zmat1,3,1,4,21.067961,0,0
ZMAT2,Zmat2,5,-3,2,3.378641,0,0
ZMAT3,Zmat3,6,-10,-4,8.038835,0,0
ZMAT4,Zmat4,-3,-5,-8,0,0,0
ZMAT5,Zmat5,26,-4,22,0,0,0
ZMIZ1,Zmiz1,7,1,8,31.087379,0,0
ZMIZ2,Zmiz2,6,0,6,5.087379,0,0
ZMPSTE24,Zmpste24,5,-2,3,20.300971,0,0
ZMYM1,Zmym1,-3,3,0,1.368932,0,0
ZMYM2,Zmym2,7,-3,4,0,0,0
ZMYM3,Zmym3,2,-11,-9,2.427184,0,0
ZMYM4,Zmym4,8,-3,5,15.019417,0,0
ZMYM5,Zmym5,4,-3,1,1.07767,0,0
ZMYM6,Zmym6,1,3,4,1.330097,0,0
ZMYND10,Zmynd10,11,-8,3,4.349515,0,0
ZMYND11,Zmynd11,2,0,2,1.029126,0,0
ZMYND12,Zmynd12,-4,-7,-11,2.796117,0,0
ZMYND15,Zmynd15,-4,-2,-6,5.436893,0,0
ZMYND19,Zmynd19,-2,-3,-5,1.805825,0,0
ZMYND8,Zmynd8,-2,8,6,41.417476,0,0
ZNFX1,Znfx1,3,-4,-1,19.941748,0,0
ZNHIT1,Znhit1,12,-4,8,52.834951,6.166667,0
ZNHIT2,Znhit2,-1,-1,-2,29.097087,0,0
ZNHIT3,Znhit3,2,-15,-13,3.961165,0,0
ZNHIT6,Znhit6,5,-5,0,3.631068,0,0
ZNRD2,Znrd2,-1,-2,-3,12.291262,0,0
ZNRF1,Znrf1,3,-5,-2,19.76699,0,0
ZNRF2,Znrf2,4,0,4,6.330097,0,0
ZNRF3,Znrf3,3,-3,0,2.592233,0,0
ZNRF4,Znrf4,3,-2,1,0,0,0
ZP1,Zp1,3,8,11,0,0,0
ZP2,Zp2,5,0,5,0,0,0
ZP3,Zp3,6,3,9,15.61165,0,0
ZPBP,Zpbp,1,-6,-5,1,0,0
ZPBP2,Zpbp2,1,-18,-17,0,0,0
ZPLD1,Zpld1,2,2,4,0,0,0
ZPR1,Zpr1,5,-3,2,3.854369,0,0
ZRANB1,Zranb1,5,-1,4,0,0,0
ZRANB2,Zranb2,5,-2,3,4.087379,0,0
ZRANB3,Zranb3,4,-3,1,1.679612,0,0
ZRSR2,Zrsr2,2,-4,-2,3.106796,0,0
ZSCAN10,Zscan10,19,-7,12,0,0,0
ZSCAN12,Zscan12,1,-3,-2,0,0,0
ZSCAN18,Zscan18,13,-5,8,3.029126,0,0
ZSCAN2,Zscan2,-1,-12,-13,3.572816,0,0
ZSCAN20,Zscan20,8,-13,-5,1.514563,0,0
ZSCAN21,Zscan21,0,-7,-7,10.631068,0,0
ZSCAN22,Zscan22,2,-3,-1,12.621359,0,0
ZSCAN25,Zscan25,9,-5,4,6.669903,0,0
ZSCAN26,Zscan26,1,-1,0,4.815534,0,0
ZSCAN29,Zscan29,10,7,17,2.524272,0,0
ZSCAN5B,Zscan5b,10,-3,7,0,0,0
ZSWIM1,Zswim1,1,-1,0,15.825243,0,0
ZSWIM2,Zswim2,-3,-8,-11,0,0,0
ZSWIM3,Zswim3,2,-2,0,1.61165,0,0
ZSWIM4,Zswim4,5,-2,3,21.951456,0,0
ZSWIM5,Zswim5,2,-2,0,3.932039,0,0
ZSWIM6,Zswim6,11,-1,10,0,0,0
ZSWIM7,Zswim7,0,-13,-13,11.339806,0,0
ZSWIM8,Zswim8,14,-8,6,28.291262,0,0
ZSWIM9,Zswim9,5,0,5,6.242718,0,0
ZUP1,Zup1,5,-7,-2,0,0,0
ZW10,Zw10,5,-3,2,4.669903,0,0
ZWILCH,Zwilch,-4,-7,-11,1.252427,0,0
ZWINT,Zwint,5,-3,2,3.563107,0,0
ZXDB,Zxdb,5,1,6,1.126214,0,0
ZXDC,Zxdc,5,4,9,5.097087,0,0
ZYG11A,Zyg11a,7,-1,6,1.242718,0,0
ZYG11B,Zyg11b,1,-2,-1,2.825243,0,0
ZYX,Zyx,5,4,9,14.242718,0,0
ZZEF1,Zzef1,6,1,7,7.825243,0,0
ZZZ3,Zzz3,7,-4,3,11.912621,0,0